LittlerootTown_BrendansHouse_1F (11x9)
622 622 542 622 622 542 542 527 543 543 543
560 561 562 563 564 550 550 520 521 525 589
568 569 570 571 572 517 517 528 529 533 534
516 517 517 517 578 513 513 612 517 519 517
516 513 576 577   2 513 513 513 513 513 513
516 565 584 585 586 558 566 513 513 513 513
516 536 537 538 539 540 541 513 513 513 513
516 544 545 546 547 548 549 513 513 513 513
516 552 553 554 555 556 557 513 514 515 513
