LittlerootTown_MaysHouse_1F (11x9)
543 543 543 535 542 542 622 622 622 542 622
622 623 521 621 550 550 579 580 561 562 560
630 631 529 629 632 517 587 588 569 570 568
516 518 517 519 633 513 582 517 517 517 517
516 513 513 513 513 513   2 576 577 513 513
516 513 513 513 565 558 586 584 585 566 513
516 513 513 513 536 537 538 539 540 541 513
516 513 513 513 544 545 546 547 548 549 513
516 514 515 513 552 553 554 555 556 557 513
