LittlerootTown_ProfessorBirchsLab (13x13)
528 529 520 530 531 520 520 521 521 520 520 520 520
536 537 572 538 539 522 523 524 525 526 522 522 527
544 545 580 546 547 574 546 563 546 563 574 574 535
552 514 554 554 577 514 514 514 514 553 570 514 543
516 514 514 514 514 514 514 514 514 561 578 514 551
548 549 566 567 514 514 514 514 514 575 575 514 559
556 557 556 557 514 514 514 514 514 514 532 533 534
564 565 564 565 514 514 514 514 514 514 540 541 542
573 574 574 574 514 514 514 514 514 514 583 575 658
516 560 514 514 514 514 514 514 514 514 514 571 558
584 568 569 514 514 514 514 514 514 514 585 579 570
584 576 514 550 514 514 514 514 514 514 514 587 578
591 575 514 558 514 514 518 519 514 514 514 575 575
