LittlerootTown_MaysHouse_2F (9x8)
520 524 522 551 598 596 592 596 593
528 532 530 559   2 613 597 600 601
581 517 519 517 605 615 517 608 609
516 664 665 665 666 513 640 641 642
516 672 673 673 674 513 648 649 650
516 672 673 673 674 513 656 657 658
516 680 681 681 682 513 513 513 513
516 513 513 513 513 513 513 513 513
