AbandonedShip_Corridors_B1F_Layout (13x10)
545 545 560 561 561 561 561 562 545 545 560 561 561
553 671 560 561 561 561 561 562 553 671 560 561 561
678 679 560 561 561 561 561 562 678 679 560 561 561
515 514 549 547 548 546 686 550 516 514 549 547 548
515 514 557 555 556 554 694 558 516 514 557 555 556
515 514 517 518 518 518 518 518 519 514 517 518 518
515 514 514 514 514 514 514 514 514 514 514 514 684
515 514 514 514 536 538 539 537 538 539 537 538 540
685 514 514 514 560 561 561 561 561 561 561 561 562
515 514 514 514 560 561 561 561 561 561 561 561 562