AbandonedShip_Rooms2_1F_Layout (9x17)
566 576 619 661 611 662 551 551 567
574 584 627 669 663 670 559 559 575
574 592 593 570 571 571 571 571 575
574 600 601 573 568 568 568 568 575
574 542 571 572 568 568 609 568 575
574 573 568 568 568 568 568 568 575
574 573 568 610 568 609 568 568 575
574 573 568 568 568 568 568 568 575
513 513 513 513 573 513 513 513 513
566 551 551 551 573 551 551 551 567
574 559 559 559 573 559 559 559 575
574 570 571 571 572 571 571 571 575
574 573 568 568 568 568 568 568 575
574 573 598 599 568 609 568 568 575
574 573 606 607 609 568 568 568 575
574 573 568 568 568 568 568 568 575
574 573 568 568 612 613 568 568 575