AbandonedShip_HiddenFloorRooms_Layout (44x15)
566 551 551 551 551 661 611 662 551 551 551 551 551 567 566 551 551 551 551 551 661 687 662 551 551 551 551 551 567 566 551 551 551 551 551 661 611 662 551 551 551 551 551 567
574 559 559 559 559 669 663 670 559 559 559 559 559 575 574 559 559 559 559 559 669 695 670 559 559 559 559 559 583 582 559 559 559 559 559 669 663 670 559 559 559 559 559 575
574 616 571 571 571 571 571 571 571 571 571 571 571 575 574 570 571 571 527 535 565 571 665 666 571 571 571 571 591 590 570 571 571 571 571 571 571 615 571 571 665 666 571 575
574 573 568 568 568 568 568 609 568 568 568 568 682 575 574 683 568 609 606 607 568 610 672 674 568 568 568 568 571 571 572 568 568 610 568 568 568 568 568 568 672 674 568 575
574 573 568 598 599 568 568 568 568 568 609 568 568 575 574 573 568 568 608 568 568 568 568 568 568 568 568 568 575 574 573 568 568 568 568 608 568 568 568 568 568 568 568 575
574 683 568 606 607 568 568 568 568 568 568 608 568 575 574 573 608 568 568 568 568 568 568 568 568 568 609 568 575 574 683 568 598 599 568 568 568 568 610 568 568 568 609 575
574 573 568 568 568 568 568 568 568 568 568 568 568 575 574 573 568 568 568 568 568 568 568 568 568 568 568 568 575 574 573 568 606 607 568 568 568 609 568 568 568 568 682 575
513 513 513 513 513 513 513 513 513 513 513 513 513 513 513 513 513 513 513 513 513 513 513 513 513 513 513 513 513 513 513 513 513 513 513 513 513 513 513 513 513 513 513 513
566 551 551 551 551 551 551 551 551 551 551 551 551 567 566 551 551 551 551 551 551 551 551 551 551 551 551 551 567 566 551 551 551 551 551 551 551 551 551 551 551 551 551 567
574 559 559 559 559 559 559 559 559 559 559 559 559 575 574 559 559 559 559 559 559 559 559 559 559 559 559 559 575 574 559 559 559 559 559 559 559 559 559 559 559 559 559 575
574 570 615 571 571 571 571 565 571 571 571 571 571 575 574 570 571 571 571 571 571 571 571 571 571 571 571 571 575 574 570 571 571 615 571 571 571 571 571 571 665 666 571 575
574 573 568 568 568 568 609 568 568 568 598 599 568 575 574 573 568 568 568 568 568 608 568 568 568 610 568 682 575 574 683 568 568 568 568 598 599 568 568 568 672 674 568 575
574 573 568 568 568 568 568 568 568 568 606 607 568 575 574 573 568 568 609 608 568 568 568 568 568 568 568 568 575 574 573 568 568 568 568 606 607 568 568 609 568 568 568 575
574 683 568 608 568 568 568 568 568 568 568 568 568 575 574 573 598 599 568 568 568 568 568 568 568 568 568 568 575 574 573 568 568 568 568 568 568 568 568 568 568 568 682 575
574 573 568 568 568 568 612 613 568 568 568 568 682 575 574 573 606 607 568 568 568 612 613 568 568 568 609 568 575 574 573 608 568 610 568 568 612 613 568 568 568 568 609 575