AbandonedShip_Corridors_1F_Layout (18x12)
520 521 520 680 681 680 520 513 521 520 680 681 521 520 680 520 521 520
528 529 528 688 689 688 528 513 529 528 688 689 529 528 688 528 529 528
515 515 515 515 515 522 523 513 685 515 515 515 515 515 515 515 522 523
515 514 536 538 540 514 531 513 515 514 536 538 539 537 538 540 514 531
685 514 560 561 562 516 514 513 515 514 560 561 561 561 561 562 516 514
515 514 560 561 562 516 514 513 515 514 560 561 561 561 561 562 516 514
515 514 560 561 562 516 514 513 515 514 560 561 561 561 561 562 516 514
515 514 560 561 562 516 514 513 515 514 560 561 561 561 561 562 516 514
685 514 549 547 550 516 514 513 515 514 549 686 548 546 547 550 516 514
515 514 557 555 558 516 514 513 515 514 557 694 556 554 555 558 516 684
515 514 517 518 518 519 514 513 515 514 517 518 518 518 518 518 519 514
667 668 514 514 514 514 514 513 667 668 514 514 514 514 514 514 514 514