AbandonedShip_Rooms2_B1F_Layout (18x8)
566 576 577 578 551 551 551 551 567 566 576 577 578 551 579 580 581 567
574 584 585 586 559 559 559 559 575 574 584 585 586 559 587 588 589 575
574 592 593 570 571 571 571 571 583 582 592 593 570 571 571 596 597 575
574 600 601 573 568 598 599 682 591 590 600 601 573 568 568 604 605 575
574 570 571 572 568 606 607 568 571 571 571 571 614 568 568 571 571 575
574 573 568 568 568 568 568 568 575 574 573 568 568 568 568 568 682 575
574 683 568 568 568 568 568 568 575 574 683 568 568 568 568 608 568 575
574 573 568 568 612 613 568 610 575 574 573 568 568 612 613 568 568 575