AbandonedShip_HiddenFloorCorridors_Layout (13x11)
520 521 520 680 520 521 520 521 681 680 520 521 520
689 688 528 688 689 529 528 529 689 688 528 529 528
515 515 515 515 515 515 515 515 515 515 515 515 515
685 514 536 564 539 537 538 539 537 564 540 514 514
515 514 560 561 561 561 561 561 561 561 562 516 684
685 514 560 561 561 561 561 561 561 561 562 516 514
515 514 560 561 561 561 561 561 561 561 562 516 514
515 514 549 547 548 546 547 548 546 547 550 516 514
393 385 557 563 556 554 563 556 554 555 558 516 514
342 410 385 518 518 518 518 518 518 518 518 519 514
327 342 376 514 514 514 514 514 514 514 514 514 514