AbandonedShip_Deck_Layout (23x21)
552 552 552 608 552 543 543 608 552 552 552 552 552 610 608 552 552 552 552 552 552 552 552
552 552 552 608 552 551 551 608 552 613 617 614 552 610 608 552 552 543 673 552 552 552 552
552 552 552 608 552 551 559 608 552 552 552 552 552 610 608 552 543 551 673 552 543 673 552
613 614 552 608 552 559 551 616 617 617 617 617 617 618 608 552 551 551 673 552 551 673 552
552 552 552 608 552 554 559 528 969 969 969 707 708 709 608 552 559 559 673 552 559 673 552
552 552 552 608 552 968 554 544 861 861 861 715 716 717 616 617 617 617 617 617 617 617 617
552 552 552 608 552 552 552 819 968 554 554 702 554 703 536 969 969 969 969 969 969 969 969
613 614 552 616 617 617 617 617 617 614 552 552 613 617 544 972 973 972 973 972 973 972 973
552 552 552 536 969 969 969 707 708 709 175 207 707 708 947 969 969 969 969 969 969 969 969
552 552 552 544 861 861 861 715 716 717 175 207 715 716 717 861 861 861 861 861 861 861 861
552 552 552 819 554 554 968 702 554 703 554 968 702 554 703 968 554 554 554 554 554 554 554
552 552 552 552 968 552 552 968 552 552 552 552 968 552 552 552 968 552 968 552 552 552 552
617 617 617 617 617 617 617 617 617 617 617 617 614 552 552 613 617 617 617 617 617 617 617
969 969 969 969 969 969 969 969 969 969 969 969 536 175 207 536 969 969 969 969 969 969 969
971 971 971 971 971 971 971 971 971 971 971 971 544 175 207 544 971 971 971 971 971 971 971
970 970 970 970 970 970 970 970 970 970 970 970 544 718 719 544 970 970 970 970 970 970 970
414 414 414 414 414 414 414 414 414 414 414 414 820 414 414 820 414 414 414 414 414 414 414
414 414 414 414 414 414 414 414 414 414 414 414 414 414 414 414 414 414 414 414 414 414 414
419 414 414 414 414 414 414 414 414 414 414 414 414 414 414 414 414 414 414 414 414 414 414
445 446 446 446 446 446 446 446 419 414 414 414 414 414 414 414 414 414 414 414 414 414 414
368 368 368 368 368 368 368 368 445 446 446 446 446 446 446 446 446 446 446 446 446 446 446