AbandonedShip_CaptainsOffice_Layout (9x7)
760 760 760 537 537 539 540 537 537
768 768 768 696 697 547 548 526 527
515 516 516 704 705 516 516 534 535
948 514 514 514 514 514 514 516 516
949 514 514 514 514 514 514 514 514
515 514 514 524 525 514 514 514 514
515 514 514 532 533 514 514 518 519