AbandonedShip_Rooms_B1F_Layout (27x8)
566 576 619 661 687 662 621 581 513 513 576 619 661 611 662 551 551 513 513 576 619 661 687 662 621 581 567
574 584 627 669 695 670 629 589 513 513 584 627 669 663 670 559 559 513 513 584 627 669 695 670 629 589 575
574 592 593 570 571 571 596 597 513 513 592 593 570 571 571 571 571 513 513 592 593 570 571 571 596 597 575
574 600 601 573 568 568 604 605 513 513 600 601 573 568 568 609 568 513 513 600 601 573 609 568 604 605 575
574 570 571 572 609 568 571 571 513 513 570 571 572 568 568 568 682 513 513 570 571 572 568 568 571 571 575
574 573 598 599 568 568 568 682 513 513 573 384 393 393 393 385 568 513 513 573 568 568 609 568 568 568 575
574 573 606 607 568 608 568 568 513 513 573 400 368 342 368 402 568 513 513 573 608 568 568 568 610 568 575
574 683 568 568 568 568 568 568 513 513 573 400 342 327 342 402 568 513 513 573 568 568 568 568 568 682 575