AbandonedShip_Underwater2_Layout (21x7)
716 718 728 729 730 718 717 718 716 718 717 718 716 718 716 718 717 718 717 718 716
724 726 731 732 733 726 725 726 724 726 725 727 724 727 724 726 725 727 725 726 724
719 719 719 719 719 719 719 719 719 719 719 720 721 719 719 719 760 713 722 723 713
721 719 719 719 719 719 719 719 719 719 719 719 719 719 719 760 713 713 713 713 713
719 719 719 719 719 719 720 721 719 719 719 719 719 719 760 713 713 713 713 713 713
719 719 719 719 719 719 719 719 719 719 719 719 719 719 759 751 713 713 713 713 722
720 721 719 719 719 719 719 719 719 719 719 719 719 720 721 759 751 713 713 713 713