AbandonedShip_Rooms_1F_Layout (18x17)
566 551 551 661 611 662 551 551 567 566 576 619 661 611 662 551 551 567
574 559 559 669 663 670 559 559 575 574 584 627 669 663 670 559 559 575
574 570 571 571 571 571 571 571 575 574 592 593 570 571 571 571 571 575
574 573 568 568 568 568 568 568 575 574 600 601 573 568 568 568 682 575
574 683 568 568 568 568 609 568 575 574 570 571 572 568 568 568 568 575
574 573 568 568 568 568 568 568 575 574 573 568 568 568 608 568 568 575
574 573 610 568 568 568 568 568 575 574 683 568 568 568 568 568 568 575
574 573 568 568 568 609 568 568 575 574 573 568 568 568 568 568 568 575
513 513 513 513 513 513 513 513 513 513 513 513 513 573 513 513 513 513
566 576 577 578 551 551 551 581 567 566 551 551 551 573 579 580 581 567
574 584 585 586 559 559 559 559 575 574 559 559 559 573 587 588 589 575
574 592 593 570 571 571 571 571 583 582 570 571 571 572 571 596 597 575
574 600 601 573 568 608 568 568 591 590 573 568 568 568 568 604 605 575
574 570 571 572 610 568 568 568 571 571 572 568 568 568 568 571 571 575
574 573 568 568 568 568 568 568 575 574 573 598 599 568 568 568 682 575
574 573 609 568 568 568 568 568 575 574 573 606 607 568 568 568 568 575
574 683 568 568 612 613 568 568 575 574 573 568 568 612 613 568 568 575