AbandonedShip_Underwater1_Layout (8x8)
717 718 716 718 716 718 717 718
725 727 724 726 724 726 725 726
719 719 719 719 719 719 720 721
719 760 722 723 713 713 719 719
760 713 713 713 713 713 713 719
760 713 713 713 722 723 713 719
762 713 713 713 713 713 713 720
759 751 713 714 715 713 761 719