AbandonedShip_Room_B1F_Layout (9x8)
566 551 551 551 551 551 551 551 567
574 559 559 559 559 559 559 559 575
574 570 571 571 571 571 571 571 575
574 573 568 609 568 568 568 568 575
574 573 608 568 568 568 568 568 575
574 573 568 568 568 568 609 568 575
574 573 568 568 568 568 568 568 575
574 573 568 568 612 613 568 610 575