AquaHideout_B1F_Layout (51x24)
513 513 513 513 513 513 513 529 736 736 736 707 708 709 529 736 736 707 708 709 736 736 736 736 736 529 736 736 691 692 693 736 736 529 513 513 513 513 513 513 529 736 736 736 736 736 736 736 736 736 529
513 513 513 513 513 513 513 521 560 561 545 715 716 717 522 561 561 715 716 717 545 984 985 984 985 522 545 545 699 700 701 545 545 522 513 513 513 513 513 513 522 984 985 545 545 545 984 985 984 985 522
529 736 707 708 709 595 596 528 568 569 553 710 553 711 522 569 569 710 553 711 553 986 987 986 987 522 551 553 710 553 711 553 551 522 513 513 513 513 513 513 522 986 987 553 553 553 986 987 986 987 522
522 545 715 716 717 603 604 544 553 552 552 552 552 552 522 553 552 552 552 552 552 988 989 986 987 522 559 673 552 552 552 552 559 522 513 513 513 513 513 513 522 988 989 673 552 735 988 989 986 987 522
522 553 710 553 711 611 612 531 553 552 552 552 552 552 522 553 552 552 552 552 735 554 554 988 989 522 553 735 552 552 552 735 552 522 513 513 513 513 513 513 522 553 554 681 552 552 554 554 988 989 522
522 553 552 552 552 619 620 673 552 552 552 552 552 552 521 523 601 601 601 601 601 601 601 601 601 521 523 601 601 601 601 601 601 521 513 513 513 513 513 513 522 553 735 552 552 735 552 552 735 552 522
522 553 552 552 552 514 577 578 514 514 514 552 552 552 529 736 736 725 724 725 736 736 736 736 736 529 736 736 736 555 556 557 558 529 513 513 513 513 513 513 522 646 617 617 617 617 617 617 617 606 522
522 553 552 552 552 517 585 586 514 514 514 552 552 552 522 995 995 548 547 548 545 545 545 526 527 522 560 560 561 563 564 565 566 522 513 513 513 513 513 513 522 608 686 679 679 679 679 679 679 678 522
522 553 552 552 552 514 541 514 577 578 514 552 552 552 522 1002 1002 998 1011 1012 998 1013 998 534 535 522 568 568 569 571 572 573 574 522 513 513 513 513 513 513 522 616 617 617 617 617 617 617 617 684 522
522 553 552 552 552 514 514 514 585 586 517 552 552 552 522 897 896 997 963 965 997 1021 997 997 997 522 553 822 552 579 580 581 582 522 513 513 513 513 513 513 522 553 735 552 552 735 552 552 735 552 522
522 553 552 552 552 514 514 514 541 514 514 552 552 552 522 897 896 997 1019 1020 997 1018 997 735 997 522 553 552 552 587 588 589 590 522 513 513 513 513 513 513 522 646 617 617 617 617 617 617 617 606 522
521 523 601 601 601 601 601 601 601 601 601 601 601 601 521 1006 1005 1005 1005 1005 1005 1005 1005 1005 1005 521 553 552 552 552 597 598 553 522 513 513 513 513 513 513 522 608 686 679 679 679 679 679 679 678 522
529 736 736 736 736 736 736 736 736 736 736 736 736 736 528 736 736 736 736 736 736 736 736 736 736 529 553 735 552 552 552 552 552 522 513 513 513 513 513 513 522 616 617 617 617 617 617 617 617 684 522
522 545 545 545 545 545 545 545 545 545 545 545 545 545 544 545 545 545 545 545 545 545 545 545 545 521 523 601 601 601 601 601 601 521 513 513 513 513 513 513 522 553 735 552 552 735 552 552 735 552 522
522 553 553 553 553 553 553 553 553 553 553 553 553 553 531 553 515 515 515 515 515 515 515 515 992 528 736 736 736 736 736 736 736 529 513 513 513 513 513 513 522 646 617 617 617 617 617 617 617 606 522
522 553 552 735 552 552 552 552 552 552 552 552 552 552 552 552 1001 524 525 514 514 514 1008 1009 993 544 545 545 545 545 545 545 545 522 513 513 513 513 513 513 522 608 686 679 679 679 679 679 679 678 522
522 646 617 617 617 617 617 617 617 617 617 617 617 617 617 606 1000 532 533 514 514 541 1016 1017 1000 836 515 515 515 515 515 553 553 522 513 513 513 513 513 513 522 616 617 617 617 617 617 617 617 684 522
522 608 686 679 679 679 679 679 679 679 679 679 679 679 679 678 514 514 541 514 514 514 514 541 514 514 514 514 514 514 514 552 552 522 513 513 513 513 513 513 522 553 735 552 552 735 552 552 735 552 522
522 608 687 335 335 335 335 335 335 335 335 335 335 335 335 676 514 577 578 514 514 514 577 578 1001 1001 514 514 514 514 514 552 552 522 513 513 513 513 513 513 521 523 601 601 601 601 601 601 601 601 521
522 616 617 617 617 617 617 617 617 617 617 617 617 617 617 684 514 585 586 514 514 514 585 586 1000 1000 514 514 514 514 514 552 735 522 513 513 513 513 513 513 528 736 736 736 736 736 736 736 736 736 528
522 553 554 735 554 554 554 554 554 554 554 554 554 554 554 554 514 541 514 514 514 514 514 541 514 514 514 514 514 514 514 552 552 522 513 513 513 513 513 513 544 545 545 545 545 545 545 545 545 545 544
521 523 601 601 601 601 601 601 601 601 601 601 601 601 601 601 601 601 601 601 601 601 601 601 601 601 601 601 601 601 601 601 601 521 513 513 513 513 513 513 513 513 513 513 513 513 513 513 513 513 513
528 736 736 736 736 736 736 736 736 736 736 736 736 736 736 736 736 736 736 736 736 736 736 736 736 736 736 736 736 736 736 736 736 528 513 513 513 513 513 513 513 513 513 513 513 513 513 513 513 513 513
544 545 545 545 545 545 545 545 545 545 545 545 545 545 545 545 545 545 545 545 545 545 545 545 545 545 545 545 545 545 545 545 545 544 513 513 513 513 513 513 513 513 513 513 513 513 513 513 513 513 513