AquaHideout_B2F_Layout (34x24)
513 513 513 513 513 513 529 595 596 537 537 691 692 693 529 537 537 691 692 693 555 556 557 558 537 537 555 556 557 558 537 537 537 529
513 513 513 513 513 513 521 603 604 560 561 699 700 701 522 545 545 699 700 701 563 564 565 566 545 545 563 564 565 566 545 545 545 522
529 736 691 692 693 736 529 611 612 568 569 710 553 711 522 553 553 710 553 711 571 572 573 574 553 553 571 572 573 574 553 553 553 522
522 545 699 700 701 545 522 619 620 673 552 552 552 552 522 553 552 552 552 552 579 580 581 582 673 552 579 580 581 582 673 552 552 522
522 553 710 553 711 553 522 553 552 552 552 552 552 552 522 553 552 552 552 552 587 588 589 590 673 552 587 588 589 590 673 552 552 522
522 553 552 552 552 552 522 553 552 552 514 577 578 514 522 553 552 552 552 552 552 597 598 673 552 552 552 597 598 673 552 552 552 522
522 553 543 543 552 552 522 553 552 552 514 585 586 517 522 553 552 642 643 552 552 554 554 681 552 552 552 554 554 681 552 552 552 522
522 553 559 559 543 552 522 553 552 552 514 541 514 514 522 553 552 648 649 673 552 642 643 552 552 642 643 552 642 643 552 552 552 522
522 553 567 567 559 735 522 553 735 552 514 514 514 514 522 553 552 656 657 673 560 648 649 673 552 648 649 562 648 649 673 735 552 522
521 523 601 601 601 601 521 523 601 601 601 601 601 601 521 553 552 554 554 681 568 656 657 673 552 656 657 570 656 657 673 552 552 522
529 736 736 736 736 736 528 736 736 736 736 736 736 736 529 553 552 552 552 552 552 554 554 681 552 554 554 681 554 554 681 552 552 522
522 545 545 545 545 545 544 560 561 562 545 545 545 545 522 553 552 552 552 552 552 552 552 552 552 552 552 552 552 552 552 552 552 522
522 553 553 553 553 553 531 568 569 570 553 553 553 553 522 553 552 552 552 552 552 552 552 543 552 552 552 552 552 552 552 552 552 521
522 553 552 552 552 552 552 552 552 552 552 552 735 552 521 553 552 552 735 552 552 552 543 551 542 601 601 601 601 601 601 601 601 529
522 553 552 552 552 552 552 552 552 552 552 552 552 552 528 553 552 552 552 552 552 543 551 559 528 736 736 736 736 736 736 736 736 522
522 654 617 617 617 617 617 617 617 617 617 617 617 614 544 553 552 552 552 552 552 559 559 559 544 545 545 545 545 545 545 545 545 522
522 384 393 393 393 393 393 393 393 393 393 393 393 385 531 654 617 617 617 617 617 617 617 606 531 553 553 553 553 553 553 553 553 522
522 400 342 342 342 342 342 342 342 342 368 368 368 410 393 393 393 393 393 393 393 393 385 678 673 552 552 552 552 552 552 735 552 522
522 400 327 327 327 327 327 327 327 342 342 342 342 342 342 342 342 368 368 368 368 368 402 633 673 552 552 552 552 543 543 543 543 522
522 400 327 327 327 327 327 327 327 327 327 327 327 327 327 327 342 342 342 342 342 368 402 554 681 552 552 552 552 551 551 559 559 522
522 400 327 327 327 327 327 327 327 327 327 327 327 327 327 327 327 327 327 327 342 368 402 661 665 552 552 552 552 559 559 553 735 522
521 400 327 327 327 327 327 327 327 327 327 327 327 327 327 327 327 327 327 327 342 368 402 678 652 601 601 601 601 523 523 523 601 521
528 400 327 327 327 327 327 327 327 327 327 327 327 327 327 327 327 327 327 327 342 368 402 610 528 736 736 736 736 736 736 736 736 528
544 654 617 617 617 617 617 617 617 617 617 617 617 617 617 617 617 617 617 617 617 617 617 618 544 545 545 545 545 545 545 545 545 544