AquaHideout_1F_Layout (28x30)
513 513 513 513 513 529 595 596 537 537 540 539 537 595 596 537 537 537 537 537 537 707 708 709 538 537 529 513
513 513 513 513 513 521 603 604 562 561 548 547 545 603 604 560 545 562 561 545 545 715 716 717 546 543 522 513
513 529 537 537 537 528 611 612 570 569 553 553 553 611 612 568 553 570 569 553 553 710 553 711 553 551 522 513
513 522 545 545 545 544 619 620 673 552 552 552 552 619 620 673 552 552 552 552 552 552 552 552 552 567 522 513
513 522 543 543 543 531 553 552 552 552 552 552 552 552 552 552 552 552 552 552 552 552 552 552 552 553 522 513
513 522 551 559 559 673 552 552 605 617 617 617 617 617 617 617 617 617 617 606 665 552 552 552 552 552 522 513
513 522 559 551 559 673 552 552 608 369 369 369 369 369 369 369 369 369 369 676 673 552 552 552 552 552 522 513
513 522 551 559 689 681 552 552 608 369 368 368 368 368 368 368 368 368 369 676 673 552 552 552 552 552 522 513
513 522 559 689 681 552 552 552 616 617 617 617 617 617 617 617 617 617 617 684 673 552 552 552 552 543 522 513
513 522 553 681 552 552 552 552 554 554 554 554 554 554 554 554 554 554 554 554 681 552 552 552 552 551 522 513
513 522 553 552 552 552 552 552 552 552 552 552 552 552 552 552 552 552 552 552 552 552 552 552 552 559 522 513
513 522 553 552 552 605 617 617 617 617 617 617 614 552 552 613 617 617 617 617 617 617 606 665 552 551 522 513
513 522 553 552 552 608 116 124 124 124 124 124 124 175 207 124 124 124 124 124 124 137 676 673 552 559 522 513
513 522 553 552 552 608 117 384 393 393 393 393 393 393 393 393 393 393 393 393 385 115 676 673 552 554 522 513
513 522 553 552 552 608 117 400 368 368 368 368 368 368 368 368 368 368 368 368 402 115 676 673 552 552 522 513
513 522 650 643 552 608 117 400 368 368 368 368 368 368 368 368 368 368 368 368 402 115 676 673 552 552 522 513
513 522 648 649 673 682 117 400 368 368 368 368 368 368 368 368 368 368 368 368 402 115 633 673 552 552 522 513
513 522 656 657 673 554 685 669 669 669 372 368 368 368 368 368 370 669 669 669 669 669 554 681 552 552 522 513
513 522 553 554 681 552 552 669 669 669 117 377 368 368 368 376 115 669 669 669 669 669 552 552 642 643 522 513
513 522 553 552 552 662 116 124 124 124 125 400 368 368 368 402 123 124 124 124 124 137 661 665 648 649 522 513
513 522 553 552 552 608 117 384 393 393 393 408 368 368 368 410 393 393 393 393 385 115 676 673 656 657 522 513
513 522 553 552 552 608 117 400 368 368 368 368 368 368 368 368 368 368 368 368 402 115 676 673 554 554 522 513
513 522 650 643 552 608 117 400 368 368 368 368 368 368 368 368 368 368 368 368 402 115 676 673 552 552 522 513
513 522 648 649 673 608 117 400 368 368 368 368 368 368 368 368 368 368 368 368 402 115 676 673 642 643 522 513
513 522 656 657 673 682 117 400 368 368 368 368 368 368 368 368 368 368 368 368 402 115 633 673 648 649 522 513
513 522 553 554 681 554 685 669 669 669 669 372 368 368 368 370 669 669 669 669 669 669 554 681 656 657 522 513
513 522 553 552 552 552 552 669 669 669 669 117 377 368 376 115 669 552 552 552 552 552 552 552 554 554 522 513
513 522 621 621 621 621 621 621 621 621 623 117 400 615 402 115 622 621 621 621 621 621 621 621 621 621 522 513
513 522 113 113 113 113 113 113 113 113 117 191 712 713 714 190 115 113 113 113 113 113 113 113 113 113 522 513
513 191 108 108 108 108 108 108 108 108 191 108 108 108 108 108 190 108 108 108 108 108 108 108 108 108 190 513