BattleTower_Lobby_Layout (14x9)
521 521 521 521 521 542 518 543 521 521 521 640 521 521
529 529 529 520 529 550 526 551 529 520 529 4 529 529
516 515 515 528 516 631 515 631 515 528 516 641 515 515
525 553 512 528 525 512 512 512 512 528 525 553 512 512
525 553 512 536 642 524 512 522 523 537 525 553 512 552
525 553 512 544 531 532 512 530 531 545 525 553 512 560
525 553 512 514 515 515 512 514 515 515 517 553 512 568
622 607 512 512 512 512 512 512 512 512 512 512 607 607
630 615 512 512 512 512 534 535 512 512 512 512 615 615