BattleTower_Corridor_Layout (17x5)
557 540 558 557 540 558 554 555 518 556 554 557 540 558 557 540 558
565 548 566 565 548 566 562 563 526 564 562 565 548 566 565 548 566
516 515 515 515 515 515 515 631 515 631 515 515 515 515 515 515 515
622 553 553 553 553 553 553 553 553 553 553 553 553 553 553 553 607
630 512 512 512 512 512 512 623 512 623 512 512 512 512 512 512 615