BattleTower_Outside_Layout (29x30)
368 368 368 368 368 368 368 370 640 585 586 586 632 633 634 635 610 586 586 608 641 372 368 368 368 368 368 368 368
368 368 368 368 368 370 401 190 640 585 586 586 632 633 634 635 610 586 586 608 641 191 401 372 368 368 368 368 368
368 368 368 370 401 190 107 211 626 585 586 586 632 633 634 635 610 586 586 608 627 212 109 191 372 368 368 368 368
368 370 401 238 107 190 115 1 618 585 586 586 632 633 634 635 610 586 586 608 619 1 212 109 191 372 368 368 368
376 115 113 238 115 107 211 1 584 585 586 586 632 633 634 635 610 586 586 608 609 513 513 117 109 191 372 368 368
402 115 107 190 115 115 514 514 584 585 586 586 632 633 634 635 610 586 586 608 609 519 519 117 117 113 117 372 368
402 115 115 113 115 115 514 1 584 585 586 586 587 588 589 590 591 586 586 608 609 513 519 117 117 113 117 117 377
402 115 115 113 115 115 1 1 592 593 594 594 595 596 597 598 599 594 594 616 617 513 513 117 117 113 117 117 377
402 115 115 107 190 115 514 1 600 601 602 602 603 604 605 606 607 602 602 624 625 513 519 117 117 113 117 117 400
402 115 115 115 113 115 1 1 1 631 623 513 611 612 613 614 615 513 513 513 513 513 513 117 117 113 117 117 400
402 115 115 115 113 115 514 1 1 514 631 623 519 620 621 622 519 513 513 519 513 513 519 117 117 116 125 117 400
402 115 115 115 113 115 1 1 1 1 1 1 1 628 629 630 1 1 1 1 1 1 116 125 117 117 113 117 400
402 115 115 115 113 123 137 1 1 1 1 1 514 636 637 638 514 1 1 1 1 1 117 116 125 117 116 125 400
402 115 115 123 137 113 115 1 1 1 1 1 1 1 1 1 3 1 1 1 1 116 125 117 113 117 117 384 408
402 115 123 137 115 113 123 137 514 514 1 1 1 1 1 1 1 1 1 514 514 117 116 125 116 125 117 400 368
402 123 137 115 123 124 137 123 137 514 514 514 1 1 1 1 1 514 514 514 116 125 117 113 117 113 117 400 368
410 385 115 123 137 113 115 113 123 124 124 124 124 175 207 207 124 124 124 124 125 116 125 113 117 113 117 400 368
368 402 123 137 123 137 123 124 124 169 169 169 169 175 207 207 169 169 169 169 169 125 113 113 117 113 117 400 368
368 410 385 115 113 115 113 113 113 113 116 169 169 175 207 207 169 169 137 113 113 113 116 124 125 116 125 400 368
368 368 402 115 113 123 124 124 124 124 125 113 93 94 94 94 95 113 123 124 124 124 125 113 113 117 384 408 368
368 368 402 123 124 169 169 169 169 169 169 124 93 94 94 94 95 124 169 169 169 169 169 124 124 125 400 368 368
368 368 410 393 393 393 393 393 393 393 393 393 93 94 94 94 95 642 393 393 393 393 393 393 393 393 408 368 368
368 368 368 368 368 368 368 368 368 368 368 368 93 94 94 94 94 86 86 86 86 86 86 87 368 368 368 368 368
368 368 368 368 368 368 368 368 368 368 368 368 93 94 94 94 94 94 94 94 94 94 94 95 646 368 368 368 368
368 368 368 368 368 368 368 368 368 368 368 368 643 644 644 644 644 644 644 648 649 644 644 645 646 368 368 368 368
368 368 368 368 368 368 368 368 368 368 368 368 651 652 652 652 652 652 652 652 652 652 652 653 646 368 368 368 368
368 368 368 368 368 368 368 368 368 368 368 368 368 368 368 368 368 368 368 368 368 368 368 368 368 368 368 368 368
368 368 368 368 368 368 368 368 368 368 368 368 368 368 368 368 368 368 368 368 368 368 368 368 368 368 368 368 368
368 368 368 368 368 368 368 368 368 368 368 368 368 368 368 368 368 368 368 368 368 368 368 368 368 368 368 368 368
368 368 368 368 368 368 368 368 368 368 368 368 368 368 368 368 368 368 368 368 368 368 368 368 368 368 368 368 368