BattleTower_BattleRoom_Layout (10x9)
559 559 559 588 589 589 590 559 559 559
575 567 567 596 597 597 598 567 567 575
583 572 572 572 572 572 572 572 572 533
571 570 584 578 585 586 578 587 570 570
571 570 580 592 593 594 595 581 570 570
571 570 580 600 601 602 603 581 570 570
571 570 580 608 609 610 611 581 570 570
638 570 576 579 561 569 579 577 570 574
639 570 570 570 534 535 570 570 570 582