CableCarStation_Layout (13x12)
537 536 537 760 760 537 536 537 760 760 537 536 537
545 544 545 768 768 545 544 545 768 768 545 544 545
755 754 755 755 755 755 754 755 755 755 755 754 755
761 761 761 761 761 761 761 761 761 761 761 761 761
776 776 756 757 776 777 758 778 776 776 776 776 776
784 784 784 784 784 785 752 786 784 784 784 784 784
792 792 792 792 792 793 752 794 792 792 792 792 792
771 800 800 800 800 801 752 802 800 800 800 800 762
779 752 752 752 752 752 752 752 752 752 752 752 770
787 752 752 752 752 752 752 752 752 752 752 752 763
795 752 752 752 752 752 752 752 752 752 752 752 752
803 752 752 752 752 752 518 519 752 752 752 752 752