CaveOfOrigin_B4F_Layout (19x19)
796 809 809 809 809 809 809 809 809 809 809 809 809 809 809 809 809 809 797
799 819 796 809 809 809 809 809 809 809 809 809 809 809 809 809 797 819 842
802 819 802 819 819 819 819 819 819 819 819 819 819 819 819 819 800 819 800
802 796 810 819 796 809 809 809 809 809 809 809 809 809 797 819 808 797 800
802 802 819 796 810 796 809 809 809 809 809 809 832 797 808 797 819 800 800
802 802 819 802 796 810 795 795 795 795 795 795 833 808 797 800 819 842 800
802 802 819 802 799 795 795 795 796 809 797 795 795 795 800 800 819 800 800
802 802 819 802 802 795 795 796 837 334 836 797 795 795 800 800 819 800 800
802 802 819 802 802 795 796 837 334 335 334 836 797 795 800 800 819 800 800
802 802 819 802 802 795 839 334 335 335 335 334 838 795 800 800 819 844 800
802 802 819 799 802 795 839 334 335 335 335 334 838 795 800 800 819 800 800
802 802 819 802 802 795 804 831 334 335 334 830 804 795 800 798 819 800 800
802 845 819 802 804 794 795 804 831 334 830 804 795 792 804 800 819 800 800
802 802 819 804 791 802 795 795 804 834 804 795 795 800 783 804 819 800 800
802 804 791 819 802 804 818 818 818 818 818 818 818 804 800 819 783 804 800
802 819 802 819 804 818 818 818 818 818 818 818 818 818 804 819 798 819 800
802 819 804 818 818 818 818 791 819 819 819 783 818 818 818 818 804 819 800
802 819 819 819 819 819 819 804 818 818 818 804 819 819 819 819 819 819 800
804 818 818 818 818 818 818 818 791 819 783 818 818 818 818 818 818 818 804