CaveOfOrigin_B2F_Layout (21x21)
796 809 809 809 809 809 797 803 803 803 796 809 809 809 809 797 803 803 796 809 797
802 803 803 803 803 803 808 809 809 809 810 796 809 809 797 808 809 809 810 803 800
802 803 796 809 809 809 809 809 809 809 809 810 803 803 808 809 809 809 809 797 800
802 803 802 803 803 796 809 809 809 809 809 809 809 809 809 809 797 803 803 800 800
802 803 802 803 803 802 796 809 809 809 809 809 809 809 809 797 808 797 803 800 800
802 796 810 796 809 810 802 795 795 795 795 795 795 795 795 808 797 800 803 800 800
802 802 803 802 796 809 810 795 795 795 795 795 795 795 795 795 800 800 783 805 800
802 802 803 802 802 795 795 795 792 818 818 794 795 795 795 795 800 800 800 803 800
802 802 803 802 802 795 795 792 805 803 803 805 794 795 795 795 800 800 800 783 805
802 802 803 802 802 795 795 800 803 803 803 803 805 794 795 795 800 800 800 800 803
802 802 803 802 802 828 795 800 803 803 803 803 803 802 795 795 800 800 800 800 803
802 802 803 802 805 818 818 805 803 803 803 803 803 802 795 795 800 800 800 800 803
802 805 791 805 818 791 803 803 803 803 803 796 809 810 795 795 800 800 800 800 803
802 803 802 803 803 802 803 796 809 809 809 810 795 795 795 795 800 800 800 808 797
802 803 802 803 803 802 803 802 829 795 795 795 795 795 795 792 818 800 800 803 800
802 803 802 803 803 805 791 802 795 795 795 795 795 795 792 805 803 800 800 803 800
802 803 802 803 803 803 802 805 818 818 818 818 818 818 805 783 818 805 808 797 800
802 803 802 803 803 803 805 818 818 818 818 818 818 818 818 805 803 803 803 800 800
802 803 805 818 818 818 791 803 803 783 818 818 818 818 818 818 791 803 803 800 800
805 818 818 818 791 803 805 818 818 805 803 803 803 803 803 803 805 818 818 805 800
803 803 803 803 805 818 818 818 818 818 818 818 818 818 818 818 818 818 818 818 805