CaveOfOrigin_Entrance_Layout (19x26)
819 819 819 819 819 819 819 819 819 819 819 819 819 819 819 819 819 819 819
819 819 819 819 819 819 796 809 809 809 809 809 809 797 819 819 819 819 819
819 819 796 809 809 809 810 796 809 809 809 797 819 808 809 809 797 819 819
819 819 802 796 809 809 809 810 819 819 819 808 809 809 809 797 800 819 819
819 819 802 802 796 809 809 809 813 814 815 809 809 797 819 800 808 797 819
819 819 802 802 802 819 796 809 821 822 823 809 797 800 819 800 819 800 819
819 796 810 802 802 819 802 795 819 819 819 795 800 800 819 808 797 800 819
819 802 819 802 802 819 802 795 819 819 819 795 800 800 819 819 800 800 819
819 802 819 802 802 819 802 795 819 819 819 795 800 800 819 819 800 800 819
819 802 819 802 802 819 802 795 819 819 819 795 800 808 797 819 800 808 797
796 810 796 810 802 819 802 795 819 819 819 795 800 819 800 819 800 819 800
802 819 802 819 802 819 802 795 819 819 819 795 800 819 800 819 800 819 800
802 819 802 819 802 819 802 795 819 819 819 795 800 819 808 797 800 819 800
802 819 802 819 802 819 802 795 819 819 819 795 800 819 819 800 800 819 800
802 819 802 819 802 819 802 795 819 819 819 795 800 819 819 800 808 797 800
802 796 810 819 802 819 802 795 819 819 819 795 800 819 819 800 819 800 800
802 802 819 819 802 819 802 795 819 819 819 795 800 819 819 800 819 800 800
802 802 819 819 802 819 802 795 819 819 819 795 800 819 783 804 819 800 800
802 802 819 796 810 819 802 795 819 819 819 795 800 819 800 819 819 800 800
802 802 819 802 819 819 802 795 819 819 819 795 800 819 800 819 819 800 800
802 802 819 802 819 819 802 795 819 803 819 795 800 819 800 819 819 800 800
802 805 791 802 819 819 804 818 824 825 826 818 804 819 800 819 819 800 800
802 819 802 804 818 818 818 791 819 819 819 783 818 818 804 819 819 800 800
802 819 802 819 819 819 819 804 818 818 818 804 819 819 819 819 819 800 800
802 819 804 818 818 818 818 818 818 818 818 818 818 818 818 818 818 804 800
804 818 818 818 818 818 818 818 791 819 819 819 783 818 818 818 818 818 804