CaveOfOrigin_B1F_Layout (23x23)
819 819 796 809 809 809 809 809 809 809 809 809 809 809 809 809 809 809 809 797 819 819 819
819 819 802 819 819 796 809 809 809 797 819 819 819 819 796 809 809 809 797 800 819 819 819
819 819 802 819 819 802 819 819 819 808 809 809 809 809 810 819 819 819 800 808 797 819 819
796 809 810 819 819 802 819 796 809 809 809 809 809 809 809 809 797 819 808 797 800 819 819
802 819 819 796 809 810 819 802 796 809 809 809 809 809 809 797 808 797 819 800 800 819 819
802 819 819 802 819 819 819 802 802 795 795 795 795 828 795 808 797 800 819 800 800 819 819
802 819 796 810 819 819 819 802 802 795 795 795 795 795 795 795 800 800 819 800 800 819 819
802 819 802 819 819 819 819 805 805 794 795 795 795 795 795 795 800 800 819 800 800 819 819
802 819 802 819 819 819 819 819 819 805 818 794 795 795 795 795 800 800 819 800 800 819 819
802 796 810 796 809 809 809 797 819 819 819 805 794 795 795 795 800 800 783 818 800 819 819
802 802 819 802 796 809 797 808 797 819 819 819 802 794 795 795 800 800 800 819 800 819 819
802 802 819 802 802 829 808 797 800 819 819 819 802 802 795 795 800 800 800 819 800 819 819
802 802 819 802 802 795 795 800 800 819 819 796 810 802 795 795 800 800 800 819 800 819 819
802 802 819 802 802 795 795 800 808 809 809 810 796 810 795 795 800 800 800 819 800 819 819
802 802 819 802 802 795 795 808 809 809 809 809 810 795 795 795 800 800 800 819 800 819 819
802 802 819 802 802 795 795 795 795 795 795 795 795 795 795 795 800 800 808 797 800 819 819
802 802 819 802 805 794 795 795 795 795 795 795 795 795 795 792 805 800 819 800 800 819 819
802 802 819 802 819 805 794 795 795 795 795 795 795 795 792 805 819 800 819 800 800 819 819
802 802 819 805 791 819 805 818 818 818 818 818 818 818 805 783 818 805 819 800 800 819 819
802 805 791 819 805 818 818 818 818 818 818 818 818 818 818 805 819 783 818 805 800 819 819
802 819 805 818 791 819 819 783 818 818 818 818 818 818 791 819 819 800 819 819 800 819 819
805 791 819 819 805 818 818 805 819 819 819 819 819 819 805 818 818 805 783 818 805 819 819
819 805 818 818 818 818 818 818 818 818 818 818 818 818 818 818 818 818 805 819 819 819 819