CaveOfOrigin_1F_Layout (23x23)
796 809 809 809 809 809 809 809 809 809 809 809 809 809 809 809 809 809 809 809 809 809 797
802 819 819 819 819 819 819 819 819 796 809 809 809 809 797 819 819 819 819 819 819 819 800
802 796 809 809 809 809 809 809 809 810 819 819 819 819 808 809 809 809 809 809 809 797 800
802 802 819 819 796 809 809 809 809 809 809 809 809 809 809 809 809 809 797 819 819 800 800
802 802 819 796 810 819 819 819 796 809 809 809 809 809 809 809 809 797 800 819 819 800 800
802 802 819 802 819 796 809 809 810 795 795 795 795 795 829 795 795 800 800 819 819 800 800
802 802 819 802 796 810 795 795 795 795 795 795 795 795 795 795 795 800 800 819 819 800 800
802 804 791 802 802 795 795 795 795 795 795 795 795 795 792 818 818 804 800 819 819 800 800
802 819 802 802 802 795 795 795 795 795 792 818 818 818 804 819 819 819 800 819 819 800 800
802 819 802 802 802 795 795 795 795 792 804 819 819 819 819 819 819 819 800 819 783 804 800
802 819 802 802 802 795 795 795 792 804 819 819 819 819 819 819 819 819 808 797 800 819 800
802 819 802 802 802 795 795 795 800 819 819 819 819 819 819 819 819 819 819 800 800 819 800
802 819 802 802 802 795 795 795 800 819 819 819 819 819 819 819 819 819 819 800 800 819 800
802 819 802 802 802 795 795 795 808 809 797 819 819 819 796 809 809 809 797 800 800 819 800
802 796 810 802 802 795 795 795 795 795 808 809 809 809 810 795 795 795 800 800 800 819 800
802 802 819 802 802 795 795 795 795 795 795 795 795 795 795 795 795 795 800 800 800 819 800
802 802 819 802 804 794 795 795 795 795 795 795 795 795 795 795 795 792 804 800 800 819 800
802 802 819 802 819 804 794 795 795 795 795 827 795 795 795 795 792 804 819 800 800 819 800
802 802 819 804 791 819 804 818 818 818 824 825 826 818 818 818 804 792 818 804 800 819 800
802 804 791 819 804 818 818 818 818 818 818 818 818 818 818 818 818 804 819 819 800 783 804
802 819 802 819 819 783 818 818 818 818 818 791 819 819 819 783 818 818 818 818 804 800 819
802 819 804 818 818 804 819 819 819 819 819 804 818 818 818 804 819 819 819 783 818 804 819
804 818 818 818 818 818 818 818 818 818 818 818 818 818 818 818 818 818 818 804 819 819 819