ContestLobby_Layout (15x7)
603 604 605 714 715 590 715 714 589 714 714 714 714 714 714
611 612 613 716 610 598 610 716 4 610 610 713 610 596 610
544 545 545 720 721 722 723 724 597 545 545 545 545 545 546
552 608 608 728 729 730 731 732 614 608 733 608 608 608 569
552 608 608 710 607 607 607 607 615 608 608 608 608 608 577
552 608 608 608 608 608 608 608 608 608 608 608 733 608 569
552 608 608 608 608 516 517 608 608 608 608 608 608 608 577