ContestHall_Layout (21x18)
559 559 559 559 559 559 559 559 559 559 559 559 559 559 559 559 559 559 559 559 559
529 529 529 529 622 529 529 529 529 529 622 529 529 529 529 529 622 529 529 529 529
531 531 531 531 640 531 531 531 531 531 640 531 531 531 531 531 640 531 531 531 531
610 610 610 610 610 610 610 610 610 610 610 610 610 610 610 610 610 610 610 610 610
544 545 545 545 545 545 545 545 545 545 545 545 545 545 545 545 545 545 545 545 546
552 608 608 524 525 525 525 525 525 525 525 525 525 525 525 525 525 526 614 608 554
552 608 608 548 549 549 549 549 549 549 549 549 549 549 549 549 549 550 614 608 554
552 608 608 548 549 549 616 617 617 617 617 617 617 617 618 549 549 550 614 608 554
552 608 608 548 549 549 624 625 625 625 625 625 623 625 626 549 549 550 614 608 554
552 608 608 548 549 549 624 625 625 625 641 625 631 625 626 549 549 550 614 608 554
552 608 608 548 549 549 624 625 625 625 649 625 625 625 626 549 549 550 614 608 554
552 608 608 548 549 549 624 625 625 625 625 625 625 625 626 549 549 550 614 608 554
552 608 608 548 549 549 632 633 633 619 620 621 633 633 634 549 549 550 614 608 554
552 608 608 532 533 533 533 533 533 627 628 629 533 533 533 533 533 534 614 608 554
552 608 608 540 541 541 541 541 537 627 628 629 537 541 541 541 541 542 614 608 554
552 608 608 710 607 607 607 607 607 607 607 607 607 607 607 607 607 607 615 608 554
552 608 586 608 608 586 608 608 608 608 608 608 608 608 608 586 608 608 586 608 554
552 608 594 608 608 594 608 608 608 608 516 517 608 608 608 594 608 608 594 608 554