DewfordTown_Layout (20x20)
579 529 530 524 524 525 292 292 292 292 292 293 368 378 579 579 579 569 579 569
579 531 532 532 532 533 292 292 292 292 292 293 368 378 579 570 579 579 579 579
570 526 543 541 542 527 292 292 292 292 292 293 368 378 579 569 579 579 570 579
569 534 551 549 550 535 292 292 292 292 292 293 368 378 579 579 570 579 569 570
579 292 3 292 292 292 292 292 292 569 569 293 368 378 579 579 569 579 579 569
570 292 292 292 292 292 292 523 524 530 536 293 368 378 570 570 570 579 579 579
292 292 292 292 292 292 292 531 532 532 533 293 368 386 121 121 137 570 570 570
292 515 516 517 518 292 292 526 541 542 527 293 368 368 368 368 386 121 121 121
292 80 81 82 83 292 292 534 549 550 535 293 368 368 368 368 368 368 368 368
292 88 89 90 91 292 292 292 292 292 292 552 553 553 368 368 368 368 368 368
292 521 97 98 522 292 292 292 292 292 3 560 561 561 283 284 284 284 284 284
292 292 292 292 292 292 292 292 292 292 292 318 284 284 317 292 523 524 524 525
292 292 292 292 292 292 292 292 292 292 292 292 292 292 292 292 531 532 532 533
292 292 292 292 292 538 539 539 539 539 540 292 292 292 292 292 526 541 542 527
569 292 292 292 292 546 547 547 547 547 548 292 292 292 292 292 534 549 550 535
579 292 292 292 292 555 556 557 435 558 559 520 292 292 292 292 292 292 226 569
579 292 292 292 292 563 564 565 453 566 567 528 292 292 292 292 292 292 292 579
570 569 292 292 292 571 572 573 461 574 575 292 292 292 292 292 569 569 569 570
569 579 569 292 292 292 292 292 292 292 292 292 292 226 569 569 570 579 579 226
579 579 579 569 569 569 569 569 569 569 569 569 569 569 579 579 569 579 579 569