DewfordTown_Gym_Layout (18x28)
520 544 544 544 544 544 544 544 544 544 544 544 544 544 544 544 544 521
522 523 523 523 523 523 523 523 523 523 543 531 531 531 531 531 531 529
522 523 523 523 523 523 523 523 523 523 524 539 539 539 539 539 539 541
522 523 523 523 523 523 523 523 523 523 524 527 553 554 554 554 527 541
522 523 523 523 523 523 523 523 523 523 524 534 555 569 570 513 534 541
528 531 531 531 531 531 531 531 531 531 571 568 548 513 513 513 564 537
541 539 539 539 539 539 539 539 539 539 522 551 561 513 513 514 550 524
541 556 557 558 559 547 547 557 559 547 522 523 524 555 513 522 523 524
541 555 522 523 524 555 513 522 524 555 522 523 524 555 513 522 523 524
541 555 522 523 524 555 513 522 524 555 530 531 532 555 513 522 523 524
536 567 550 523 524 555 513 522 524 555 538 539 540 555 513 522 523 524
522 523 523 523 524 555 513 522 551 567 565 558 558 566 515 550 523 524
522 543 531 531 532 555 513 522 523 523 523 523 523 523 523 523 523 524
522 524 539 539 540 555 513 530 531 531 531 531 531 531 531 531 542 524
522 524 556 557 559 548 513 538 539 539 539 539 539 539 539 539 522 524
522 524 555 522 524 555 513 564 558 558 558 559 547 557 558 558 550 524
522 524 555 522 524 555 513 522 523 523 523 524 555 522 523 523 523 524
522 551 567 550 524 555 513 522 523 523 523 524 555 522 523 523 523 524
522 523 523 523 551 567 515 572 531 542 523 524 555 522 523 523 523 524
522 543 531 542 523 523 523 524 539 522 523 524 555 522 523 523 523 524
522 524 539 530 531 531 531 532 556 530 531 532 555 522 523 523 523 524
522 524 556 538 539 539 539 540 555 538 539 540 555 522 523 523 523 524
522 551 561 546 547 547 547 547 562 565 558 559 548 522 523 523 523 524
522 523 551 561 517 513 513 517 522 523 523 524 555 522 523 523 523 524
522 523 523 524 525 555 513 525 522 523 523 551 567 550 523 523 523 524
522 523 523 551 568 548 513 564 550 523 523 523 523 523 523 523 523 524
530 531 531 531 532 513 513 530 531 531 531 531 531 531 531 531 531 532
538 539 539 539 540 518 519 538 539 539 539 539 539 539 539 539 539 540