DewfordTown_Hall_Layout (17x9)
517 646 647 517 517 519 517 637 517 560 760 517 517 519 519 517 517
617 654 655 525 525 527 525 645 525 542 768 525 525 527 527 525 525
625 662 663 548 548 548 548 548 548 568 768 548 548 635 636 548 548
569 547 547 547 547 547 547 547 547 547 768 569 555 594 595 556 547
569 547 744 745 746 556 547 547 547 547 768 569 547 762 763 763 763
569 555 752 753 754 547 547 547 547 547 776 569 547 770 771 771 771
569 547 547 547 547 547 547 547 547 547 784 569 547 778 643 644 616
569 547 547 547 547 547 547 547 547 547 557 559 547 549 651 652 624
569 547 547 547 547 520 521 547 547 547 547 547 547 547 547 547 547