DoubleBattleColosseum_Layout (14x9)
616 617 618 618 618 619 620 620 621 618 618 618 623 591
624 625 626 626 626 627 628 628 629 626 626 626 631 599
632 633 634 634 634 635 636 636 637 634 634 634 639 607
640 641 642 588 589 643 644 644 645 589 590 642 646 647
652 650 597 608 597 597 610 611 597 597 609 597 651 653
652 650 597 596 597 597 612 613 597 597 598 597 651 653
652 650 597 608 597 597 614 615 597 597 609 597 651 653
648 649 597 604 605 605 605 605 605 605 606 597 654 655
513 513 513 513 513 545 545 545 545 513 513 513 513 513