EverGrandeCity_PhoebesRoom_Layout (13x14)
527 519 527 519 527 520 520 520 519 527 519 527 519
517 516 517 516 517 513 514 515 516 517 516 517 516
525 524 525 524 525 521 522 523 524 525 524 525 524
578 578 578 578 578 600 600 600 578 578 578 578 578
581 582 604 604 576 579 579 579 580 604 604 583 577
589 590 604 604 584 585 586 587 588 604 604 591 832
597 598 604 604 592 593 594 595 596 604 604 599 833
605 606 604 604 584 601 602 603 588 604 604 599 834
613 614 604 604 584 609 610 611 588 604 604 615 835
621 622 604 604 616 619 619 619 620 604 604 623 608
618 617 617 617 617 617 617 617 617 617 617 617 617
519 527 519 527 520 520 520 520 520 519 527 519 527
725 726 725 726 741 604 604 604 727 725 726 725 726
840 841 840 841 742 612 612 612 735 840 841 840 841