EverGrandeCity_Corridor4_Layout (11x34)
520 520 520 520 520 520 520 520 520 520 520
725 726 725 726 513 836 515 725 726 725 726
524 525 524 525 521 837 523 524 525 524 525
721 721 721 721 721 721 721 721 721 721 721
720 720 720 720 720 720 720 720 720 720 720
732 732 732 728 729 730 730 731 732 732 732
740 740 740 736 737 738 738 739 740 740 740
743 842 743 736 737 738 738 739 743 842 743
743 743 743 736 737 738 738 739 743 743 743
743 842 743 736 737 738 738 739 743 842 743
743 743 743 736 737 738 738 739 743 743 743
743 842 743 736 737 738 738 739 743 842 743
743 743 743 736 737 738 738 739 743 743 743
743 743 743 736 737 738 738 739 743 743 743
743 842 743 736 737 738 738 739 743 842 743
743 743 743 736 737 738 738 739 743 743 743
743 743 743 736 737 738 738 739 743 743 743
743 743 743 736 737 738 738 739 743 743 743
743 842 743 736 737 738 738 739 743 842 743
743 743 743 736 737 738 738 739 743 743 743
743 743 743 736 737 738 738 739 743 743 743
743 743 743 736 737 738 738 739 743 743 743
743 743 743 736 737 738 738 739 743 743 743
743 842 743 736 737 738 738 739 743 842 743
743 743 743 736 737 738 738 739 743 743 743
743 743 743 736 737 738 738 739 743 743 743
743 743 743 736 737 738 738 739 743 743 743
743 743 743 736 737 738 738 739 743 743 743
743 743 743 736 737 738 738 739 743 743 743
743 743 743 736 737 738 738 739 743 743 743
743 743 743 736 737 738 738 739 743 743 743
743 743 743 736 737 738 738 739 743 743 743
743 743 743 736 737 738 738 739 743 743 743
743 743 743 736 737 738 738 739 743 743 743