EverGrandeCity_DrakesRoom_Layout (13x14)
527 519 527 519 527 520 520 520 519 527 519 527 519
517 516 517 516 517 513 514 515 516 517 516 517 516
525 524 525 524 525 521 522 523 524 525 524 525 524
674 674 674 674 674 696 696 696 674 674 674 674 674
718 678 700 700 672 675 675 675 676 700 700 679 677
685 686 700 700 680 681 682 683 684 700 700 687 685
693 694 700 700 688 689 690 691 692 700 700 695 693
701 673 700 700 680 697 698 699 684 700 700 695 701
701 702 700 700 680 705 706 707 684 700 700 703 701
717 710 700 700 712 715 715 715 716 700 700 711 709
714 713 713 713 713 713 713 713 713 713 713 713 713
519 527 519 527 520 520 520 520 520 519 527 519 527
725 726 725 726 741 700 700 700 727 725 726 725 726
840 841 840 841 742 708 708 708 735 840 841 840 841