EverGrandeCity_GlaciasRoom_Layout (13x14)
527 519 527 519 527 520 520 520 519 527 519 527 519
517 516 517 516 517 513 514 515 516 517 516 517 516
525 524 525 524 525 521 522 523 524 525 524 525 524
626 626 626 626 626 648 648 648 626 626 626 626 626
670 630 652 652 624 627 627 627 628 652 652 631 629
637 638 652 652 632 633 634 635 636 652 652 639 637
645 646 652 652 640 641 642 643 644 652 652 647 645
653 625 652 652 632 649 650 651 636 652 652 647 653
653 654 652 652 632 657 658 659 636 652 652 655 653
669 662 652 652 664 667 667 667 668 652 652 663 661
666 665 665 665 665 665 665 665 665 665 665 665 665
519 527 519 527 520 520 520 520 520 519 527 519 527
725 726 725 726 741 652 652 652 727 725 726 725 726
840 841 840 841 742 660 660 660 735 840 841 840 841