EverGrandeCity_SidneysRoom_Layout (13x14)
527 519 527 519 527 520 520 520 519 527 519 527 519
517 516 517 516 517 513 514 515 516 517 516 517 516
525 524 525 524 525 521 522 523 524 525 524 525 524
530 530 530 530 530 552 552 552 530 530 530 530 530
574 534 556 556 528 531 531 531 532 556 556 535 533
541 542 556 556 536 537 538 539 540 556 556 543 541
549 550 556 556 544 545 546 547 548 556 556 551 549
575 570 556 556 536 553 554 555 540 556 556 551 575
557 558 556 556 536 561 562 563 540 556 556 559 557
573 566 556 556 568 571 571 571 572 556 556 567 565
569 529 529 529 529 529 529 529 529 529 529 529 529
519 527 519 527 520 520 520 520 520 519 527 519 527
725 726 725 726 741 556 556 556 727 725 726 725 726
840 841 840 841 742 564 564 564 735 840 841 840 841