EverGrandeCity_HallOfFame_Layout (15x17)
716 717 756 757 756 720 721 721 722 723 756 757 756 718 719
724 725 764 765 764 728 729 729 730 731 764 765 764 726 727
732 733 766 766 766 736 737 737 738 739 766 766 766 734 735
740 741 758 758 758 744 745 746 752 747 758 758 758 742 743
740 741 758 758 758 758 753 754 755 758 758 758 758 742 743
740 741 758 758 758 758 761 762 763 758 758 758 758 742 743
740 741 758 758 758 758 758 758 758 758 758 758 758 742 743
740 741 758 758 758 758 758 758 758 758 758 758 758 742 743
740 741 758 758 758 758 758 758 758 758 758 758 758 742 743
740 741 758 758 758 758 758 758 758 758 758 758 758 742 743
740 741 758 758 758 758 758 758 758 758 758 758 758 742 743
740 741 758 758 758 758 758 758 758 758 758 758 758 742 743
740 741 758 758 758 758 758 758 758 758 758 758 758 742 743
740 741 758 758 758 758 758 758 758 758 758 758 758 742 743
740 741 758 758 758 758 758 758 758 758 758 758 758 742 743
748 749 758 758 758 758 758 758 758 758 758 758 758 750 751
513 513 513 513 513 767 760 760 760 759 513 513 513 513 513