EverGrandeCity_ChampionsRoom_Layout (13x13)
1 744 745 746 746 746 747 746 746 746 750 751 1
744 745 753 754 754 797 798 799 754 754 758 750 751
745 753 761 762 762 805 806 807 762 762 766 758 750
753 761 769 770 770 830 730 831 770 770 774 766 758
761 769 777 778 779 737 738 738 779 781 782 774 766
769 777 785 786 787 787 787 787 787 789 790 782 774
777 752 772 787 787 787 787 787 787 787 773 759 782
752 760 772 787 787 787 787 787 787 787 773 767 759
760 768 792 793 787 787 787 787 787 795 796 775 767
780 776 800 801 802 802 802 802 802 803 804 783 788
756 748 808 809 810 813 814 815 810 811 812 749 757
764 756 828 817 818 821 822 823 818 819 829 757 765
1 764 824 825 818 821 822 823 818 826 827 765 1