EverGrandeCity_PokemonLeague_Layout (19x12)
520 523 523 586 587 523 524 523 691 692 692 693 525 526 523 523 523 523 527
528 546 547 594 595 585 4 531 699 700 700 701 533 534 584 531 531 531 535
627 554 555 519 603 593 548 541 707 708 708 709 542 542 592 637 553 628 629
545 545 545 517 545 601 572 576 576 576 576 576 576 576 600 545 517 545 545
544 518 518 518 518 518 549 576 576 560 563 576 576 576 615 518 518 518 580
544 576 576 576 576 576 576 576 630 635 635 631 576 576 576 576 576 576 551
662 606 514 514 576 576 576 560 635 646 647 635 563 576 576 576 576 606 522
670 614 514 514 576 576 576 568 636 654 655 636 571 576 576 576 550 614 530
544 576 550 573 574 576 576 576 638 636 636 639 576 576 576 573 574 576 551
544 576 564 581 582 550 576 576 576 577 578 576 576 576 576 581 582 564 551
544 576 576 576 564 576 576 576 576 576 576 576 576 576 514 550 564 576 551
552 514 514 576 576 576 576 576 576 515 516 576 576 576 576 576 576 576 567