EverGrandeCity_Layout (40x80)
115 115 115 115 115 115 115 113 113 113 113 113 117 520 513 514 514 514 514 514 514 514 552 561 115 113 113 113 113 113 117 113 117 117 117 117 117 117 1 117
115 115 115 115 115 115 115 113 113 113 113 116 125 578 529 530 530 530 530 530 530 530 568 579 123 137 113 113 113 113 117 113 117 117 117 117 117 2 106 117
115 115 115 115 115 115 115 113 113 116 124 125 113 512 513 514 514 514 514 514 514 514 552 553 113 123 124 137 113 113 117 113 117 117 117 117 114 1 117 117
115 115 115 115 115 115 123 124 124 125 116 145 580 520 521 522 523 524 525 526 527 522 560 561 580 145 137 123 124 124 125 113 117 117 117 117 117 113 117 117
115 115 115 115 115 123 137 113 113 116 122 14 562 528 529 530 531 532 533 534 535 530 568 569 562 610 631 137 113 113 113 116 125 117 117 117 117 113 117 117
115 115 115 115 123 137 123 137 113 114 14 198 562 536 537 538 539 540 541 542 543 538 576 577 562 198 610 112 113 113 113 117 113 117 117 117 117 113 117 190
115 115 115 123 137 120 137 123 121 122 198 198 562 1 544 575 547 548 549 550 551 575 575 546 562 198 198 120 121 121 121 125 116 122 117 117 190 109 117 113
115 115 115 113 115 652 120 137 650 1 22 198 562 1 571 544 515 516 517 518 519 575 575 546 562 198 618 651 650 649 648 116 122 653 117 117 113 117 117 113
115 115 123 137 123 137 652 112 650 650 1 22 562 1 571 571 545 624 625 626 546 575 575 546 562 618 546 652 651 650 649 114 655 654 117 190 109 117 190 109
115 115 113 115 113 115 653 112 651 650 1 1 562 1 571 571 1 573 573 573 546 575 575 546 562 546 546 653 652 651 650 114 14 14 2 109 117 117 113 117
115 123 137 123 137 115 654 112 652 651 650 1 562 1 571 571 1 573 573 573 1 571 571 1 562 1 655 654 653 652 651 114 198 198 14 117 117 117 113 117
123 137 115 113 115 115 655 112 653 652 651 650 562 648 1 584 589 586 586 586 591 588 1 652 562 649 648 655 654 653 652 114 22 198 198 117 117 117 113 117
137 115 123 137 115 115 648 112 654 653 652 651 562 649 648 592 597 594 594 594 599 596 654 653 562 650 649 648 655 654 653 2 106 22 22 117 117 117 113 117
115 123 137 115 115 123 137 115 655 654 653 652 566 666 557 600 605 602 602 602 607 604 555 670 627 667 666 665 664 671 557 653 114 651 650 117 117 117 113 117
115 113 115 115 115 113 115 115 648 655 654 653 563 564 611 608 1 572 573 574 1 612 563 564 564 564 564 564 564 564 611 654 114 652 116 125 117 117 116 125
115 107 190 115 115 113 115 115 649 648 655 654 653 652 562 620 1 572 573 573 615 620 1 3 1 1 652 651 650 649 562 655 114 653 117 116 125 117 117 116
115 115 107 190 123 137 115 115 650 649 648 655 654 653 562 651 1 621 573 573 573 573 573 573 573 573 573 615 651 650 562 648 117 116 125 117 116 125 117 117
115 115 115 113 113 115 115 115 651 650 649 648 655 654 562 652 651 1 621 573 573 573 573 573 573 573 573 574 1 651 562 649 117 114 654 117 117 116 125 117
115 115 123 137 113 115 115 115 652 651 650 649 648 655 562 653 652 651 1 1 1 1 1 1 621 573 573 574 1 652 562 650 117 114 116 125 117 117 116 125
115 123 137 115 113 115 115 115 653 652 651 650 649 648 566 670 669 668 667 666 665 556 559 1 584 585 586 587 588 1 562 651 117 117 117 116 125 117 117 116
123 137 115 115 113 115 115 115 654 653 652 651 650 649 563 564 564 564 564 564 564 564 611 1 592 593 594 595 596 1 562 652 117 117 117 117 116 125 117 117
137 115 115 115 113 115 115 115 655 654 104 105 105 105 105 105 105 105 106 652 651 650 562 1 600 601 602 603 604 1 562 653 117 117 117 117 117 116 125 117
115 115 115 115 113 115 115 115 648 104 190 113 113 113 107 108 108 109 191 105 106 651 562 1 608 572 573 574 612 1 562 654 117 117 117 117 117 117 116 125
115 115 115 123 137 115 115 115 104 190 107 108 108 108 190 113 113 191 108 109 114 652 562 1 620 572 573 574 620 1 562 1 117 117 117 117 117 117 117 116
190 115 115 113 115 115 115 115 115 113 115 113 113 113 113 113 113 113 116 125 114 653 562 571 1 572 573 574 1 571 562 116 125 117 117 117 117 117 117 190
107 190 115 113 115 115 115 115 115 107 190 113 113 113 116 124 124 124 125 116 122 654 570 571 571 572 573 574 571 571 570 117 116 122 117 117 117 117 190 109
115 113 115 107 190 115 115 115 115 115 113 113 113 116 125 113 116 169 159 125 116 121 121 121 121 175 207 207 121 121 580 122 117 662 117 117 117 2 109 117
115 113 115 115 113 115 115 115 115 115 113 113 113 117 113 113 117 116 167 121 122 660 659 1 1 572 573 574 1 658 562 656 117 663 117 117 117 660 117 117
115 107 190 115 107 190 115 115 115 115 113 113 113 117 113 113 117 114 1 1 1 1 1 1 613 573 573 574 1 659 562 657 117 116 122 117 117 661 117 117
115 115 113 115 115 113 115 115 115 115 113 113 113 191 109 113 117 114 1 1 572 573 573 573 573 573 573 623 661 660 562 658 117 114 663 117 117 662 117 117
115 115 113 115 115 113 115 115 115 115 113 113 113 113 191 109 191 191 106 1 621 573 573 573 573 573 623 663 662 661 562 659 117 114 656 117 117 663 117 117
115 115 113 115 115 113 115 115 115 115 113 113 113 113 113 191 109 113 117 106 1 555 556 556 676 675 674 673 672 679 567 660 117 114 1 117 117 116 125 117
115 115 113 115 115 113 115 115 115 123 137 113 107 108 108 109 191 108 191 191 106 563 564 564 564 564 564 564 564 564 565 661 117 117 116 125 117 117 116 125
115 123 137 115 123 137 115 115 115 113 115 107 190 113 113 190 108 109 113 113 191 105 105 105 105 105 106 1 657 656 663 662 117 117 117 116 125 117 117 116
115 113 115 115 113 115 115 115 115 113 115 115 113 113 113 113 113 190 108 108 108 108 109 113 113 113 191 105 106 657 656 663 117 117 117 117 116 125 117 117
123 137 115 123 137 115 115 115 123 137 115 123 124 137 113 113 113 113 113 113 113 113 190 108 108 109 113 113 117 106 657 656 117 117 117 117 117 116 125 117
137 115 115 113 115 115 115 115 113 115 115 113 113 123 124 137 113 113 113 113 113 113 113 113 113 190 108 109 117 117 106 657 117 117 117 117 117 117 116 125
115 115 115 113 115 115 115 120 137 115 123 124 137 113 113 123 124 124 124 137 113 113 113 113 113 113 113 117 117 117 117 116 122 117 117 117 117 117 117 116
115 115 123 137 115 115 115 656 112 123 169 137 115 113 113 113 113 113 113 123 124 124 124 124 137 113 113 117 117 117 117 117 659 117 117 117 117 117 117 117
115 115 113 115 115 115 115 657 120 145 137 115 115 113 113 116 124 124 124 169 169 137 113 113 123 124 124 125 117 117 117 117 660 117 117 117 117 117 117 117
115 123 137 115 115 115 115 658 657 656 112 115 123 124 124 125 116 169 159 169 137 123 124 137 113 113 116 169 125 117 117 117 116 125 117 117 117 117 117 117
123 137 115 115 115 115 123 124 124 137 115 123 169 137 113 116 125 116 167 137 123 169 137 123 124 124 125 116 169 125 117 117 117 116 125 117 117 117 117 117
137 115 115 115 115 123 169 169 137 115 123 169 137 123 124 125 116 122 1 120 145 137 123 169 169 169 169 125 116 169 125 117 117 117 116 125 117 117 117 117
115 115 115 115 123 169 169 137 115 123 169 137 120 145 145 145 122 1 1 3 651 120 145 145 145 169 169 169 125 116 145 125 117 117 117 116 125 117 117 117
115 115 115 123 169 169 137 115 123 145 137 115 652 651 650 649 648 636 1 1 652 651 650 649 648 116 145 145 145 122 662 116 125 117 117 117 116 125 117 117
115 115 123 169 169 137 115 123 137 659 112 115 653 652 651 650 649 636 636 636 653 652 651 650 649 114 72 73 74 75 663 117 116 125 117 117 117 116 125 117
115 123 169 169 137 115 120 137 115 660 112 115 654 653 652 651 650 636 636 636 654 653 652 651 650 114 80 81 82 83 116 125 117 116 122 117 117 117 116 125
123 169 169 137 115 115 1 112 115 661 112 123 137 654 653 652 651 636 636 636 636 654 653 652 651 114 88 89 90 91 117 116 122 114 662 117 117 117 117 116
169 169 137 115 115 120 137 115 120 137 120 137 115 655 654 653 636 637 636 636 636 655 654 653 652 114 96 97 98 99 117 117 663 117 116 125 117 117 117 117
145 137 115 115 115 1 112 115 663 112 662 112 115 648 655 654 636 636 636 636 636 648 655 654 116 122 659 1 657 656 117 117 116 125 117 116 125 117 117 117
1 112 115 115 115 658 112 123 137 123 137 115 115 649 648 655 636 636 636 636 636 636 648 655 114 636 1 1 658 657 117 117 117 116 125 117 116 125 117 117
137 115 115 115 123 137 123 137 123 137 115 115 115 650 649 648 116 121 121 175 207 121 121 121 122 636 636 660 659 116 125 117 117 117 116 125 117 116 125 117
378 115 115 123 137 123 137 120 137 115 115 115 120 137 650 649 114 636 3 636 636 636 636 636 636 636 662 661 660 117 116 125 117 117 117 116 125 117 116 125
378 115 123 137 123 137 112 658 112 115 115 115 656 112 651 650 114 636 636 636 636 636 636 636 636 656 663 662 661 117 117 116 122 117 117 117 116 125 117 116
378 123 137 123 137 115 120 137 115 115 115 115 657 112 652 116 125 116 121 175 207 121 121 137 658 657 656 663 662 117 117 114 659 117 117 117 117 116 125 380
386 137 123 137 115 115 659 112 115 115 115 115 658 120 121 125 116 122 1 1 1 1 1 120 124 124 137 656 663 117 117 114 660 117 117 117 117 117 116 388
368 386 137 115 115 123 137 115 115 115 115 120 137 658 657 116 125 384 393 393 393 393 393 393 393 385 123 137 656 117 117 114 661 117 117 117 117 117 380 368
368 368 378 115 123 137 115 115 115 115 115 1 120 137 116 125 384 408 368 368 368 368 368 368 368 410 385 115 116 125 117 117 116 122 117 117 117 117 380 368
368 368 378 120 137 115 115 115 115 115 123 124 137 115 117 384 408 368 368 368 368 368 368 368 368 368 402 115 117 116 125 117 114 656 117 117 117 117 380 368
368 368 378 1 112 115 115 115 115 123 169 137 115 123 125 400 368 368 368 368 368 368 368 368 368 368 402 123 125 117 116 125 114 657 117 117 117 117 380 368
368 368 386 137 115 115 115 115 123 145 137 115 123 169 169 187 179 179 179 179 179 179 179 179 179 179 188 169 169 125 117 116 122 658 117 117 117 117 380 368
368 368 368 378 115 115 115 123 137 656 112 123 169 169 169 185 185 185 185 185 185 185 185 185 185 185 185 169 169 169 125 114 660 659 117 117 117 117 380 368
368 368 368 378 115 115 120 137 115 657 120 169 169 169 169 185 185 185 185 185 185 185 185 185 185 185 185 169 169 169 169 122 661 116 122 117 117 117 380 368
368 368 368 378 115 115 1 112 123 121 121 169 169 169 169 185 185 185 185 185 185 185 185 185 185 185 185 169 169 169 169 145 121 122 660 117 117 117 380 368
368 368 368 378 115 123 137 115 659 658 657 116 169 169 169 185 185 185 185 185 185 185 185 185 185 185 185 169 169 169 137 656 663 662 661 117 117 117 380 368
373 374 368 378 123 137 115 115 660 659 658 117 116 169 169 185 185 185 185 185 185 185 185 185 185 185 185 169 169 137 123 121 137 663 662 117 117 117 380 368
381 382 368 386 137 115 115 123 124 124 124 125 117 116 169 185 185 185 185 185 185 185 185 185 185 185 185 169 137 120 137 657 120 124 124 125 117 117 380 368
368 368 373 374 378 115 123 124 145 145 145 169 125 117 116 185 185 185 185 185 185 185 185 185 185 185 185 137 136 658 120 124 145 145 145 169 125 117 380 368
368 368 381 382 378 123 145 137 1 661 660 116 145 125 380 193 193 193 193 193 193 193 193 193 193 193 193 378 123 124 145 137 1 657 656 116 145 125 380 368
368 368 368 368 386 137 1 120 121 121 121 122 660 116 388 336 337 368 368 368 368 368 368 368 368 368 368 386 145 137 1 120 121 124 124 122 656 116 388 368
368 368 368 368 368 386 121 137 1 1 662 661 116 388 368 344 345 368 368 368 368 368 368 368 368 368 373 374 368 386 137 1 658 116 145 145 121 388 368 368
368 368 368 368 368 368 368 386 121 121 121 121 388 368 368 373 374 368 368 368 368 368 368 368 368 368 381 382 368 368 386 121 121 388 368 368 368 368 368 368
368 368 368 368 368 368 368 368 373 374 368 368 368 368 368 381 382 368 368 368 368 368 368 368 368 368 368 370 379 372 368 368 368 368 368 368 368 368 368 368
368 368 368 368 368 368 368 368 381 382 336 337 373 374 336 337 368 368 368 368 368 368 368 368 368 368 368 378 113 380 368 368 368 368 368 368 368 368 368 368
368 368 368 368 368 368 368 368 368 368 344 345 381 382 344 345 368 368 368 368 368 368 368 368 368 368 368 386 121 388 368 368 368 368 368 368 368 368 368 368
336 337 368 368 368 368 368 368 368 368 368 368 368 368 368 368 368 368 368 368 368 368 368 368 368 368 368 368 368 373 374 368 368 368 368 368 368 368 368 368
344 345 368 368 368 368 368 368 368 368 368 368 368 368 368 368 368 368 368 370 379 372 368 368 368 368 368 336 337 381 382 368 368 368 368 368 368 368 368 368
368 373 374 336 337 373 374 368 368 336 337 368 368 368 368 368 368 368 368 378 113 380 368 368 368 336 337 344 345 368 368 368 368 368 368 368 368 368 368 368
368 381 382 344 345 381 382 336 337 344 345 336 337 373 374 373 374 336 337 386 121 388 373 379 374 344 345 368 368 368 368 368 368 368 368 368 368 368 368 368
368 368 368 368 368 368 368 344 345 368 368 344 345 381 382 381 382 344 345 368 368 368 381 121 382 368 368 368 368 368 368 368 368 368 368 368 368 368 368 368