FallarborTown_Layout (20x20)
798 798 798 798 798 798 798 798 798 798 798 798 798 798 789 633 633 633 633 633
617 617 617 617 617 617 617 617 617 617 617 617 617 618 797 798 798 798 798 798
617 617 617 617 617 617 617 617 617 617 617 617 618 634 617 617 617 617 617 618
802 803 803 804 706 707 768 769 769 769 770 618 634 617 617 617 617 617 618 634
645 646 646 647 714 715 688 691 691 691 692 634 617 672 673 674 675 618 634 617
653 669 670 655 679 633 776 777 777 777 778 625 625 80 81 82 83 634 617 617
661 677 678 663 633 547 784 785 467 786 787 547 633 88 89 90 91 625 625 625
633 633 633 3 633 547 792 793 475 794 795 547 633 681 97 98 682 633 633 671
671 633 633 633 633 633 3 744 745 746 633 633 633 633 744 746 633 633 633 633
633 744 745 745 745 745 745 753 753 753 745 745 745 745 753 753 745 745 746 633
633 760 761 761 761 761 761 761 761 761 761 753 753 761 761 761 761 761 762 633
633 671 671 671 671 633 633 633 633 633 3 752 754 633 633 671 671 671 671 633
633 633 633 633 633 633 633 633 633 633 633 752 754 633 699 680 680 700 633 633
633 633 633 633 633 633 633 800 801 633 633 752 754 633 48 49 50 51 633 671
633 805 806 807 633 637 638 808 809 633 633 752 754 633 56 57 58 59 518 519
633 813 814 815 633 645 646 646 647 633 671 752 754 633 681 65 66 683 526 628
633 821 822 823 633 653 669 670 655 633 633 752 753 745 745 746 633 671 518 620
519 633 633 633 633 661 677 678 663 633 633 760 761 761 761 762 633 518 627 628
619 519 518 519 679 633 633 633 633 633 633 633 633 633 518 519 518 620 619 620
620 619 620 619 519 518 519 518 519 518 519 518 519 518 627 628 627 628 627 628