FieryPath_Layout (35x38)
625 625 625 625 635 628 628 628 628 628 628 628 636 625 625 625 625 635 628 628 628 628 628 628 628 628 628 628 628 636 625 625 625 625 625
625 625 625 625 626 786 635 628 628 628 636 625 624 625 625 625 625 626 635 628 628 628 628 628 628 628 628 636 625 624 625 625 625 625 625
625 625 625 635 634 635 783 776 776 776 782 636 624 625 625 625 635 634 775 776 776 776 776 776 776 776 776 782 636 624 625 625 625 625 625
625 625 625 626 625 775 776 785 776 776 776 774 624 625 625 625 626 625 775 776 776 776 776 784 776 776 776 776 774 624 625 625 625 625 625
625 625 635 634 625 775 776 776 776 776 784 774 624 625 625 625 626 635 783 776 776 776 776 776 776 776 777 776 774 624 625 625 625 625 625
625 635 634 787 625 775 776 778 780 780 780 638 624 625 625 625 626 775 776 776 785 776 778 780 780 525 526 527 638 638 625 625 625 625 625
625 626 635 628 628 783 776 774 616 780 780 780 638 625 625 625 626 775 776 776 776 778 624 625 625 625 625 625 625 625 625 625 625 625 625
625 626 626 784 776 776 776 774 624 786 625 625 625 625 625 625 626 775 776 784 776 774 624 625 625 625 625 625 625 625 625 625 625 625 625
625 626 626 776 778 779 776 774 624 625 625 625 625 625 625 625 626 775 776 776 776 774 624 625 625 625 625 625 625 625 625 625 625 625 625
625 626 626 776 774 775 784 774 632 628 628 628 628 628 636 625 626 775 776 776 776 774 624 625 625 625 625 625 625 625 625 625 625 625 625
625 626 626 776 782 783 776 782 628 628 628 628 628 636 624 625 626 775 776 776 776 774 624 625 625 625 625 625 625 625 625 625 625 625 625
625 626 626 776 776 776 776 776 776 776 776 785 776 774 624 625 626 775 776 776 785 774 624 625 625 625 625 625 625 625 625 625 625 625 625
625 626 626 785 778 780 780 780 780 779 781 776 778 638 632 628 634 775 776 776 776 774 624 625 625 625 625 625 625 625 625 625 625 625 625
625 626 626 776 774 625 625 625 786 775 781 776 774 625 625 625 625 775 784 776 776 774 624 625 625 625 625 625 625 625 625 625 625 625 625
625 626 626 776 774 616 780 780 618 626 776 776 782 628 628 628 628 783 776 776 776 774 632 636 625 625 625 625 625 625 625 625 625 625 625
625 626 626 776 774 624 625 787 626 626 776 776 776 776 776 776 776 776 776 776 776 774 786 624 625 625 625 625 625 625 625 625 625 625 625
625 626 626 784 774 624 625 625 626 626 784 776 776 778 780 780 780 779 776 776 776 774 625 624 625 625 625 625 625 625 625 625 625 625 625
625 626 626 776 774 624 625 625 626 639 780 780 780 638 616 780 618 775 776 785 776 782 636 632 636 625 625 625 625 625 625 625 625 625 625
787 626 626 776 774 624 625 625 639 780 780 780 780 780 638 625 626 775 776 776 776 776 774 625 632 628 628 628 628 636 625 625 625 625 625
635 634 626 776 774 632 628 636 625 625 625 625 625 625 625 625 626 775 776 776 776 776 782 628 628 628 628 636 787 624 625 625 625 625 625
626 635 783 776 782 628 636 632 628 636 625 625 625 625 625 625 626 639 779 776 776 776 776 776 776 776 776 782 636 624 625 625 625 625 625
626 626 776 776 781 776 782 636 786 632 636 625 625 625 625 625 626 787 775 776 776 784 776 776 776 776 776 776 774 624 625 625 625 625 625
626 626 784 776 776 776 776 782 636 625 624 625 625 625 625 625 639 618 775 776 776 776 776 776 776 776 776 776 774 624 625 625 625 625 625
626 639 780 780 779 785 776 776 774 625 624 625 625 625 625 625 625 626 639 780 780 780 780 779 776 776 776 776 774 624 625 625 625 625 625
639 780 780 618 626 776 776 776 774 625 624 625 625 625 625 625 625 639 617 617 617 617 618 775 776 776 784 776 774 624 625 625 625 625 625
625 625 625 626 626 776 776 778 638 625 624 625 625 625 625 625 625 625 625 625 625 625 626 775 776 776 776 776 774 624 625 625 625 625 625
625 625 625 626 626 784 778 638 625 625 624 625 625 625 625 625 625 625 625 625 625 625 626 639 779 776 776 776 774 624 625 625 625 625 625
787 625 625 626 626 776 782 628 628 636 624 625 625 625 625 625 625 625 625 625 625 625 626 625 775 776 776 776 774 624 625 625 625 625 625
625 625 625 626 626 776 776 776 784 624 624 625 625 625 625 625 625 625 625 625 625 625 639 618 775 776 776 776 774 624 625 625 625 625 625
625 625 635 634 639 779 776 785 776 624 632 628 636 625 625 625 625 625 625 625 625 625 625 626 775 776 776 776 774 624 625 625 625 625 625
625 625 626 635 628 634 776 776 776 632 628 636 624 625 625 625 625 625 625 625 625 625 625 626 775 776 785 776 774 624 625 625 625 625 625
625 625 626 626 781 784 776 776 776 776 781 624 624 625 625 625 625 625 625 625 625 625 625 626 775 776 776 776 774 624 625 625 625 625 625
625 625 626 626 776 776 776 776 776 785 776 624 624 625 625 625 625 625 625 625 625 625 625 626 775 776 776 776 774 624 625 625 625 625 625
625 625 626 626 785 776 776 776 776 776 776 624 624 625 625 625 625 625 625 625 625 625 625 626 775 784 776 776 774 624 625 625 625 625 625
625 625 626 626 776 776 784 776 776 776 776 624 624 625 625 625 625 625 625 625 625 625 625 626 775 776 776 776 774 624 625 625 625 625 625
625 625 626 639 780 780 780 780 780 780 780 638 624 625 625 625 625 625 625 625 625 625 625 626 775 776 776 776 774 624 625 625 625 625 625
625 625 639 617 617 617 617 617 617 617 617 617 638 625 625 625 625 625 625 625 625 625 625 626 775 776 777 776 774 624 625 625 625 625 625
625 625 625 625 625 625 625 625 625 625 625 625 625 625 625 625 625 625 625 625 625 625 625 639 639 525 526 527 638 638 625 625 625 625 625