FortreeCity_House2_Layout (8x6)
968 969 969 958 959 969 971 970
976 995 996 958 959 977 542 978
984 1003 1004 958 959 987 979 986
985 985 988 966 967 987 985 985
985 985 985 985 985 985 985 985
972 985 985 980 981 985 985 973