FortreeCity_DecorationShop_Layout (8x6)
968 969 969 958 959 969 969 970
976 977 977 958 959 977 977 978
1005 1006 975 958 959 974 1006 1007
1013 1014 983 966 967 982 1014 1015
985 985 985 985 985 985 985 985
972 985 985 980 981 985 985 973