FortreeCity_Gym_Layout (20x25)
536 536 523 528 528 528 527 536 536 536 536 536 528 528 528 528 528 528 528 536
536 537 531 532 533 534 535 537 537 537 537 537 516 515 515 560 515 515 515 536
536 529 539 540 541 542 543 529 529 529 529 529 517 514 562 563 526 514 514 536
536 516 518 514 514 514 514 515 546 546 546 560 518 514 563 564 517 514 514 536
536 517 514 514 514 562 520 520 544 544 544 563 526 514 564 516 548 521 521 536
536 517 514 514 514 563 537 537 529 529 529 564 517 514 515 518 556 538 538 536
536 517 514 514 514 553 529 538 516 515 546 546 561 514 562 514 538 538 538 536
536 517 514 514 514 544 552 538 517 514 544 544 563 526 563 526 538 538 538 536
536 517 514 514 514 544 537 538 517 514 538 538 553 517 564 517 538 538 538 536
536 524 525 525 525 544 538 538 517 514 538 538 538 547 546 548 538 538 538 536
536 517 514 514 514 544 538 538 517 514 538 538 538 538 538 538 538 538 538 536
536 517 514 514 514 544 538 538 517 514 538 538 538 529 529 529 529 529 538 536
536 517 514 514 514 544 529 538 517 514 538 538 538 516 515 515 515 515 529 536
536 524 525 525 525 544 552 538 522 526 529 529 529 517 562 514 562 521 515 536
536 517 514 514 514 544 537 538 536 530 521 521 521 521 563 526 563 557 517 536
536 517 514 514 514 544 529 538 536 538 538 538 538 538 563 517 564 529 517 536
536 517 514 514 514 544 552 538 536 538 538 538 538 538 553 517 546 546 548 536
536 524 525 525 525 544 537 538 536 538 538 538 538 538 538 517 544 544 544 536
536 517 514 514 514 529 529 529 537 538 538 538 538 538 544 517 529 529 529 536
536 517 514 514 514 515 515 515 529 529 529 529 529 529 529 517 515 515 515 536
536 558 514 514 551 514 562 521 546 546 560 515 515 515 515 518 562 521 521 536
536 559 517 514 559 517 563 544 544 544 563 526 514 514 514 514 563 544 544 536
536 516 518 514 515 518 553 544 544 544 553 547 521 520 520 520 553 544 544 536
537 530 514 514 521 520 544 544 544 544 544 544 544 537 537 537 544 544 544 537
529 529 549 550 529 528 529 529 529 529 529 529 529 529 529 529 529 529 529 529