FortreeCity_House1_Layout (8x6)
968 969 969 958 959 969 969 970
976 992 977 958 959 977 977 978
984 1000 988 958 959 987 985 986
985 985 988 966 967 987 985 985
985 985 985 985 985 985 985 985
972 985 985 980 981 985 985 973