FortreeCity_Layout (40x20)
199 199 199 199 198 199 198 199 198 199 199 199 199 198 198 198 198 198 199 199 198 198 198 199 199 199 199 199 198 198 198 548 549 550 198 199 199 199 199 199
199 584 585 586 198 199 198 199 198 548 549 550 198 198 198 554 548 549 550 198 198 198 198 198 548 549 550 198 198 198 555 556 557 558 559 199 199 199 199 199
198 592 593 594 23 23 23 23 555 556 557 558 559 554 554 555 556 557 558 559 198 198 198 555 556 557 558 559 198 198 563 564 565 566 567 199 199 199 199 199
199 580 604 580 72 73 74 75 563 564 565 566 567 198 198 563 564 565 566 567 199 554 554 563 564 565 566 567 198 554 563 572 574 574 567 199 199 199 199 199
199 198 199 199 80 81 82 83 563 572 573 574 575 598 598 571 572 574 574 575 598 598 598 571 572 573 574 575 598 598 571 572 574 574 567 199 199 199 199 199
23 199 199 198 88 89 90 91 579 582 581 582 583 580 580 579 582 582 582 583 580 580 580 579 582 581 582 583 580 580 579 582 581 582 583 199 199 199 199 199
1 23 23 23 96 97 98 99 198 199 589 199 584 585 586 199 199 199 199 199 199 199 199 199 199 589 199 199 584 585 586 199 589 199 199 199 199 23 23 23
1 1 1 1 1 600 601 601 595 595 609 199 592 593 594 199 199 199 199 611 612 612 612 612 613 609 199 199 592 593 594 199 609 595 595 595 23 1 1 1
1 1 1 1 1 608 609 609 609 609 609 199 199 577 199 199 199 199 199 434 435 435 435 435 436 609 595 199 199 577 199 199 609 609 609 610 1 1 1 1
1 1 1 1 1 616 3 609 609 609 609 199 199 627 198 198 199 199 595 440 441 442 435 443 444 608 597 199 199 627 198 199 609 609 609 618 1 1 1 1
14 1 1 1 1 1 1 616 609 609 609 199 199 198 198 198 199 199 1 448 449 450 453 451 452 608 605 199 198 198 554 595 609 609 618 15 15 15 15 15
198 14 14 40 41 41 43 1 608 609 587 548 549 550 554 554 199 199 14 456 457 458 461 459 460 608 609 199 198 198 199 609 609 609 15 198 548 549 550 198
198 198 198 48 49 50 51 1 608 587 555 556 557 558 559 199 199 199 199 14 600 601 601 601 601 609 587 199 554 199 595 609 609 609 199 555 556 557 558 559
198 198 198 56 57 58 59 1 608 198 563 564 565 566 567 198 199 199 199 199 587 587 587 587 587 587 199 199 199 199 1 616 617 617 199 563 564 565 566 567
198 198 198 96 65 66 67 600 609 198 563 572 573 574 575 598 598 598 598 598 598 598 598 598 598 598 598 598 598 598 590 590 590 590 598 571 572 574 574 567
198 198 198 14 1 1 600 609 609 595 579 582 581 582 583 580 580 580 580 580 580 580 580 580 580 580 580 580 580 580 1 1 600 601 580 579 582 581 582 583
198 198 198 198 600 601 609 609 609 609 595 595 589 198 584 585 586 198 198 198 198 198 198 198 198 199 199 199 199 199 588 601 609 609 595 595 595 589 199 199
198 198 198 198 587 587 609 609 609 609 609 609 609 198 592 593 594 198 198 198 198 198 198 198 198 199 199 584 585 586 199 587 609 609 609 609 609 609 199 199
198 198 198 198 198 198 587 587 587 609 609 609 609 198 580 604 580 198 198 198 198 198 198 198 198 198 199 592 593 594 199 199 587 587 609 609 609 587 199 199
199 554 554 198 198 198 198 198 198 587 587 587 587 198 198 199 199 554 199 198 198 198 198 198 198 198 199 580 604 580 199 199 199 199 587 587 587 199 199 199