GraniteCave_1F_Layout (42x15)
529 529 529 529 529 529 539 537 537 537 537 537 537 537 537 537 537 537 537 537 537 537 537 537 537 537 537 537 537 537 537 537 537 537 540 529 529 529 529 529 529 529
529 529 529 529 529 529 530 515 529 529 529 529 514 514 529 529 529 529 529 529 529 529 529 529 529 514 529 529 529 529 529 529 515 529 536 537 537 537 537 537 537 540
529 529 529 539 537 537 538 529 529 529 529 539 537 537 537 537 537 537 537 537 537 537 537 537 537 537 537 537 537 537 537 537 537 537 537 537 537 540 529 529 543 528
529 529 529 530 543 529 529 539 537 537 537 538 529 529 529 529 529 529 529 529 529 529 529 529 529 529 529 529 529 529 529 529 529 529 529 575 529 528 529 529 551 528
529 539 537 538 551 529 529 530 529 529 529 529 529 529 529 529 529 529 529 529 529 529 529 529 529 529 529 529 529 529 529 529 529 529 529 529 529 536 537 537 540 528
529 530 529 529 539 537 537 538 529 529 544 521 521 521 546 529 529 529 529 539 537 537 537 537 537 537 537 537 540 529 529 529 529 529 529 529 529 529 529 529 528 528
529 530 539 537 538 529 529 529 529 529 528 529 515 514 530 539 537 537 537 538 513 513 513 513 513 513 513 513 536 537 537 537 537 537 537 540 529 529 529 529 528 528
529 530 530 529 529 529 529 529 529 529 528 529 514 529 530 530 515 513 513 513 513 513 513 513 513 513 513 513 513 513 513 513 513 513 513 536 537 537 537 540 528 528
529 530 530 529 529 529 529 529 529 529 536 537 537 537 538 530 514 513 513 513 513 513 513 520 521 521 522 513 513 513 513 513 513 513 513 513 513 513 515 528 528 528
529 530 530 529 529 529 529 529 529 529 529 529 529 586 594 582 513 513 513 513 513 520 521 548 529 529 547 521 522 513 513 513 513 513 513 513 513 513 513 528 528 528
529 530 530 529 514 572 529 529 529 529 529 529 529 571 529 571 513 513 513 513 513 528 529 529 529 529 529 529 547 522 513 513 513 513 513 513 513 513 514 528 528 528
529 530 547 521 600 601 602 521 521 546 529 529 529 571 529 571 513 575 513 520 521 521 529 544 521 521 521 546 529 547 521 521 521 521 522 513 513 513 513 528 528 528
529 547 521 546 529 529 529 529 529 547 521 546 529 571 529 571 513 513 513 528 529 529 543 528 529 529 529 547 521 521 521 546 529 529 530 513 513 519 513 528 528 528
529 529 529 547 521 521 521 521 521 521 546 547 521 521 521 521 521 521 521 548 529 515 551 528 529 529 529 529 529 529 529 530 515 514 547 521 600 601 602 548 548 528
529 529 529 529 529 529 529 529 514 529 547 521 521 521 521 521 521 521 521 521 521 521 521 548 529 529 529 529 529 529 529 547 521 521 521 521 521 521 521 521 521 548