GraniteCave_B2F_Layout (32x26)
539 537 537 537 537 537 537 537 540 529 539 537 537 537 537 537 537 537 537 537 537 537 537 537 537 537 540 539 537 537 537 540
530 529 529 529 529 529 529 529 528 529 530 529 529 529 529 529 529 529 529 529 529 529 529 529 529 543 528 530 529 529 529 528
530 529 529 529 529 529 529 529 595 537 538 529 529 529 529 529 529 529 529 529 529 529 529 529 529 551 528 530 529 574 529 528
530 529 529 529 529 529 529 529 529 529 570 529 574 529 529 529 529 529 529 529 529 529 529 529 529 529 528 530 529 529 529 528
530 529 529 529 529 529 529 529 529 529 570 529 544 521 521 521 521 546 529 529 529 529 529 529 529 529 528 530 529 529 529 528
530 529 529 529 529 529 529 529 574 529 578 594 528 529 529 529 529 530 529 529 529 529 529 529 529 515 528 530 529 529 529 528
530 529 529 529 529 529 529 529 529 529 529 529 528 529 529 529 529 530 529 529 529 529 529 529 529 544 548 530 592 529 529 528
521 521 521 521 521 521 521 521 521 521 521 521 548 529 529 529 529 548 521 521 521 521 521 521 521 521 529 548 521 521 521 521
529 529 529 529 529 529 529 529 529 529 529 529 529 529 529 529 529 529 529 529 529 529 529 529 529 529 529 529 529 529 529 529
529 529 529 529 529 529 529 529 539 537 537 537 537 537 537 537 537 537 537 537 537 537 537 537 537 540 529 529 529 529 529 529
529 529 529 529 539 537 537 537 538 539 537 537 537 537 537 537 537 537 537 537 537 537 537 540 529 595 537 537 537 537 537 540
529 529 529 539 538 539 537 537 537 538 529 529 544 521 521 610 521 521 546 515 529 529 514 595 537 537 537 537 537 537 540 528
539 537 537 538 529 530 515 529 529 529 529 529 528 529 529 529 529 529 530 529 529 529 529 529 529 529 529 529 529 529 528 528
530 539 537 537 537 538 529 529 529 529 529 529 536 537 537 516 537 537 538 529 529 529 529 529 529 529 529 529 529 574 528 528
530 530 543 529 529 529 529 529 529 529 529 529 529 529 529 529 529 529 529 529 529 529 529 529 529 529 529 529 529 529 528 528
530 530 551 529 529 529 529 529 529 529 529 529 529 529 529 529 529 529 529 529 529 529 539 537 537 537 537 537 537 540 528 528
530 530 529 529 529 529 529 529 529 529 529 529 539 537 537 537 537 537 537 537 537 537 538 513 513 513 513 513 513 528 528 528
530 530 529 529 529 529 529 539 537 537 537 537 538 513 513 513 513 513 513 513 513 513 513 513 513 513 513 513 513 528 528 528
530 530 529 529 529 529 529 530 513 513 513 513 513 513 513 513 513 513 513 513 513 513 513 513 513 513 513 513 513 528 528 528
530 530 539 537 516 537 537 538 513 513 513 513 513 513 513 513 513 513 513 520 521 521 521 521 522 513 513 513 513 528 528 528
530 530 530 513 513 513 513 513 513 513 514 543 513 513 513 513 513 513 513 528 529 529 529 529 530 513 513 513 513 528 528 528
530 530 530 513 513 513 513 513 513 513 513 551 513 513 513 520 521 521 521 548 529 529 529 529 530 543 513 513 573 528 528 528
530 530 530 515 513 513 513 513 513 513 513 513 513 513 513 528 529 529 544 521 521 521 521 546 530 551 513 513 513 528 528 528
530 530 548 521 521 521 521 521 521 521 521 521 521 521 521 548 529 529 528 529 529 529 529 530 548 521 521 521 521 548 528 528
530 548 521 521 521 521 521 521 521 521 521 521 521 521 521 521 521 521 548 529 529 529 529 548 521 521 521 521 521 521 548 528
548 521 521 521 521 521 521 521 521 521 521 521 521 521 521 521 521 521 521 521 521 521 521 521 521 521 521 521 521 521 521 547