GraniteCave_B1F_Layout (32x26)
539 537 537 537 537 537 537 537 537 537 537 537 537 537 537 537 537 537 537 537 537 537 537 537 537 537 537 537 537 537 537 540
530 513 559 559 559 559 559 559 513 513 513 513 513 513 513 559 559 559 559 559 559 559 559 520 545 545 545 545 522 513 513 528
530 513 559 559 559 559 559 559 513 513 513 513 513 513 513 559 559 559 559 559 559 559 559 528 529 529 529 529 530 575 513 528
530 513 513 520 545 545 545 545 545 545 522 513 575 513 513 559 559 559 559 559 559 559 559 536 537 537 537 537 538 513 513 528
530 513 513 536 537 537 537 537 537 537 538 520 545 545 545 545 545 522 559 559 559 514 559 559 559 513 513 513 513 513 513 528
530 513 513 559 559 559 513 513 575 513 513 528 529 529 529 529 529 530 559 559 559 559 559 559 559 513 513 513 513 513 513 528
530 513 513 559 559 559 513 513 513 513 513 536 540 529 529 529 529 530 559 559 559 559 559 559 559 513 513 513 513 513 515 528
547 545 547 545 545 522 513 513 513 513 513 513 528 529 529 529 529 547 545 547 545 547 545 547 545 545 545 545 545 545 545 547
529 529 529 529 529 530 513 513 513 513 513 513 536 537 540 529 529 529 529 529 529 529 529 529 529 529 529 529 529 529 529 529
539 537 537 537 537 538 539 537 653 232 654 537 540 513 536 537 537 537 537 537 537 537 537 537 537 537 537 537 537 537 537 540
530 539 537 537 537 537 538 539 661 232 662 540 536 537 537 537 537 537 537 537 537 537 537 537 537 537 537 537 537 537 540 528
530 530 529 514 539 537 537 538 513 513 513 536 537 537 537 537 537 537 537 537 537 537 537 540 529 529 529 515 529 515 528 528
530 530 529 529 530 513 513 513 513 513 513 513 513 513 513 513 513 513 513 513 513 514 515 528 529 529 529 529 529 529 528 528
530 530 539 537 538 513 513 513 513 513 513 513 513 513 513 513 513 513 513 513 513 513 513 528 529 574 529 529 529 575 528 528
530 530 530 513 513 513 513 520 521 521 522 513 513 513 520 521 521 522 513 513 513 513 513 528 529 529 529 529 529 529 528 528
530 530 530 513 513 513 513 528 529 529 530 513 513 513 528 529 529 530 513 513 513 513 513 536 537 537 540 529 529 529 528 528
530 530 530 513 520 521 521 547 529 529 530 513 513 513 528 529 529 530 514 515 513 513 513 513 513 514 528 529 529 529 528 528
530 530 530 513 528 529 529 529 529 529 530 513 513 513 528 529 529 547 521 521 522 513 513 513 513 513 528 529 529 529 528 528
530 530 530 513 536 537 540 529 529 529 530 513 513 513 528 529 529 529 529 529 530 513 513 513 513 513 528 529 529 514 528 528
530 530 530 513 513 514 528 529 529 529 530 514 513 513 536 537 540 529 529 529 530 513 513 513 513 513 536 537 537 540 528 528
530 530 530 513 513 513 528 529 529 529 530 515 513 513 513 515 528 529 529 529 547 521 521 522 513 513 513 513 513 528 528 528
530 530 530 513 573 513 528 529 529 529 547 521 522 513 513 513 528 544 545 545 545 545 546 530 513 513 513 513 575 528 528 528
530 530 530 515 513 513 528 529 529 529 529 529 530 515 513 513 528 528 529 529 529 529 530 530 515 513 513 513 513 528 528 528
530 530 547 521 521 521 521 544 545 545 545 546 547 521 521 521 547 528 529 529 529 529 530 547 547 521 521 521 521 547 528 528
530 547 521 521 521 521 521 521 529 529 529 547 521 521 521 521 521 547 529 529 529 529 547 521 521 521 521 521 521 521 547 528
547 521 521 521 521 521 521 521 521 521 521 521 521 521 521 521 521 521 521 521 521 521 521 521 521 521 521 521 521 521 521 547