GraniteCave_StevensRoom_Layout (15x14)
529 529 529 529 529 539 537 537 537 540 529 529 529 529 529
529 539 537 537 537 538 529 529 529 536 537 537 540 529 529
529 530 529 539 537 537 523 524 525 537 537 540 528 529 529
529 530 539 538 539 537 531 532 533 540 529 528 536 540 529
529 530 530 529 530 513 513 513 513 528 529 528 529 528 529
529 530 530 539 538 515 513 513 513 528 529 536 540 528 529
529 530 530 530 513 513 513 513 513 536 537 540 528 528 529
529 530 530 530 513 513 513 513 513 513 513 528 528 528 529
529 530 530 530 513 513 513 513 513 513 515 528 528 528 529
529 530 530 548 545 522 513 513 513 513 513 528 528 528 529
529 530 548 522 529 530 513 514 513 513 513 528 528 528 529
529 548 522 530 514 548 545 545 545 545 545 548 528 528 529
529 529 530 548 545 545 545 545 545 545 545 545 548 528 529
529 529 548 545 545 545 545 545 545 545 545 545 545 548 529