Harbor_Layout (24x15)
537 537 537 537 537 537 537 537 537 537 537 537 537 537 537 537 537 537 537 537 537 537 537 537
946 950 950 946 946 946 950 950 946 946 946 950 950 946 946 946 950 950 946 946 946 950 950 946
946 951 951 946 946 946 951 951 946 946 946 951 951 946 946 946 951 951 946 946 946 951 951 946
545 545 545 545 545 545 545 545 545 545 545 545 545 545 545 545 545 545 545 545 545 545 545 545
515 515 515 845 846 846 846 846 846 846 846 846 846 846 846 846 846 846 846 846 846 846 846 846
515 514 514 839 369 369 369 369 369 369 369 369 369 369 369 369 369 369 369 369 369 369 369 369
515 514 514 839 369 368 368 368 368 368 368 368 368 368 368 368 368 368 368 368 368 368 368 368
515 514 514 839 369 368 368 368 368 368 368 368 368 368 368 368 368 368 368 368 368 368 368 368
515 514 514 839 369 368 368 368 368 368 368 368 368 368 368 368 368 368 368 368 368 368 368 368
515 514 514 839 369 368 368 368 368 368 368 368 368 368 368 368 368 368 368 368 368 368 368 368
515 514 514 616 854 854 855 859 859 853 854 854 854 854 854 854 854 838 990 991 854 854 854 854
515 514 514 516 516 516 516 514 514 549 516 516 549 516 516 549 516 608 986 987 984 985 689 554
515 514 514 514 514 514 514 514 514 514 514 514 514 514 514 514 514 608 988 989 988 989 984 985
515 514 514 514 514 514 514 514 514 514 514 514 514 514 514 514 514 608 554 554 554 554 986 987
515 514 514 514 514 514 514 514 514 514 514 518 519 514 514 514 514 608 552 552 552 552 988 989