House4_Layout (10x9)
739 702 703 533 535 535 533 533 533 740
747 710 711 541 543 543 541 541 672 748
755 718 719 691 691 545 545 545 680 756
545 553 580 553 553 553 553 553 553 553
545 553 553 553 553 553 553 590 607 580
545 553 553 553 553 553 580 598 599 580
545 553 553 553 553 553 553 553 553 553
800 792 792 792 792 792 792 792 792 792
803 795 795 528 529 795 795 795 795 795