House2_Layout (11x8)
646 647 560 517 517 518 517 517 517 517 632
654 655 542 525 525 526 525 616 620 621 640
662 663 568 548 548 548 548 624 628 629 648
569 547 547 547 547 547 547 547 547 547 547
569 547 547 547 555 586 587 556 547 547 547
569 547 547 547 555 594 595 556 547 547 547
657 547 547 547 547 547 547 547 547 547 546
665 547 547 520 521 547 547 547 547 547 554