HouseWithBed_Layout (10x8)
517 517 517 518 517 517 518 517 622 623
616 617 525 526 525 525 526 525 630 631
624 625 548 548 548 548 548 548 638 639
602 603 547 547 547 547 547 547 547 556
610 611 547 547 547 547 547 547 588 589
569 547 547 547 547 547 547 555 596 597
569 547 547 547 547 547 547 547 547 547
569 547 547 520 521 547 547 547 547 547