House1_Layout (10x9)
646 647 633 634 517 519 517 517 517 517
654 655 641 642 525 527 525 525 656 656
662 663 649 650 548 548 548 548 664 664
569 565 566 566 566 566 566 567 547 547
569 573 584 585 738 574 574 575 547 547
569 573 592 593 738 574 574 575 547 547
569 581 582 582 582 582 582 583 547 547
569 547 547 547 547 547 547 547 547 546
569 547 547 520 521 547 547 547 547 554