House3_Layout (10x8)
739 702 703 535 533 534 678 679 533 740
747 710 711 543 541 542 686 687 673 748
755 718 719 545 545 576 694 695 681 756
545 553 553 580 590 591 580 553 553 553
545 553 553 580 598 599 580 553 553 553
545 553 553 553 553 553 553 553 553 553
800 792 792 792 792 792 792 792 792 792
803 795 795 528 529 795 795 795 795 795