IslandCave_Layout (17x33)
729 723 737 737 737 737 737 737 737 737 737 737 737 737 737 724 729
729 777 723 737 737 737 737 737 737 737 737 737 737 737 724 776 729
723 785 730 539 537 537 537 537 537 537 537 537 537 540 776 784 724
777 723 738 530 513 513 513 513 513 513 513 513 513 528 784 724 776
777 730 539 538 513 513 725 513 513 513 725 513 513 536 540 776 776
777 730 530 513 513 513 513 513 513 513 513 513 513 513 528 776 776
777 730 530 513 513 513 513 513 513 513 513 513 513 513 528 776 776
777 730 530 513 725 513 513 513 513 513 513 513 725 513 528 776 776
777 730 530 513 513 513 513 513 513 513 513 513 513 513 528 776 776
777 730 530 513 513 513 513 513 513 513 513 513 513 513 528 776 776
777 730 547 522 513 513 725 513 513 513 725 513 513 520 548 776 776
777 731 722 530 513 513 513 513 519 513 513 513 513 528 720 732 776
731 769 730 547 521 521 521 600 601 602 521 521 521 548 728 768 732
729 730 731 721 721 721 721 721 721 721 721 721 721 721 732 728 729
729 731 721 721 721 721 721 721 721 721 721 721 721 721 721 732 729
729 729 729 729 729 729 729 729 729 729 729 729 729 729 729 729 729
729 729 729 729 729 729 729 729 729 729 729 729 729 729 729 729 729
729 729 729 729 729 729 729 729 729 729 729 729 729 729 729 729 729
729 723 737 737 737 737 739 566 566 566 740 737 737 737 737 724 729
729 777 723 737 737 739 553 554 555 556 553 740 737 737 724 776 729
723 785 730 539 537 566 566 562 563 564 566 566 537 540 776 784 724
777 723 738 530 513 513 513 513 513 513 513 513 513 528 784 724 776
777 730 539 538 513 513 513 513 513 513 513 513 513 536 540 776 776
777 730 530 513 513 513 513 513 513 513 513 513 513 513 528 776 776
777 730 530 513 513 513 513 513 513 513 513 513 513 513 528 776 776
777 730 530 513 513 513 513 513 513 513 513 513 513 513 528 776 776
777 730 530 513 513 513 513 513 513 513 513 513 513 513 528 776 776
777 730 530 513 513 513 513 513 513 513 513 513 513 513 528 776 776
777 730 547 522 513 513 513 513 513 513 513 513 513 520 548 776 776
777 731 722 530 513 513 513 513 519 513 513 513 513 528 720 732 776
731 769 730 547 521 521 521 600 601 602 521 521 521 548 728 768 732
729 730 731 721 721 721 721 721 721 721 721 721 721 721 732 728 729
729 731 721 721 721 721 721 721 721 721 721 721 721 721 721 732 729