JaggedPass_Layout (30x46)
722 723 628 636 706 707 706 707 706 707 706 707 625 625 625 625 706 707 706 707 706 707 706 707 626 704 705 626 706 707
704 705 625 624 712 715 694 695 694 695 694 695 625 625 625 625 694 695 694 695 714 715 714 713 626 712 713 626 694 695
712 713 625 632 628 636 706 707 706 707 706 707 625 625 625 625 706 707 706 707 625 625 635 628 634 720 721 626 706 707
722 723 722 723 636 624 712 715 714 715 714 713 625 625 625 625 712 715 714 713 625 635 634 625 635 718 719 634 712 713
704 705 704 705 624 632 722 723 722 723 628 628 636 625 625 635 628 628 722 723 722 725 720 721 626 712 702 721 635 628
712 713 712 713 632 628 718 719 718 719 636 625 632 535 535 634 625 635 718 719 718 719 718 719 634 635 718 719 634 635
628 636 625 625 625 625 694 695 694 695 724 723 636 625 625 635 628 634 712 715 694 695 694 695 625 626 694 695 635 634
636 724 723 722 723 636 706 707 706 707 706 705 632 687 687 634 625 625 625 625 706 707 706 707 625 626 706 707 626 625
624 704 707 706 705 624 694 695 714 715 714 713 625 625 625 625 625 625 771 625 712 715 694 695 635 634 712 713 626 625
624 712 715 714 713 632 718 719 628 628 748 746 746 746 746 746 746 747 770 628 628 628 718 719 634 625 625 635 634 625
632 628 628 722 723 636 714 715 519 519 744 625 625 625 625 625 625 745 767 625 625 771 712 713 625 625 635 634 635 628
636 625 625 704 705 724 723 636 519 519 752 746 746 746 746 746 746 753 625 625 635 770 628 628 628 628 634 635 634 625
724 723 636 712 715 706 705 624 519 519 519 519 625 625 625 625 625 625 625 625 626 767 625 635 628 628 722 725 635 628
704 705 632 636 625 712 713 632 628 628 628 628 628 687 687 628 628 628 628 628 634 625 625 626 625 625 704 705 626 635
712 713 625 632 628 722 723 628 748 746 746 746 746 746 746 746 746 746 746 747 628 687 628 634 625 625 712 713 626 626
625 625 720 721 625 704 705 625 752 755 625 625 625 625 625 625 625 625 625 745 519 519 519 635 628 628 628 628 634 626
636 625 704 705 625 712 713 625 625 752 746 746 746 746 765 616 618 764 746 753 519 519 771 626 720 721 625 625 635 634
632 636 712 713 635 722 723 628 628 636 625 625 625 625 625 632 634 625 625 519 519 519 768 626 704 705 625 625 626 635
636 632 628 628 634 704 705 625 625 632 748 746 746 746 746 746 746 746 746 747 628 628 770 634 712 713 635 628 634 626
632 628 628 628 636 712 702 721 625 625 744 625 625 625 625 625 625 625 625 745 625 625 767 635 628 628 634 625 625 626
616 617 618 625 624 625 706 705 625 625 744 625 625 625 754 746 746 746 746 753 625 625 625 626 625 625 625 625 625 626
624 625 639 618 624 625 712 713 625 625 752 746 746 746 753 625 625 625 625 625 635 687 687 634 616 617 618 625 625 626
624 625 625 626 632 628 748 746 746 746 755 625 625 625 625 625 625 625 625 625 626 625 625 616 638 625 626 625 625 626
632 628 628 634 616 617 639 618 518 518 752 765 616 618 764 746 746 746 746 747 634 625 625 632 628 628 634 625 625 626
628 794 795 636 624 625 625 626 518 518 518 518 624 626 625 625 625 625 625 745 625 625 734 735 635 628 628 628 628 634
625 728 729 624 632 628 636 626 518 518 518 518 624 626 625 625 625 625 625 745 625 625 728 729 626 616 617 617 617 618
625 738 739 632 628 636 624 626 764 746 746 765 624 626 764 746 746 746 746 753 625 625 738 739 626 624 734 735 625 626
625 616 617 617 618 624 632 634 625 625 625 625 632 634 625 625 625 625 625 754 746 766 746 747 634 624 728 729 625 626
625 624 625 625 626 632 628 628 748 746 746 746 746 746 746 746 746 746 746 753 625 768 616 639 617 638 726 727 635 634
636 632 636 625 639 617 618 625 744 625 625 625 625 625 625 625 625 734 735 625 625 768 624 625 734 735 728 729 626 625
611 625 632 636 734 735 626 625 752 766 746 746 746 746 746 746 765 728 729 764 746 769 624 625 728 729 738 739 626 625
792 733 636 624 728 729 626 625 625 768 625 625 625 625 625 734 735 738 739 518 518 767 632 636 738 739 625 635 634 625
468 471 611 624 738 739 626 764 746 769 746 746 746 746 765 728 729 518 518 518 518 518 518 632 628 628 628 634 625 625
476 477 611 624 625 625 626 625 625 767 625 625 625 625 625 738 739 764 746 746 746 746 765 635 732 733 732 733 732 733
468 469 611 632 628 628 634 625 625 625 625 625 625 625 625 625 625 625 625 625 625 625 625 791 470 469 468 469 468 469
476 477 792 733 732 733 732 733 636 625 625 625 625 625 625 625 625 625 625 625 625 635 732 793 476 477 476 477 476 477
468 469 468 469 468 469 468 471 627 633 633 633 636 625 625 625 625 635 633 633 633 629 470 469 468 469 468 469 468 469
476 477 476 477 476 477 476 477 462 463 462 463 627 633 687 687 633 629 462 463 462 463 476 477 476 477 476 477 476 477
468 469 468 469 468 469 468 469 468 469 468 471 1 1 1 1 1 1 470 469 468 469 468 469 468 469 468 469 468 469
476 477 476 477 476 477 476 477 476 477 476 477 462 463 1 1 462 463 476 477 476 477 476 477 476 477 476 477 476 477
468 469 468 469 468 469 468 469 468 469 468 469 468 471 36 36 470 469 468 469 468 469 468 469 468 469 468 469 468 469
476 477 476 477 476 477 476 477 476 477 476 477 476 477 1 1 476 477 476 477 476 477 476 477 476 477 476 477 476 477
468 469 468 469 468 469 468 469 468 469 468 469 468 469 1 1 468 469 468 469 468 469 468 469 468 469 468 469 468 469
476 477 476 477 476 477 476 477 476 477 476 477 476 477 1 1 476 477 476 477 476 477 476 477 476 477 476 477 476 477
468 469 468 469 468 469 468 469 468 469 468 469 468 469 1 1 468 469 468 469 468 469 468 469 468 469 468 469 468 469
476 477 476 477 476 477 476 477 476 477 476 477 476 477 1 1 476 477 476 477 476 477 476 477 476 477 476 477 476 477