LavaridgeTown_HerbShop_Layout (11x8)
639 639 648 651 653 648 648 639 639 639 648
647 647 656 659 661 669 656 647 647 647 656
790 678 678 678 678 677 632 624 624 624 624
674 674 674 674 674 685 640 616 616 616 786
632 624 624 624 624 624 633 616 616 616 563
640 616 616 616 616 616 616 616 616 616 788
735 615 616 616 616 616 616 616 616 614 602
609 610 616 534 535 616 616 616 616 609 610