LavaridgeTown_Layout (20x20)
625 625 625 625 635 628 628 628 628 628 636 625 625 625 625 625 625 625 536 536
635 628 628 628 634 625 686 686 686 686 632 628 628 628 628 628 628 628 628 529
626 635 665 666 667 667 668 669 628 670 636 625 625 625 590 587 588 591 625 536
626 626 673 675 700 675 675 677 586 584 585 589 633 633 48 49 50 51 529 529
626 626 673 699 797 797 699 677 80 81 82 83 542 543 56 57 58 59 198 198
626 626 681 682 675 700 684 685 88 89 90 91 470 471 96 65 66 67 198 198
626 626 689 690 691 691 692 693 96 97 98 99 486 487 4 288 290 1 22 22
626 626 698 680 680 680 697 650 1 288 290 1 4 4 1 288 290 1 1 1
626 626 680 664 680 664 652 658 1 288 290 1 1 3 1 288 290 1 1 1
626 626 680 672 680 672 650 1 1 288 289 281 281 281 281 289 289 281 281 281
626 626 657 657 657 657 658 1 1 296 297 297 297 297 297 297 297 297 297 297
626 626 426 427 427 427 427 428 1 1 1 1 1 1 1 1 1 1 1 1
626 626 434 435 435 435 435 436 1 1 1 8 9 9 10 8 9 9 10 1
626 626 440 441 442 435 443 444 1 1 1 16 17 17 18 16 17 17 18 14
626 626 448 449 450 453 451 671 1 1 1 24 25 11 26 24 25 11 26 198
626 626 456 457 458 461 459 679 1 1 1 32 33 19 34 32 33 19 34 198
626 626 1 1 1 1 1 1 1 1 1 1 1 1 3 1 1 1 14 198
639 639 621 1 1 1 1 1 1 1 1 1 1 1 1 1 1 1 198 198
625 625 626 621 1 1 1 1 1 1 1 1 1 1 1 1 1 1 22 22
625 625 639 639 620 620 620 620 620 620 620 620 620 620 620 620 620 620 620 620