LavaridgeTown_Gym_1F_Layout (11x24)
520 520 520 520 520 536 520 520 520 520 520
528 528 528 528 528 529 528 528 528 528 528
542 541 541 541 517 537 542 541 541 517 541
515 514 514 514 514 537 515 514 514 514 514
515 514 514 514 514 537 515 514 514 514 514
515 514 514 514 514 537 515 514 514 514 514
515 516 514 514 516 537 542 514 514 514 516
520 520 520 520 520 536 520 520 520 520 520
528 528 528 528 528 529 528 528 528 528 528
515 541 541 541 517 537 515 541 541 541 541
515 514 514 514 514 537 522 523 523 523 524
542 514 514 514 514 537 530 531 531 531 532
515 514 514 514 516 537 515 514 514 514 514
515 514 514 514 514 537 515 514 514 514 514
515 516 514 514 514 537 542 514 514 514 516
520 520 520 520 520 536 520 520 520 520 520
528 528 528 528 528 529 525 528 528 528 525
542 541 541 541 517 537 533 541 541 541 533
515 514 514 514 514 537 515 514 514 514 514
515 514 514 514 514 537 515 514 514 514 516
515 514 514 514 514 537 542 514 514 514 514
515 514 514 516 514 537 515 514 514 514 514
515 514 514 514 514 544 515 514 514 514 514
542 514 514 514 514 552 515 514 534 535 514