LavaridgeTown_PokemonCenter_1F_Layout (14x9)
520 688 689 690 523 523 523 586 587 523 524 525 526 527
528 696 697 698 584 546 547 594 595 585 4 533 534 535
536 704 705 706 592 554 555 519 603 593 548 541 542 543
544 550 514 514 600 545 545 517 545 601 572 514 514 551
544 564 514 514 608 620 621 622 623 518 549 514 514 551
640 641 514 514 514 560 561 562 563 514 514 514 514 551
648 649 514 514 514 568 569 570 571 514 564 573 574 551
656 657 514 514 514 576 577 578 579 514 550 581 582 551
552 514 514 514 514 514 515 516 514 514 514 550 564 567