LavaridgeTown_Gym_B1F_Layout (11x24)
520 520 520 520 520 520 520 520 520 520 520
528 528 528 528 528 528 528 528 528 528 528
515 541 541 541 541 541 541 541 541 543 541
515 514 514 514 514 514 514 514 514 514 514
520 520 521 520 520 521 520 520 521 520 520
528 528 529 528 528 529 528 528 529 528 528
515 543 537 515 541 537 515 541 537 515 541
515 514 537 515 514 537 515 514 537 515 514
515 514 537 515 514 537 515 514 537 515 514
515 514 537 515 514 537 515 514 537 515 514
515 514 537 515 514 537 515 514 537 515 514
515 514 537 515 514 537 515 514 537 515 514
526 527 537 515 514 537 515 514 537 515 514
515 514 537 515 514 537 515 514 537 515 514
515 518 537 515 514 537 519 514 537 515 514
515 514 537 515 514 537 515 514 537 515 514
515 514 537 515 514 537 515 514 537 515 514
515 514 537 515 514 537 515 514 537 515 514
515 514 545 515 514 545 515 514 545 515 514
526 527 553 526 527 553 526 527 553 526 527
515 514 514 514 514 514 518 514 514 514 514
515 514 514 518 514 514 514 514 514 514 514
515 514 514 514 514 514 514 514 514 514 514
515 514 514 514 514 514 514 514 514 514 514