LilycoveCity_LilycoveMuseum_2F_Layout (22x13)
633 633 633 634 641 641 641 641 641 641 641 641 618 619 620 641 641 641 632 633 633 633
641 641 641 642 649 649 649 649 649 649 649 644 626 627 628 645 649 649 640 641 641 641
649 649 649 650 625 624 625 624 625 624 625 652 625 624 625 653 625 624 648 649 649 649
624 625 624 625 624 617 616 617 616 617 616 617 616 617 616 617 616 617 624 625 624 625
625 612 613 614 615 616 617 616 617 612 613 614 615 616 617 616 617 612 613 614 615 616
624 646 622 622 623 643 616 617 616 646 622 622 623 643 616 617 616 646 622 622 623 643
625 654 600 601 631 635 617 616 617 654 600 601 631 635 617 616 617 654 600 601 631 635
624 636 637 638 639 643 616 617 616 636 637 638 639 643 616 617 616 636 637 638 639 643
625 616 617 616 617 612 613 614 615 616 617 616 617 612 613 614 615 616 617 616 617 616
624 617 616 617 616 646 622 622 623 643 616 617 616 646 622 622 623 643 616 617 616 617
625 616 617 616 617 654 600 601 631 635 617 616 617 654 600 601 631 635 617 616 617 616
624 617 616 617 616 636 637 638 639 643 616 617 616 636 637 638 639 643 616 617 616 617
625 616 617 616 617 616 617 616 617 616 617 616 617 616 617 616 617 616 617 616 617 616