LilycoveCity_CoveLilyMotel_2F_Layout (12x9)
739 530 609 532 535 533 533 535 688 702 703 740
747 538 537 540 543 541 541 543 696 710 711 748
755 545 545 545 545 545 545 545 704 718 719 756
545 553 590 607 580 553 553 580 590 591 580 553
545 580 598 599 580 553 553 580 598 599 580 553
545 553 553 553 553 553 553 553 553 553 553 553
545 580 590 591 580 553 553 553 590 607 553 553
545 580 598 599 580 553 553 580 598 599 553 553
545 553 553 553 553 553 553 553 553 553 553 553