LilycoveCity_ContestLobby_Layout (23x12)
603 604 605 714 714 714 570 571 714 714 714 589 603 604 605 714 714 714 714 714 714 714 714
611 612 613 716 610 610 578 579 610 610 716 4 611 612 613 713 610 713 610 713 610 610 596
544 545 545 720 721 670 727 727 686 721 642 597 545 545 545 545 545 545 545 545 545 545 546
552 608 608 728 729 678 735 735 694 729 650 614 608 608 608 608 608 608 608 608 608 608 554
552 608 608 710 607 607 607 607 607 607 607 615 608 608 608 608 608 608 608 608 608 608 554
552 608 608 608 608 608 608 608 608 608 608 608 608 608 608 608 608 608 733 608 608 608 554
568 608 608 608 608 608 608 608 608 608 608 608 608 608 608 608 608 608 608 608 608 608 569
576 608 608 608 608 608 608 608 608 608 608 608 608 608 608 608 608 608 608 608 608 608 577
552 608 608 608 608 608 608 608 608 608 608 608 608 608 608 608 608 608 608 608 608 608 554
568 608 608 608 608 608 608 608 608 608 608 608 608 608 608 608 608 608 733 608 608 608 569
576 608 608 608 608 608 608 608 608 608 608 608 608 608 608 608 608 608 608 608 608 608 577
552 608 608 608 608 608 516 517 608 608 608 608 608 608 608 608 608 608 608 608 608 608 554