LilycoveCity_DepartmentStoreRooftop_Layout (18x12)
550 641 641 641 641 641 641 641 641 623 623 641 641 641 641 551 543 543
558 595 595 595 595 595 595 595 595 631 631 595 590 591 565 559 543 543
566 713 714 586 586 586 586 586 586 589 589 791 598 599 573 634 641 551
566 715 716 586 586 586 586 586 586 586 586 586 606 607 581 596 595 559
566 713 714 586 586 586 586 586 586 586 586 586 589 589 589 589 704 567
566 715 716 586 586 705 706 586 586 705 706 586 586 586 586 586 704 567
574 597 603 603 603 603 603 603 603 603 603 603 603 603 603 603 603 575
582 611 611 611 611 611 611 611 611 611 611 611 611 611 611 611 611 583
740 741 741 741 741 741 741 741 741 741 741 741 741 741 741 741 741 742
748 752 753 749 749 749 749 749 752 753 749 749 749 749 749 752 753 750
748 760 761 749 749 749 749 749 760 761 749 749 749 749 749 760 761 750
748 749 749 749 749 749 749 749 749 749 749 749 749 749 749 749 749 750