LilycoveCity_PokemonTrainerFanClub_Layout (12x14)
622 623 517 517 518 517 517 518 560 517 517 517
630 631 617 525 526 525 525 526 542 525 643 644
638 639 625 548 548 548 548 548 568 548 651 652
569 547 547 555 588 589 588 589 556 547 547 547
569 547 547 547 596 597 596 597 547 547 547 547
569 547 547 547 547 547 547 556 547 547 547 547
777 763 764 547 547 547 547 547 547 762 763 763
771 771 772 547 547 547 547 547 547 770 771 771
643 644 780 565 566 566 566 566 567 778 616 617
651 652 548 573 584 606 584 585 575 549 624 625
569 547 547 573 592 593 592 593 575 547 547 547
569 547 547 581 582 582 582 582 583 547 547 547
569 547 547 547 547 547 547 547 547 547 547 547
569 547 547 547 547 520 521 547 547 547 547 547