LilycoveCity_Layout (80x40)
112 115 468 469 484 485 484 487 1 650 651 651 651 651 652 486 485 484 485 476 477 476 477 768 749 750 769 763 769 749 750 770 476 477 468 469 117 117 117 400 368 368 368 368 368 368 368 368 368 368 368 368 368 368 368 368 368 368 368 368 368 368 368 368 429 411 358 115 123 137 113 113 117 117 380 414 414 414 414 439
112 115 486 498 463 104 211 2 2 608 609 610 610 610 634 2 2 212 106 468 469 468 469 768 769 769 769 769 769 769 769 770 468 469 476 477 117 117 117 400 368 368 368 368 368 368 368 368 368 368 368 368 368 368 368 368 368 368 368 368 368 368 429 430 411 414 358 123 137 115 113 113 117 117 380 414 414 414 414 439
112 115 1 468 469 112 1 520 611 616 617 618 632 617 633 611 519 1 114 476 477 476 477 768 749 750 769 763 769 749 750 770 476 477 468 469 212 212 212 488 489 2 2 2 2 488 489 488 489 578 368 368 368 368 368 368 368 368 368 368 429 430 411 414 414 414 366 137 115 115 113 113 117 117 380 414 414 414 414 439
112 115 1 476 477 112 1 541 542 624 625 626 640 625 641 542 543 1 114 468 469 468 469 768 769 769 769 769 769 769 769 770 468 469 484 557 558 558 559 470 471 557 558 558 559 468 469 468 471 488 489 488 489 578 368 368 368 368 429 430 411 414 414 414 414 414 414 358 115 123 124 124 125 117 380 414 414 414 414 439
112 123 137 468 469 112 4 512 517 517 513 514 515 516 517 517 518 4 114 486 485 484 485 768 749 750 757 758 759 749 750 770 484 487 1 565 566 566 567 476 477 565 566 566 567 476 477 476 477 468 469 468 471 2 2 212 351 414 414 414 414 404 414 404 350 351 414 358 123 680 681 682 169 125 380 414 414 414 420 447
120 137 115 486 487 112 1 549 550 525 521 522 523 524 525 526 527 1 114 592 593 593 593 766 764 783 771 772 773 782 764 767 593 593 594 573 574 575 589 468 469 573 574 575 589 468 469 468 469 484 485 484 487 1 1 1 117 351 414 414 404 414 404 350 238 239 351 366 145 688 689 690 145 145 367 414 414 414 439 368
1 112 123 137 1 112 4 535 533 533 529 530 531 532 533 533 534 4 114 1 1 1 1 774 765 727 779 780 781 726 765 775 1 1 3 581 582 583 597 486 487 581 582 583 597 486 485 484 487 1 1 1 1 1 1 1 117 117 351 404 414 414 414 358 123 125 359 420 446 447 368 445 446 446 360 361 360 361 447 368
1 120 137 115 1 120 124 124 121 121 537 538 539 540 121 121 121 121 122 3 1 1 1 1 1 1 563 563 555 3 1 1 1 1 1 1 1 1 1 1 1 1 1 1 1 1 1 1 1 1 1 1 1 1 1 1 117 117 114 414 414 404 414 366 145 145 367 439 368 368 368 368 368 368 344 345 344 345 336 337
462 463 112 120 121 121 145 137 571 571 545 546 547 548 555 571 571 571 571 571 563 563 563 555 563 563 563 555 555 555 555 555 555 555 555 555 555 555 555 555 555 555 555 556 1 1 1 1 1 1 1 1 1 1 1 1 117 117 114 414 414 414 414 414 414 404 420 447 368 368 368 368 368 368 368 370 372 368 344 345
468 471 112 1 1 1 1 112 571 571 562 564 571 571 571 571 571 571 571 571 571 571 571 571 571 571 571 571 571 571 571 563 563 571 571 571 571 571 571 571 571 571 571 572 1 1 1 110 135 135 135 135 135 135 111 1 117 117 114 407 414 414 414 414 420 446 447 368 368 368 368 368 368 429 506 238 239 507 431 368
476 477 693 497 496 497 137 115 1 1 1 1 1 1 1 1 1 1 1 1 1 1 1 1 1 1 1 1 1 1 1 562 564 1 116 124 124 124 124 124 124 124 124 121 137 1 1 134 1 1 1 1 1 1 133 1 117 117 114 390 407 414 420 446 447 368 368 368 368 368 368 368 368 437 358 123 125 380 439 368
468 469 468 469 468 471 112 123 124 124 124 605 606 606 607 124 124 124 124 124 124 124 124 619 620 621 622 124 124 124 124 175 207 124 125 116 145 605 606 606 606 607 137 1 120 121 121 691 135 135 135 135 135 135 692 121 125 114 212 130 415 414 439 368 368 368 368 368 368 368 368 368 368 437 366 145 145 367 439 368
476 477 476 477 476 477 693 497 145 145 145 613 614 614 615 145 145 145 145 145 145 145 145 80 81 82 83 145 145 145 145 175 207 145 145 122 4 565 566 566 566 567 112 1 1 1 1 1 1 1 1 1 1 1 557 558 558 607 106 114 390 407 439 368 368 368 368 368 368 368 368 368 368 445 446 446 446 446 447 368
468 469 468 469 468 469 468 469 4 4 4 573 574 575 589 1 1 1 1 1 1 1 1 88 89 90 91 1 1 1 602 562 564 600 4 4 4 579 580 574 575 589 112 1 1 1 1 1 1 1 1 1 1 1 565 566 566 567 114 212 130 415 439 368 368 368 368 368 368 368 368 368 368 368 368 368 368 368 368 368
486 485 484 485 484 485 484 487 592 593 594 581 582 583 597 592 593 593 593 593 593 593 594 96 97 98 99 592 593 593 594 562 564 592 593 593 3 587 588 582 583 597 112 1 1 110 135 135 135 111 1 1 1 1 573 574 575 589 114 1 114 415 412 430 431 368 368 368 368 368 368 368 368 368 368 368 368 368 368 368
1 1 1 1 1 1 3 1 1 1 1 1 1 1 1 1 1 1 1 1 1 1 1 554 555 556 1 1 1 1 554 563 563 556 1 1 1 1 563 563 563 1 112 1 1 134 1 1 1 133 1 1 1 1 581 582 583 597 114 1 114 390 406 407 412 430 430 431 368 368 429 430 430 430 431 368 368 368 368 368
1 1 1 1 1 1 1 1 554 555 555 555 555 555 555 555 555 555 555 555 555 555 555 563 563 563 555 555 555 555 563 563 563 555 555 555 555 555 563 563 563 1 120 121 121 691 111 1 1 133 1 1 1 1 1 1 1 1 114 1 114 292 292 390 406 406 407 412 430 430 411 414 414 414 439 368 368 368 368 368
462 463 462 463 1 1 1 1 570 571 571 571 571 571 571 563 563 571 571 571 571 571 571 571 571 571 571 571 571 571 563 563 563 563 563 563 563 563 563 563 563 1 1 1 1 1 133 1 1 141 135 135 111 1 1 1 1 1 114 1 114 292 292 292 292 292 415 414 405 406 407 414 414 414 439 368 368 368 368 368
470 469 468 471 1 1 1 1 1 1 1 1 1 1 1 1 1 1 1 1 704 705 705 705 705 705 706 1 1 1 564 563 563 563 1 1 1 1 1 1 1 1 1 1 1 1 133 1 1 1 1 1 133 1 1 1 1 1 114 1 114 292 292 292 292 292 415 414 413 292 415 414 414 414 439 368 368 368 373 374
476 477 476 477 462 463 462 463 592 593 595 586 586 596 593 593 593 593 593 593 712 713 713 713 713 713 714 593 593 594 1 562 564 1 1 1 1 1 1 1 1 1 1 1 1 1 133 1 1 1 1 1 133 1 1 1 1 1 114 1 114 292 292 292 292 398 423 414 421 422 423 414 414 420 447 368 336 337 381 382
468 469 468 469 468 469 468 471 4 4 603 566 566 604 1 1 1 1 462 463 712 713 713 713 713 713 714 462 463 1 1 562 564 1 1 1 1 659 660 660 661 1 1 1 1 1 141 135 135 135 135 135 692 124 124 175 207 124 125 116 146 292 292 398 422 423 414 414 414 414 414 414 414 439 368 368 344 345 368 368
484 485 484 498 499 498 499 487 4 4 573 574 575 589 1 1 1 1 470 471 712 713 713 713 713 713 714 470 471 1 1 562 564 1 1 1 659 662 668 668 663 661 1 1 1 1 1 1 1 1 1 1 116 145 145 175 207 145 145 146 292 398 422 423 414 414 414 414 414 414 414 420 446 447 368 368 373 374 368 368
124 124 137 468 469 468 469 1 1 1 581 582 583 597 1 1 1 4 476 477 720 721 721 721 721 721 722 476 477 4 1 562 564 1 1 1 667 670 703 703 671 669 4 4 4 1 1 1 1 1 1 1 114 292 292 292 292 292 398 422 422 423 414 405 406 406 407 414 414 414 420 447 368 368 368 368 381 382 368 368
393 385 115 476 477 476 477 1 1 1 555 555 555 1 1 1 1 4 468 469 728 729 730 467 731 729 732 468 469 4 1 562 564 1 1 1 675 646 687 677 677 678 4 4 4 1 1 1 1 1 1 1 114 292 292 398 422 422 423 414 414 405 406 389 292 292 415 414 414 420 447 368 368 368 368 336 337 368 368 368
368 402 115 468 469 468 469 1 1 555 555 555 555 1 1 1 1 4 486 487 736 737 738 475 739 737 740 486 487 3 1 563 564 1 1 3 683 654 695 685 685 686 4 4 4 1 1 1 1 116 121 121 146 398 422 423 414 414 414 414 414 413 292 292 292 398 423 414 414 439 368 368 368 368 368 344 345 368 368 368
368 402 115 476 477 476 477 1 555 555 555 555 555 555 555 555 563 555 563 555 555 555 555 555 555 555 555 555 555 555 555 563 563 555 555 555 555 555 555 555 555 555 555 555 1 1 1 1 1 114 292 398 422 423 414 405 406 406 406 407 414 421 422 422 422 423 414 414 414 439 368 368 368 368 373 374 368 368 368 368
368 402 115 468 469 468 469 563 555 555 555 555 555 555 555 555 555 555 555 563 563 563 563 563 563 563 563 563 563 563 563 570 571 571 571 571 571 571 571 571 571 571 571 571 1 1 1 1 1 114 292 415 414 414 414 413 292 292 292 390 407 414 414 414 414 414 414 414 404 439 368 368 368 368 381 382 368 368 368 368
368 402 115 476 477 476 477 563 563 840 841 841 841 841 841 842 1 1 1 1 1 4 4 4 4 4 1 1 1 1 1 1 1 1 1 1 1 1 1 1 1 1 1 1 116 121 121 121 121 146 292 415 414 414 414 421 397 292 292 292 390 406 407 414 414 414 414 414 420 447 368 368 368 368 368 373 374 368 368 368
368 402 115 468 469 468 469 563 563 848 849 849 849 849 849 850 124 124 124 124 124 124 124 124 124 137 1 1 1 1 1 1 1 1 1 1 1 1 1 1 116 121 121 121 146 292 226 292 292 292 398 423 414 414 414 405 389 292 292 292 292 292 415 414 414 414 414 420 447 368 368 368 368 368 368 381 382 368 368 368
368 402 115 486 498 499 487 563 563 848 849 849 849 849 849 850 393 393 393 393 393 393 393 393 385 123 124 137 1 1 1 1 1 1 116 121 121 121 121 121 146 292 292 292 292 292 292 292 292 292 415 414 414 414 414 413 292 292 292 398 422 422 423 414 414 420 446 447 368 368 368 368 368 370 379 372 368 368 368 368
368 402 123 137 468 469 3 563 563 856 857 857 857 857 857 858 368 368 368 368 368 368 368 368 410 393 385 115 1 1 1 1 1 1 117 292 292 292 292 292 292 292 292 292 292 292 292 292 398 422 423 414 414 414 414 421 422 422 422 423 414 414 414 414 414 439 368 368 368 368 368 368 368 378 113 380 368 368 368 368
368 410 385 115 486 487 1 563 563 859 843 844 845 846 847 860 368 368 368 368 368 368 368 368 368 368 402 115 1 1 1 1 1 1 117 292 226 292 292 292 292 292 292 292 292 292 292 398 423 414 405 406 406 407 414 414 414 414 414 414 414 414 414 414 404 439 368 368 368 368 368 368 368 378 113 380 368 368 368 368
368 368 402 115 1 1 1 563 563 861 851 852 743 854 851 862 2 2 578 368 368 368 368 368 368 368 402 115 1 1 1 1 1 1 117 292 292 292 292 292 292 292 292 292 292 292 292 415 414 414 413 292 292 415 414 414 414 414 414 414 414 414 414 414 414 439 368 368 368 368 368 368 368 386 121 388 368 368 368 368
368 368 402 115 1 1 1 563 563 563 563 563 563 563 563 1 1 1 117 377 368 368 368 368 368 368 402 123 124 137 1 1 1 1 2 2 130 292 292 292 292 292 292 292 226 292 292 415 414 414 413 292 292 415 414 414 414 414 414 414 414 576 414 414 414 439 368 368 368 368 368 368 336 337 368 368 368 368 368 368
368 368 402 115 1 1 1 1 563 563 563 563 563 563 1 1 1 1 117 400 368 368 368 368 368 368 410 393 385 115 1 1 1 1 1 1 2 2 2 2 212 130 292 292 292 292 292 390 407 414 421 397 292 415 414 414 404 414 350 2 2 674 2 2 715 447 368 368 368 368 368 368 344 345 368 368 368 368 368 368
368 368 402 123 124 137 1 1 1 1 1 1 1 1 1 1 1 1 117 400 368 368 368 368 368 368 368 368 402 123 137 1 1 1 1 1 1 1 1 1 1 2 2 2 2 2 212 130 415 414 414 421 422 423 414 414 414 414 358 1 1 1 1 1 117 377 368 336 337 368 368 373 374 368 368 368 368 368 368 368
368 368 410 393 385 123 124 124 137 1 1 1 1 1 116 124 124 124 125 400 368 368 368 368 368 368 368 368 410 385 115 1 1 1 1 1 1 1 1 1 1 1 1 1 1 1 1 2 2 2 2 2 2 2 2 2 2 2 2 1 1 1 1 1 117 356 337 344 345 336 337 381 382 368 368 368 368 368 368 368
368 368 368 368 410 393 393 385 123 124 124 124 124 124 125 384 393 393 393 408 368 368 368 368 368 368 368 368 368 402 123 124 124 137 1 1 1 1 1 1 1 1 1 1 1 1 1 1 1 1 1 1 116 124 124 124 124 124 137 1 1 1 1 1 117 364 345 368 368 344 345 368 368 368 368 368 368 368 368 368
368 368 368 368 368 368 368 410 393 393 393 393 393 393 393 408 368 368 368 368 368 368 368 368 368 368 368 368 368 410 393 393 385 123 124 124 124 124 124 124 124 124 124 124 124 124 124 124 124 124 124 124 125 384 393 393 393 385 123 124 124 124 124 124 125 400 368 368 368 368 368 368 368 368 368 368 368 368 368 368
368 368 368 368 368 368 368 368 368 368 368 368 368 368 368 368 368 368 368 368 368 368 368 368 368 368 368 368 368 368 368 368 410 393 393 393 393 393 393 393 393 393 393 393 393 393 393 393 393 393 393 393 393 408 368 368 368 410 393 393 393 393 393 393 393 408 368 368 368 368 368 368 368 368 368 368 368 368 368 368