LilycoveCity_DepartmentStore_4F_Layout (18x8)
648 636 637 638 648 784 784 648 648 784 784 648 781 777 782 781 777 782
656 644 645 646 656 785 785 656 656 785 785 656 775 592 783 775 593 783
523 662 695 663 520 520 520 520 520 520 520 520 520 520 520 520 520 520
518 513 513 513 513 513 513 513 513 513 513 513 513 513 513 513 513 513
518 513 513 513 513 513 733 667 667 667 733 513 513 513 513 513 513 513
518 682 683 516 513 513 670 675 675 675 670 518 513 682 683 682 683 516
518 690 691 518 513 513 676 523 520 520 670 518 513 690 691 690 691 518
518 527 520 514 513 513 734 518 513 513 721 518 513 527 520 520 520 514