LilycoveCity_CoveLilyMotel_1F_Layout (12x9)
739 530 609 532 535 702 703 533 535 533 534 740
747 538 523 540 543 710 711 672 543 541 542 748
755 545 545 545 545 718 719 680 545 545 576 756
545 553 553 553 553 553 553 553 553 553 553 553
545 580 590 591 580 553 553 580 590 607 580 553
545 580 598 599 580 553 553 580 598 599 580 553
545 553 553 553 553 553 553 553 553 553 553 553
800 792 792 792 792 792 792 792 792 792 792 792
803 795 795 795 795 528 529 795 795 795 795 795