LilycoveCity_DepartmentStore_3F_Layout (18x8)
648 636 637 638 648 648 648 653 639 639 639 648 781 777 782 781 777 782
656 644 645 646 656 656 668 661 647 647 647 669 775 593 783 775 592 783
523 662 687 663 520 520 676 579 686 686 686 677 523 520 520 520 520 520
518 513 513 513 513 513 684 674 674 674 674 685 518 513 513 513 513 513
518 513 555 556 516 513 527 520 520 520 520 520 514 513 555 556 516 513
518 513 563 564 518 513 513 513 513 513 513 513 513 513 563 564 518 513
518 513 571 572 518 513 513 513 513 513 513 513 513 513 571 572 518 513
518 513 527 520 514 513 513 513 513 513 513 513 513 513 527 520 514 513