LilycoveCity_House2_Layout (8x8)
739 689 690 535 535 702 703 740
747 697 698 543 543 710 711 748
755 705 706 545 545 718 719 756
601 590 591 553 553 553 553 553
601 598 599 580 553 553 553 553
545 553 553 553 553 553 553 553
800 792 792 792 792 792 792 792
803 795 528 529 795 795 795 795