LilycoveCity_LilycoveMuseum_1F_Layout (21x14)
523 536 537 523 523 538 539 523 523 540 523 541 523 529 523 517 518 519 523 542 543
531 544 545 531 531 546 547 531 531 548 531 549 531 529 531 525 526 527 531 550 551
515 515 515 515 515 515 515 515 515 515 515 515 515 516 515 515 515 515 515 515 515
515 514 514 514 514 514 514 514 514 514 514 514 514 524 515 514 514 514 514 514 514
520 521 521 521 521 521 521 521 521 530 514 514 514 532 515 514 514 514 514 514 514
523 523 557 558 523 523 559 523 523 651 515 514 514 515 515 514 514 514 514 514 514
531 531 565 566 531 531 567 531 531 516 515 514 514 514 514 570 571 571 571 572 514
515 515 515 515 515 515 515 515 515 524 515 514 514 514 514 578 552 553 554 580 591
515 514 514 514 514 514 514 514 514 532 515 514 514 514 514 586 560 561 562 588 591
515 570 571 571 571 571 572 514 514 515 515 514 514 514 514 594 595 595 595 596 591
515 584 595 577 595 576 585 574 514 514 514 514 514 514 514 575 575 575 575 575 582
515 528 589 575 575 575 528 591 514 514 514 514 514 514 514 555 514 514 556 574 514
515 568 564 571 571 571 569 591 514 514 514 514 514 514 514 563 574 514 575 582 514
515 594 595 595 595 595 596 591 514 534 535 514 514 514 514 575 582 514 514 514 514