LilycoveCity_DepartmentStore_5F_Layout (18x8)
743 770 637 771 743 743 739 736 737 738 739 743 776 777 778 776 777 778
751 772 645 773 751 763 747 744 745 746 747 767 779 593 780 779 592 780
755 768 703 769 756 676 766 758 758 758 758 677 755 756 756 756 756 756
762 754 754 754 754 684 674 674 674 674 674 685 762 754 754 754 754 754
762 754 682 683 757 764 756 756 756 756 756 756 765 754 774 759 759 759
762 754 563 564 762 754 682 683 757 754 682 683 757 754 670 675 675 675
762 754 690 691 762 754 690 691 762 754 690 691 762 754 670 755 756 756
762 754 764 756 765 754 764 756 765 754 764 756 765 754 721 762 754 754