LilycoveCity_DepartmentStore_2F_Layout (18x8)
648 636 637 638 648 648 648 784 648 648 784 648 781 777 782 781 777 782
656 644 645 646 656 656 656 785 656 656 785 656 775 592 783 775 593 783
523 662 679 663 520 520 520 520 520 520 520 520 520 520 520 520 520 520
518 513 513 513 513 513 513 513 513 513 513 513 513 513 513 513 513 621
518 513 682 683 516 513 733 667 667 667 667 733 513 513 682 683 516 629
518 513 563 564 518 513 670 675 675 675 675 670 518 513 563 564 518 513
518 513 690 691 518 513 676 523 520 520 520 670 518 513 690 691 518 621
518 513 527 520 514 513 734 518 513 513 513 721 518 513 527 520 514 629