LilycoveCity_ContestHall_Layout (51x33)
515 515 515 515 515 515 515 515 515 539 559 559 559 559 559 559 559 559 559 559 559 559 559 559 559 559 559 559 559 559 559 559 559 559 559 559 559 559 559 559 559 538 515 515 515 515 515 515 515 515 515
515 515 515 515 515 515 515 515 515 514 529 529 529 638 529 529 529 529 529 646 529 529 529 529 529 662 529 529 529 529 529 630 529 529 529 529 529 654 529 529 529 523 515 515 515 515 515 515 515 515 515
515 515 515 515 539 559 559 559 559 522 531 531 531 656 531 531 531 531 531 664 531 531 531 531 531 680 531 531 531 531 531 648 531 531 531 531 531 672 531 531 531 520 559 559 559 559 538 515 515 515 515
515 515 515 515 514 529 572 573 574 530 610 610 610 610 610 610 610 610 610 610 610 610 610 610 610 610 610 610 610 610 610 610 610 610 610 610 610 610 610 610 610 528 572 573 574 529 523 515 515 515 515
559 559 559 559 522 531 580 581 582 558 544 545 545 545 545 545 545 545 545 545 545 545 545 545 545 545 545 545 545 545 545 545 545 545 545 545 545 545 545 545 546 556 580 581 582 531 520 559 559 559 559
529 572 573 574 530 610 610 610 610 566 552 608 608 608 608 608 608 608 608 608 608 608 608 608 608 608 608 608 608 608 608 608 608 608 608 608 608 608 608 608 554 564 610 610 610 610 528 572 573 574 529
531 580 581 582 558 544 545 545 545 545 560 608 608 608 608 608 608 608 608 608 608 608 608 608 608 608 608 608 608 608 608 608 608 608 608 608 608 608 608 608 562 545 545 545 545 546 556 580 581 582 531
610 610 610 610 566 552 608 608 608 608 608 608 608 608 608 608 608 608 524 525 525 525 525 525 525 525 525 525 525 525 525 525 526 614 608 608 608 608 608 608 608 608 608 608 608 554 564 610 610 610 610
544 545 545 545 545 560 608 608 586 608 608 608 608 608 608 608 608 608 548 549 549 549 549 549 549 549 549 549 549 549 549 549 550 614 608 608 608 608 608 608 608 608 586 608 608 562 545 545 545 545 546
552 608 608 608 608 608 608 608 594 608 608 608 608 608 608 608 608 608 548 549 549 616 617 617 617 617 617 617 617 618 549 549 550 614 608 608 608 608 608 608 608 608 594 608 608 608 608 608 608 608 554
552 608 586 608 608 586 608 608 608 608 608 608 584 608 584 608 608 608 548 549 549 624 625 625 625 625 625 623 625 626 549 549 550 614 608 608 585 608 585 608 608 608 608 608 608 586 608 608 586 608 554
552 608 594 608 608 594 608 608 608 608 608 608 592 608 592 608 608 608 548 549 549 624 625 625 625 657 625 631 625 626 549 549 550 614 608 608 593 608 593 608 608 608 608 608 608 594 608 608 594 608 554
552 608 608 608 608 608 608 608 608 608 608 608 600 608 600 608 608 608 548 549 549 624 625 625 625 665 625 625 625 626 549 549 550 614 608 608 601 608 601 608 608 608 608 608 608 608 608 608 608 608 554
552 608 608 608 608 608 608 608 608 608 608 608 608 608 608 608 608 608 548 549 549 624 625 625 625 625 625 625 625 626 549 549 550 614 608 608 608 608 608 608 608 608 608 608 608 608 608 608 608 608 554
552 608 608 608 608 608 608 608 608 608 608 608 584 608 584 608 608 608 548 549 549 632 633 633 635 636 637 633 633 634 549 549 550 614 608 608 585 608 585 608 608 608 608 608 608 608 608 608 608 608 554
552 608 608 608 608 608 608 608 608 608 608 608 592 608 592 608 608 608 532 533 533 533 533 533 643 644 645 533 533 533 533 533 534 614 608 608 593 608 593 608 608 608 608 608 608 608 608 608 608 608 554
552 608 608 608 608 608 608 608 608 608 608 608 608 608 608 608 608 608 540 541 541 541 541 537 643 644 645 537 541 541 541 541 542 614 608 608 608 608 608 608 608 608 608 608 608 608 608 608 608 608 554
552 608 608 608 608 608 608 608 608 608 608 608 608 608 608 608 608 608 710 607 607 607 607 607 607 607 607 607 607 607 607 607 607 615 608 608 608 608 608 608 608 608 608 608 608 608 608 608 608 608 554
552 608 608 608 608 608 608 608 608 608 608 608 608 608 608 608 608 608 608 608 608 608 608 608 608 608 608 608 608 608 608 608 608 608 608 608 608 608 608 608 608 608 608 608 608 608 608 608 608 608 554
552 608 608 608 608 608 524 525 525 525 525 525 525 525 525 525 525 525 525 525 526 614 608 608 608 608 608 608 608 608 524 525 525 525 525 525 525 525 525 525 525 525 525 525 526 614 608 608 608 608 554
552 608 608 608 608 608 548 549 549 549 549 549 549 549 549 549 549 549 549 549 550 614 608 608 608 608 608 608 608 608 548 549 549 549 549 549 549 549 549 549 549 549 549 549 550 614 608 608 608 608 554
552 608 608 608 608 608 548 549 549 616 617 617 617 617 617 617 617 618 549 549 550 614 585 608 608 608 608 608 584 608 548 549 549 616 617 617 617 617 617 617 617 618 549 549 550 614 608 608 608 608 554
552 608 584 608 584 608 548 549 549 624 625 625 625 625 625 623 625 626 549 549 550 614 593 608 608 608 608 608 592 608 548 549 549 624 625 625 625 625 625 623 625 626 549 549 550 614 585 608 585 608 554
552 608 592 608 592 608 548 549 549 624 625 625 625 673 625 631 625 626 549 549 550 614 601 608 608 608 608 608 600 608 548 549 549 624 625 625 625 658 625 631 625 626 549 549 550 614 593 608 593 608 554
552 608 600 608 600 608 548 549 549 624 625 625 625 681 625 625 625 626 549 549 550 614 608 608 608 608 608 608 608 608 548 549 549 624 625 625 625 666 625 625 625 626 549 549 550 614 601 608 601 608 554
552 608 608 608 608 608 548 549 549 624 625 625 625 625 625 625 625 626 549 549 550 614 585 608 608 608 608 608 584 608 548 549 549 624 625 625 625 625 625 625 625 626 549 549 550 614 608 608 608 608 554
552 608 584 608 584 608 548 549 549 632 633 633 651 652 653 633 633 634 549 549 550 614 593 608 608 608 608 608 592 608 548 549 549 632 633 633 683 684 685 633 633 634 549 549 550 614 585 608 585 608 554
552 608 592 608 592 608 532 533 533 533 533 533 659 660 661 533 533 533 533 533 534 614 601 608 608 608 608 608 600 608 532 533 533 533 533 533 691 692 693 533 533 533 533 533 534 614 593 608 593 608 554
552 608 600 608 600 608 540 541 541 541 541 537 659 660 661 537 541 541 541 541 542 614 608 608 608 608 608 608 608 608 540 541 541 541 541 537 691 692 693 537 541 541 541 541 542 614 601 608 601 608 554
552 608 608 608 608 608 710 607 607 607 607 607 607 607 607 607 607 607 607 607 607 615 608 608 608 608 608 608 608 608 710 607 607 607 607 607 607 607 607 607 607 607 607 607 607 615 608 608 608 608 554
552 608 608 608 608 608 608 608 608 608 608 608 608 608 608 608 608 608 608 608 608 608 608 608 608 608 608 608 608 608 608 608 608 608 608 608 608 608 608 608 608 608 608 608 608 608 608 608 608 608 554
552 608 608 586 608 608 608 586 608 608 608 586 608 608 608 608 608 608 608 608 608 608 608 608 608 608 608 608 608 608 608 608 608 608 608 608 608 608 608 586 608 608 608 586 608 608 608 586 608 608 554
552 608 608 594 608 608 608 594 608 608 608 594 608 608 608 608 608 608 608 516 517 608 608 608 608 608 608 608 608 608 516 517 608 608 608 608 608 608 608 594 608 608 608 594 608 608 608 594 608 608 554