LilycoveCity_DepartmentStore_1F_Layout (18x8)
648 636 637 638 648 648 648 648 648 648 648 648 648 648 648 781 777 782
656 644 645 646 656 656 668 656 656 656 656 669 656 656 656 775 592 783
632 654 671 655 624 624 676 724 664 665 664 677 632 624 624 624 624 624
640 616 616 616 616 616 684 673 672 673 672 685 640 616 616 616 622 616
735 615 616 616 616 616 625 624 624 624 624 624 633 616 616 616 616 616
609 610 616 616 616 616 616 616 616 616 616 616 616 616 616 616 622 616
735 615 616 616 616 616 616 616 616 616 616 616 616 616 620 616 620 620
609 610 616 616 616 616 616 616 534 535 616 616 616 616 628 616 628 628