LinkContestRoom6_Layout (15x11)
608 608 608 608 608 608 608 608 608 608 608 608 608 608 608
524 525 525 525 525 525 525 525 525 525 525 525 525 525 526
548 549 549 549 549 549 549 549 549 549 549 549 549 549 550
548 549 549 616 617 617 617 617 617 617 617 618 549 549 550
548 549 549 624 625 625 625 625 625 623 625 626 549 549 550
548 549 549 624 625 625 625 658 625 631 625 626 549 549 550
548 549 549 624 625 625 625 666 625 625 625 626 549 549 550
548 549 549 624 625 625 625 625 625 625 625 626 549 549 550
548 549 549 632 633 633 683 684 685 633 633 634 549 549 550
532 533 533 533 533 533 691 692 693 533 533 533 533 533 534
540 541 541 541 541 537 691 692 693 537 541 541 541 541 542