LinkContestRoom2_Layout (15x11)
608 608 608 608 608 608 608 608 608 608 608 608 608 608 608
524 525 525 525 525 525 525 525 525 525 525 525 525 525 526
548 549 549 549 549 549 549 549 549 549 549 549 549 549 550
548 549 549 616 617 617 617 617 617 617 617 618 549 549 550
548 549 549 624 625 625 625 625 625 623 625 626 549 549 550
548 549 549 624 625 625 625 657 625 631 625 626 549 549 550
548 549 549 624 625 625 625 665 625 625 625 626 549 549 550
548 549 549 624 625 625 625 625 625 625 625 626 549 549 550
548 549 549 632 633 633 635 636 637 633 633 634 549 549 550
532 533 533 533 533 533 643 644 645 533 533 533 533 533 534
540 541 541 541 541 537 643 644 645 537 541 541 541 541 542