LinkContestRoom5_Layout (15x11)
608 608 608 608 608 608 608 608 608 608 608 608 608 608 608
524 525 525 525 525 525 525 525 525 525 525 525 525 525 526
548 549 549 549 549 549 549 549 549 549 549 549 549 549 550
548 549 549 616 617 617 617 617 617 617 617 618 549 549 550
548 549 549 624 625 625 625 625 625 623 625 626 549 549 550
548 549 549 624 625 625 625 673 625 631 625 626 549 549 550
548 549 549 624 625 625 625 681 625 625 625 626 549 549 550
548 549 549 624 625 625 625 625 625 625 625 626 549 549 550
548 549 549 632 633 633 651 652 653 633 633 634 549 549 550
532 533 533 533 533 533 659 660 661 533 533 533 533 533 534
540 541 541 541 541 537 659 660 661 537 541 541 541 541 542