LittlerootTown_Layout (20x20)
468 469 468 469 468 469 468 469 468 469 1 1 468 469 468 469 468 469 468 469
476 477 484 485 484 485 484 485 484 487 1 1 486 485 484 485 484 485 476 477
468 469 1 1 1 1 1 1 1 1 1 1 1 1 1 1 1 1 468 469
484 487 1 1 1 1 1 1 1 1 1 1 1 1 1 1 1 1 486 485
1 1 520 521 521 521 522 1 1 1 1 1 1 520 521 521 521 522 1 1
1 1 528 529 529 529 530 1 1 1 1 1 1 528 529 529 529 530 1 1
1 1 536 537 537 537 538 1 1 1 1 1 1 536 537 537 537 538 1 1
1 1 546 562 560 576 545 1 1 1 1 1 1 544 576 561 562 547 1 4
4 1 554 570 568 584 553 3 1 1 1 1 3 552 584 569 570 555 4 1
1 4 1 1 1 513 1 1 1 1 1 1 1 1 513 1 1 1 1 4
4 1 1 4 1 1 1 1 1 1 1 1 1 1 1 1 4 1 4 1
1 1 1 1 1 1 1 1 1 1 1 1 1 1 1 1 1 1 1 1
1 1 1 524 578 579 525 525 525 526 1 1 1 1 1 1 1 1 1 1
1 1 1 532 586 587 533 533 533 534 1 1 1 1 1 3 1 1 1 1
1 1 1 532 533 533 533 533 533 534 1 1 1 1 1 1 1 1 1 1
1 1 1 542 527 527 556 577 557 543 1 1 1 1 1 1 1 1 462 463
1 1 1 550 535 535 564 585 565 551 1 1 1 1 1 1 1 1 470 469
462 463 1 4 4 4 3 513 1 1 1 1 1 1 1 1 462 463 476 477
468 471 1 4 4 4 1 1 1 1 1 1 1 1 1 1 470 469 468 469
476 477 462 463 462 463 462 463 462 463 462 463 462 463 462 463 476 477 476 477