LittlerootTown_BrendansHouse_2F_Layout (9x8)
594 596 592 596 598 551 523 524 525
602 603 597 613 2 559 531 532 533
610 611 632 614 605 632 518 517 519
635 636 637 513 664 665 665 666 513
643 644 645 513 672 673 673 674 513
651 652 653 513 672 673 673 674 513
516 513 513 513 680 681 681 682 513
516 513 513 513 513 513 513 513 513