MagmaHideout_B2F_Layout (34x24)
513 513 513 513 513 513 529 595 596 537 537 691 692 693 529 537 537 691 692 693 892 893 894 895 537 537 892 893 894 895 537 537 537 529
513 513 513 513 513 513 521 603 604 560 561 699 700 701 522 545 545 699 700 701 563 564 565 566 545 545 563 564 565 566 545 545 545 522
529 736 691 692 693 736 528 611 612 568 569 710 553 711 522 553 553 710 553 711 571 572 573 574 553 553 571 572 573 574 553 553 553 522
522 543 699 700 701 545 544 619 620 673 552 552 552 552 522 553 552 552 552 552 579 580 581 582 552 552 579 580 581 582 673 552 552 522
522 551 710 553 711 553 531 553 552 552 552 552 552 552 522 553 552 552 552 552 587 588 589 590 552 552 587 588 589 590 673 735 552 522
522 559 552 552 552 552 514 577 578 514 514 552 552 552 522 553 642 643 552 552 552 597 598 673 552 552 552 597 598 673 552 552 552 522
522 559 552 552 552 552 514 585 586 517 514 552 552 552 522 553 648 649 562 673 552 552 552 552 552 552 552 554 554 681 552 552 552 522
522 553 552 552 552 552 514 541 514 514 514 552 552 552 522 553 656 657 570 673 552 552 552 552 552 552 642 643 552 642 643 552 552 522
522 553 552 552 552 552 514 514 514 514 514 552 552 552 522 553 554 554 681 552 552 552 552 552 552 552 648 649 562 648 649 673 552 522
521 523 601 542 601 601 601 601 601 601 601 601 601 601 521 523 601 601 601 601 601 601 601 542 552 552 656 657 570 656 657 673 552 522
529 736 736 529 736 736 736 736 736 736 736 736 736 736 529 736 736 736 736 736 736 736 736 528 552 552 554 554 681 554 554 681 552 522
522 560 561 522 545 545 545 545 545 545 545 545 545 545 522 545 545 545 545 545 545 545 545 544 552 552 552 552 552 552 552 552 552 522
522 568 569 522 553 553 553 553 553 553 553 553 553 553 521 553 553 553 553 553 553 553 553 531 552 552 552 552 552 542 601 601 601 521
522 553 552 522 553 552 552 552 552 552 552 552 735 552 528 553 552 735 552 552 552 552 552 552 552 552 552 552 552 528 736 736 736 529
522 553 735 522 553 552 552 552 552 552 552 552 552 552 544 654 617 617 617 617 617 617 617 617 617 617 617 617 606 544 545 545 545 522
522 553 552 522 553 552 552 552 624 617 617 617 617 614 531 384 393 393 393 393 393 393 393 393 393 393 393 385 678 531 553 553 553 522
522 553 552 521 553 552 552 552 608 384 393 393 393 393 393 408 368 368 368 368 368 342 342 342 342 342 342 402 610 673 552 735 552 522
522 553 552 528 553 552 552 552 608 400 368 368 368 368 368 368 342 342 342 342 342 327 327 327 327 327 342 402 610 673 552 552 552 522
522 553 552 544 553 552 552 552 632 400 368 368 368 342 342 342 327 327 327 327 327 327 327 327 327 327 342 402 610 673 552 552 552 522
522 553 552 531 553 552 552 552 554 400 368 342 342 327 327 327 327 327 327 327 327 327 327 327 327 327 342 402 610 673 552 552 552 522
522 553 552 552 552 552 552 552 662 400 342 327 327 327 327 327 327 327 327 327 327 327 327 327 327 327 342 402 610 673 552 552 552 522
521 523 601 601 601 601 601 542 608 400 342 327 327 327 327 327 327 327 327 327 327 327 327 327 327 327 342 402 610 891 552 552 552 521
528 736 736 736 736 736 736 528 608 400 342 327 327 327 327 327 327 327 327 327 327 327 327 327 327 327 342 402 610 528 736 736 736 528
544 545 545 545 545 545 545 544 616 617 617 617 617 617 617 617 617 617 617 617 617 617 617 617 617 617 617 617 618 544 545 545 545 544