MagmaHideout_B1F_Layout (62x24)
513 513 513 513 513 513 513 513 513 513 513 513 513 513 513 513 513 513 529 537 537 537 707 708 709 529 537 537 707 708 709 537 537 537 537 537 537 537 537 537 537 537 537 537 529 513 513 513 513 513 513 529 736 736 736 736 736 736 736 736 736 529
513 513 513 513 513 513 513 513 513 513 513 513 513 513 513 513 513 513 521 560 561 545 715 716 717 522 560 561 715 716 717 545 545 545 545 545 545 545 984 985 984 985 543 543 522 513 513 513 513 513 513 522 984 985 545 545 545 984 985 984 985 522
529 736 707 708 709 595 596 537 537 537 537 529 537 707 708 709 595 596 529 568 569 553 710 553 711 522 568 569 710 553 711 553 553 553 553 553 553 553 988 989 986 987 559 559 522 513 513 513 513 513 513 522 986 987 553 553 553 986 987 986 987 522
522 545 715 716 717 603 604 560 561 545 545 522 543 715 716 717 603 604 522 553 552 552 552 552 552 522 553 552 552 552 552 514 577 578 514 514 552 552 554 554 988 989 567 567 522 513 513 513 513 513 513 522 988 989 673 552 735 988 989 986 987 522
522 553 710 553 711 611 612 568 569 553 553 522 551 710 553 711 611 612 522 553 552 552 552 552 552 522 553 552 552 552 552 514 585 586 517 514 552 552 552 552 554 554 554 554 522 513 513 513 513 513 513 522 553 554 681 552 552 554 554 988 989 522
522 553 552 552 552 619 620 552 735 552 552 522 559 673 552 552 619 620 522 553 552 552 552 735 552 522 553 552 552 552 552 514 541 514 514 514 552 552 552 735 552 552 552 552 522 513 513 513 513 513 513 522 553 735 552 552 735 552 552 735 552 522
522 553 552 552 552 552 552 552 552 552 552 522 551 673 552 552 552 552 522 553 514 577 578 514 514 521 523 601 601 601 601 601 601 601 601 542 601 601 601 601 601 601 601 601 521 513 513 513 513 513 513 522 994 621 621 621 621 621 621 621 623 522
522 553 552 552 552 552 552 552 735 552 552 522 559 673 552 552 552 552 522 553 514 585 586 517 514 529 736 736 725 724 725 736 736 736 736 529 736 736 736 736 736 736 736 736 529 513 513 513 513 513 513 522 630 113 113 113 113 113 113 113 631 522
521 523 601 601 601 601 601 601 601 601 601 521 553 681 735 552 552 552 522 553 514 541 514 514 514 522 995 995 548 547 548 545 545 526 527 522 560 560 561 545 984 985 984 985 522 513 513 513 513 513 513 522 638 121 121 121 121 121 121 121 639 522
528 736 736 736 736 736 736 736 736 736 736 529 553 552 552 552 552 552 522 553 552 552 552 552 552 522 1002 1002 998 1011 1012 998 1013 534 535 522 568 568 569 553 988 989 986 987 522 513 513 513 513 513 513 522 553 735 552 552 735 552 552 735 552 522
544 545 545 545 545 545 545 545 545 545 545 521 523 601 601 601 601 601 521 523 601 601 601 601 601 521 897 896 997 963 965 997 1021 997 997 522 553 552 552 552 554 554 988 989 522 513 513 513 513 513 513 522 994 621 621 621 621 621 621 621 623 522
513 513 513 513 513 513 513 513 513 513 513 529 555 556 557 558 736 736 529 736 736 736 736 736 736 529 897 896 997 1019 1020 997 1018 997 735 522 553 552 735 552 552 735 554 554 522 513 513 513 513 513 513 522 630 113 113 113 113 113 113 113 631 522
513 513 513 513 513 513 513 513 513 513 513 522 563 564 565 566 560 561 522 560 560 561 561 545 545 521 1006 1005 1005 1005 1005 1005 1005 1005 1005 521 523 601 601 601 601 601 601 601 521 513 513 513 513 513 513 522 638 121 121 121 121 121 121 121 639 522
513 513 513 513 513 513 513 513 513 513 513 522 571 572 573 574 568 569 522 568 568 569 569 553 553 528 736 736 736 736 736 736 736 736 736 528 736 736 736 736 736 736 736 736 529 513 513 513 513 513 513 522 553 735 552 552 735 552 552 735 552 522
513 513 513 513 513 513 513 513 513 513 513 522 579 580 581 582 553 645 522 553 552 735 552 552 552 544 545 545 545 545 545 545 545 545 545 544 545 545 545 545 545 545 545 545 522 513 513 513 513 513 513 522 994 621 621 621 621 621 621 621 623 522
513 513 513 513 513 513 513 513 513 513 513 522 587 588 589 590 553 552 522 553 552 552 552 552 552 531 553 553 553 553 553 553 553 553 553 531 553 553 553 553 553 553 553 553 522 513 513 513 513 513 513 522 630 113 113 113 113 113 113 113 631 522
513 513 513 513 513 513 513 513 513 513 513 522 553 597 598 553 735 552 521 523 601 601 601 601 601 601 601 601 542 1001 514 514 514 514 514 514 514 514 514 514 514 514 552 552 522 513 513 513 513 513 513 522 638 121 121 121 121 121 121 121 639 522
513 513 513 513 513 513 513 513 513 513 513 522 553 553 553 553 552 552 529 736 736 736 736 736 736 736 736 736 528 993 524 525 514 577 578 514 514 576 578 1001 1001 514 552 552 522 513 513 513 513 513 513 522 553 735 552 552 735 552 552 735 552 522
513 513 513 513 513 513 513 513 513 513 513 522 553 552 552 552 984 985 522 545 545 545 545 545 545 545 545 545 544 1000 532 533 514 585 586 514 514 584 586 1000 1000 514 552 552 522 513 513 513 513 513 513 521 523 601 601 601 601 601 601 601 601 521
513 513 513 513 513 513 513 513 513 513 513 522 553 552 984 985 988 989 522 553 553 553 553 553 553 553 553 553 531 514 541 541 514 541 514 514 514 541 514 514 541 514 552 735 522 513 513 513 513 513 513 528 736 736 736 736 736 736 736 736 736 528
513 513 513 513 513 513 513 513 513 513 513 522 984 985 986 987 552 552 522 553 552 735 552 552 552 552 552 552 552 514 514 514 514 514 514 514 514 514 514 514 514 514 552 552 522 513 513 513 513 513 513 544 545 545 545 545 545 545 545 545 545 544
513 513 513 513 513 513 513 513 513 513 513 521 999 1007 999 1007 999 1007 521 523 601 601 601 601 601 601 601 601 601 601 601 601 601 601 601 601 601 601 601 601 601 601 601 601 521 513 513 513 513 513 513 513 513 513 513 513 513 513 513 513 513 513
513 513 513 513 513 513 513 513 513 513 513 528 736 736 736 736 736 736 528 736 736 736 736 736 736 736 736 736 736 736 736 736 736 736 736 736 736 736 736 736 736 736 736 736 528 513 513 513 513 513 513 513 513 513 513 513 513 513 513 513 513 513
513 513 513 513 513 513 513 513 513 513 513 544 545 545 545 545 545 545 544 545 545 545 545 545 545 545 545 545 545 545 545 545 545 545 545 545 545 545 545 545 545 545 545 545 544 513 513 513 513 513 513 513 513 513 513 513 513 513 513 513 513 513