MagmaHideout_1F_Layout (28x30)
513 529 595 596 537 537 540 539 537 537 537 537 691 692 693 537 537 537 537 537 537 537 540 539 537 537 529 513
513 522 603 604 562 561 548 547 545 545 545 545 699 700 701 545 545 545 545 545 562 561 548 547 543 543 522 513
513 522 611 612 570 569 553 553 553 553 553 553 710 553 711 553 553 553 553 553 570 569 553 553 551 551 522 513
513 522 619 620 673 552 552 552 552 552 552 552 552 552 552 552 552 552 552 552 552 552 552 552 551 551 522 513
513 522 543 543 543 673 552 552 622 605 617 617 617 617 617 617 617 606 623 552 552 552 552 552 559 559 522 513
513 522 551 559 559 673 552 622 115 608 554 554 554 554 554 554 554 678 117 623 552 552 552 552 559 551 522 513
513 522 559 551 559 673 552 630 115 616 617 617 617 617 617 617 617 618 117 631 553 552 552 552 554 559 522 513
513 522 551 559 689 681 552 630 123 124 124 124 124 124 124 124 124 124 125 631 553 552 552 552 552 554 522 513
513 522 559 689 681 552 552 638 145 145 145 145 145 145 145 145 145 145 145 639 553 552 552 552 552 552 522 513
513 522 553 681 552 552 552 553 553 553 553 553 553 553 553 553 553 553 553 553 553 552 552 552 552 552 522 513
513 522 553 552 552 552 552 552 552 552 552 552 552 552 552 552 552 552 552 552 552 552 552 552 552 552 522 513
513 522 663 617 617 617 617 617 617 617 617 617 614 552 552 613 617 617 617 617 617 617 617 617 617 617 522 513
513 522 889 889 889 889 889 889 889 889 889 889 739 175 207 888 889 889 889 889 889 889 889 889 889 889 522 513
513 522 553 553 553 553 553 553 553 553 553 553 553 553 553 553 553 553 553 553 553 553 553 553 553 553 522 513
513 522 553 552 552 552 552 552 552 552 552 552 552 552 552 552 552 552 552 552 552 552 552 552 552 552 522 513
513 522 663 617 617 617 617 617 617 617 617 617 614 552 552 613 617 617 617 617 617 617 617 617 617 617 522 513
513 522 889 889 889 889 889 889 889 889 889 889 890 175 207 888 889 889 889 889 889 889 889 889 889 889 522 513
513 522 553 553 553 553 553 553 553 553 553 553 553 553 553 553 553 553 553 553 553 553 553 553 553 553 522 513
513 522 553 552 552 552 552 552 552 552 552 552 552 552 552 552 552 552 552 552 552 552 552 552 552 552 522 513
513 522 650 643 552 605 617 617 617 617 617 617 614 552 552 613 617 617 617 617 617 617 606 665 642 643 522 513
513 522 648 649 552 608 116 124 124 124 124 124 124 175 207 124 124 124 124 124 124 137 676 673 648 649 522 513
513 522 656 657 552 608 117 107 108 108 108 148 113 113 113 113 147 108 108 108 109 115 676 673 656 657 522 513
513 522 553 554 552 608 117 115 116 124 124 156 113 113 113 113 155 124 124 137 117 115 676 673 554 554 522 513
513 522 650 643 552 608 117 115 117 113 113 113 113 113 113 113 113 113 113 115 117 115 676 673 642 643 522 513
513 522 648 649 673 608 117 115 117 113 113 113 113 113 113 113 113 113 113 115 117 115 676 673 648 649 522 513
513 522 656 657 673 608 117 155 156 113 113 113 113 113 113 113 113 113 113 155 156 115 676 673 656 657 522 513
513 522 553 554 681 616 617 617 617 617 614 109 384 393 385 107 613 617 617 617 617 617 618 673 554 554 522 513
513 522 621 621 621 190 190 190 190 190 623 117 400 615 402 115 622 190 190 190 190 190 190 190 621 621 522 513
513 522 113 113 113 113 113 113 113 113 117 191 712 713 714 190 115 113 113 113 113 113 113 113 113 113 522 513
513 191 108 108 108 108 108 108 108 108 191 108 108 108 108 108 190 108 108 108 108 108 108 108 108 108 190 513