MauvilleCity_GameCorner_Layout (22x11)
530 530 530 530 530 530 530 530 530 572 573 574 574 574 574 575 530 530 521 522 522 523
526 527 538 538 538 559 559 559 538 580 582 581 582 582 582 583 538 538 529 530 530 531
534 535 558 516 516 567 567 567 516 588 579 589 590 589 589 591 517 516 537 538 538 539
515 516 533 514 514 514 514 514 514 596 598 597 598 597 597 599 524 514 542 543 542 543
515 514 514 514 514 514 514 514 514 604 605 606 606 606 605 607 524 514 532 516 516 566
515 514 548 549 514 514 514 548 549 514 514 514 514 514 514 514 514 514 514 514 514 514
515 550 556 557 551 514 550 556 557 551 514 514 514 514 546 547 525 514 546 547 525 514
515 550 556 557 551 514 550 556 557 551 514 514 514 514 554 555 524 514 554 555 524 514
515 550 556 557 551 514 550 556 557 551 514 514 514 514 562 563 524 514 562 563 524 514
515 550 564 565 551 514 550 564 565 551 514 514 514 514 532 516 533 514 532 516 533 514
515 514 532 516 533 514 514 532 516 533 514 518 519 514 514 514 514 514 514 514 514 514