MauvilleCity_Layout (40x20)
648 1 4 1 4 1 4 4 1 4 1 1 650 1 1 264 94 266 1 1 648 1 14 198 198 198 198 198 198 198 198 198 198 198 198 198 198 198 198 198
648 1 4 1 4 426 427 427 427 427 428 1 650 1 1 264 94 266 1 1 648 1 22 22 22 22 22 22 22 22 22 22 22 22 22 198 198 198 198 198
648 4 1 4 4 434 435 435 435 435 436 4 650 1 1 264 94 266 1 1 648 72 73 74 75 640 657 657 657 657 657 657 657 642 643 644 644 644 645 198
648 1 4 4 1 440 441 442 435 443 444 1 650 1 1 264 94 266 1 1 648 80 81 82 83 648 664 665 666 1 664 665 666 650 651 652 652 652 653 198
627 657 657 657 657 448 449 450 453 451 452 657 658 1 1 264 94 266 1 1 656 88 89 90 91 648 664 665 666 1 664 665 666 650 659 676 677 623 661 198
648 1 1 1 1 456 457 458 461 459 460 304 1 1 1 264 94 266 1 1 1 96 97 98 99 656 1 1 1 1 1 1 1 658 667 684 685 631 669 198
690 1 1 1 1 1 1 256 94 258 1 305 1 1 1 264 94 266 1 1 1 1 264 266 1 1 1 1 1 1 1 1 1 3 1 264 266 1 1 22
1 1 1 1 1 1 1 264 94 266 1 1 1 1 256 94 94 94 258 3 1 1 264 266 1 1 1 1 1 1 1 1 1 1 1 264 266 1 1 1
256 257 257 257 257 257 257 94 94 94 257 257 257 257 94 94 94 94 94 257 257 257 94 94 257 257 257 257 257 257 257 257 257 257 257 94 94 257 257 258
272 273 273 273 273 273 273 273 273 273 273 273 94 94 273 273 273 273 273 273 273 273 273 273 273 273 273 273 94 94 273 273 273 273 273 273 273 273 273 274
1 1 1 1 1 728 729 729 729 729 729 732 264 266 1 1 1 1 1 1 1 1 1 1 1 1 1 1 264 266 1 1 1 1 1 1 1 1 1 1
698 1 1 1 1 736 737 737 737 737 737 740 264 266 1 1 1 1 643 644 644 645 40 41 41 43 1 1 264 266 1 643 644 644 644 645 638 679 679 639
648 1 1 1 1 744 731 745 746 747 731 748 264 266 640 657 657 657 651 652 652 653 48 49 50 51 1 1 264 266 1 651 652 652 652 653 646 687 687 647
648 1 1 1 1 721 739 722 723 730 739 738 264 266 648 4 4 4 659 676 623 661 56 57 58 59 1 1 264 266 1 672 676 673 675 674 654 695 695 655
656 657 657 657 657 657 642 800 1 801 1 1 264 266 648 1 1 1 667 684 631 669 96 65 66 67 1 1 264 266 1 680 684 681 683 682 662 678 678 663
14 14 1 1 1 1 650 1 1 1 1 3 264 266 648 256 257 257 257 94 257 257 257 94 257 257 257 257 94 94 257 257 94 258 1 14 670 668 668 671
198 198 14 14 14 1 650 1 1 1 1 1 272 274 648 264 94 94 273 273 273 273 273 273 273 273 273 273 273 273 273 273 273 274 1 198 14 14 1 1
198 198 198 198 198 14 650 1 1 1 1 1 1 1 648 264 94 266 1 1 1 1 1 1 1 1 1 1 1 1 1 1 1 1 1 198 22 22 1 1
198 198 198 198 198 198 689 657 657 657 657 657 657 657 690 264 94 266 1 657 657 657 657 657 657 14 14 657 657 657 657 657 657 1 14 198 392 393 393 393
199 198 198 198 198 198 14 14 14 1 14 321 1 1 1 272 273 274 1 313 14 14 14 14 14 198 198 14 1 14 14 14 14 14 198 198 400 368 368 368