MauvilleCity_BikeShop_Layout (12x9)
513 514 515 516 516 517 552 553 554 555 556 557
521 522 523 524 524 525 560 561 562 563 564 565
529 530 531 532 533 534 568 569 570 571 572 570
537 538 539 540 541 542 576 577 578 575 579 580
545 546 547 548 549 550 584 585 586 575 587 588
518 519 575 575 575 575 592 593 594 575 595 596
537 546 575 575 575 575 575 575 575 575 581 582
545 546 575 575 575 575 575 575 575 575 589 590
526 527 575 536 544 575 575 575 575 575 597 598