MauvilleCity_Gym_Layout (10x21)
1 1 550 532 532 532 532 551 1 1
1 1 543 529 529 529 529 542 1 1
1 1 543 537 537 537 537 542 1 1
1 1 543 513 513 513 513 542 1 1
1 1 543 513 513 513 513 542 1 1
1 1 543 513 513 513 513 542 1 1
532 532 533 513 513 513 513 531 532 532
540 540 541 528 544 545 528 539 540 540
514 514 514 576 552 553 536 521 514 514
517 513 513 584 513 513 513 513 513 523
528 562 563 592 562 563 528 513 513 531
536 570 571 579 570 571 576 513 517 539
525 513 513 538 513 513 584 523 524 526
533 513 513 593 544 545 592 531 532 532
541 513 513 536 552 553 536 539 540 540
514 513 513 513 517 513 513 521 514 514
513 513 513 513 513 513 513 513 513 513
527 535 513 522 513 513 522 513 534 527
1 543 513 530 513 513 530 513 542 1
1 543 513 514 513 513 514 513 542 1
1 543 513 513 515 516 513 513 542 1