MeteorFalls_1F_1R_Layout (30x42)
564 612 613 580 580 580 588 580 580 580 580 580 580 580 580 580 580 580 580 580 580 612 613 580 580 580 580 614 615 572
564 620 621 580 580 580 596 580 580 580 580 580 580 614 615 580 580 580 580 580 580 620 621 580 580 580 580 622 623 572
564 628 629 580 580 580 604 580 580 581 582 583 580 622 623 580 580 580 580 580 580 628 629 580 580 580 580 622 623 572
564 513 513 513 513 513 564 534 580 589 590 591 580 630 631 580 580 580 533 572 513 513 513 513 513 564 534 630 631 572
564 513 513 513 513 525 564 530 513 513 513 513 564 384 393 393 393 385 552 572 513 513 513 513 513 564 530 513 526 572
564 513 642 643 513 513 575 530 574 574 574 574 575 400 368 368 368 402 552 572 513 513 513 513 513 575 530 513 513 572
564 513 650 651 513 564 531 562 384 393 393 393 393 408 368 368 368 402 552 572 513 513 513 513 564 531 538 513 513 572
564 513 513 513 513 575 530 384 408 368 368 368 368 368 368 368 368 402 552 572 513 513 513 513 564 530 513 513 513 572
564 574 574 574 575 531 538 400 368 368 368 368 368 368 368 368 368 402 552 573 574 574 574 574 575 530 513 513 513 572
564 537 537 537 537 538 574 567 377 368 368 368 368 368 368 376 565 566 536 537 537 537 537 537 537 538 574 574 574 572
564 612 613 580 580 580 580 559 187 179 179 179 179 179 179 188 558 580 580 614 615 580 580 580 612 613 580 514 580 572
564 620 621 580 580 580 580 559 185 185 185 185 185 185 185 185 558 580 580 622 623 580 580 580 620 621 580 514 580 572
564 628 629 580 580 580 580 559 185 185 185 185 185 185 185 185 558 588 580 622 623 580 580 580 628 629 580 514 580 572
564 513 513 564 534 580 580 559 185 185 185 185 185 185 185 185 558 596 580 622 623 580 580 533 572 642 643 513 526 572
564 513 513 564 554 534 580 559 76 76 76 76 76 76 76 76 558 604 580 630 631 580 533 552 572 650 651 513 513 572
564 574 574 575 554 530 384 393 84 84 84 84 84 84 84 84 393 346 347 385 513 513 552 552 573 574 574 574 574 572
564 537 514 537 562 530 400 368 368 368 368 368 368 368 368 368 368 344 345 410 393 385 552 536 537 537 537 514 537 572
564 574 574 574 575 530 400 368 368 368 368 568 624 625 625 625 625 626 569 368 368 402 552 572 513 513 513 513 527 572
564 531 514 537 537 538 400 368 368 368 376 552 572 513 513 513 513 564 608 609 609 609 610 572 513 513 513 519 513 572
564 530 513 513 513 513 400 368 368 368 402 536 537 537 514 532 572 564 616 617 617 617 618 573 520 563 637 638 639 572
564 530 513 513 513 513 542 542 542 542 542 513 513 513 513 552 572 564 554 640 369 641 560 532 552 572 513 513 513 572
564 530 526 513 513 513 513 513 513 513 513 513 642 643 513 552 572 564 554 400 368 410 385 552 552 573 574 574 574 572
564 538 513 526 574 574 574 574 574 574 513 513 650 651 513 552 573 575 554 400 368 368 402 552 560 561 561 561 561 572
564 574 575 588 580 580 514 580 612 613 572 513 513 513 527 536 537 537 562 567 377 368 402 560 561 561 561 561 561 572
564 614 615 596 580 580 514 580 620 621 573 527 574 574 575 580 588 580 580 559 187 179 188 558 580 580 580 580 580 572
564 622 623 604 553 553 553 553 628 629 558 580 580 580 559 580 596 580 580 559 185 185 185 558 580 580 580 580 580 572
564 630 631 553 553 553 553 553 553 553 558 580 580 580 559 534 604 580 580 559 185 185 185 558 580 580 580 580 588 572
564 553 553 553 553 553 553 553 553 553 553 553 553 553 553 554 534 580 580 559 185 185 185 558 580 581 582 583 596 572
564 553 553 553 654 597 598 599 653 553 553 553 553 553 553 554 554 534 580 559 185 185 185 558 580 589 590 591 604 572
564 531 561 561 670 605 606 607 669 561 561 561 561 514 561 562 554 554 534 559 76 76 76 558 533 572 513 513 513 572
564 554 553 654 597 599 597 598 598 599 653 553 553 553 553 553 554 554 554 384 84 84 84 385 552 572 513 527 513 572
564 562 531 670 605 607 605 606 606 607 669 561 561 514 561 561 562 554 554 400 368 368 368 402 552 572 513 513 513 572
564 561 670 654 597 598 598 598 599 597 599 653 553 553 553 543 553 554 554 400 368 368 368 402 552 572 642 643 513 572
564 531 561 670 605 606 606 606 607 605 607 669 561 514 561 561 561 562 554 400 368 368 368 402 552 572 650 651 513 572
564 554 654 597 599 597 598 598 599 597 598 599 653 553 553 553 553 543 554 400 368 368 368 402 552 572 513 513 513 572
564 554 662 605 607 605 606 606 607 605 606 607 661 553 642 643 553 531 562 400 368 336 337 402 552 573 527 513 513 572
564 554 662 597 598 598 598 599 597 598 598 599 661 553 650 651 553 554 384 408 368 344 345 402 560 532 573 574 527 572
564 554 662 605 606 606 606 607 605 606 606 607 669 514 561 561 561 562 400 368 368 368 368 410 385 560 561 561 561 572
564 554 530 553 553 553 553 553 553 553 553 553 553 553 553 543 553 384 408 368 368 368 368 368 410 393 346 347 385 572
564 562 530 553 553 553 548 553 553 553 553 553 553 553 553 543 553 400 368 368 368 368 336 337 368 368 344 345 402 572
564 535 600 600 601 584 585 586 601 546 553 553 553 553 553 553 543 400 368 368 368 368 344 345 368 368 368 368 402 572
513 566 566 566 566 566 566 566 566 566 566 566 566 566 566 566 566 566 566 566 566 566 566 566 566 566 566 566 566 513