MeteorFalls_B1F_1R_Layout (29x38)
513 513 513 513 513 513 513 513 513 513 513 513 513 513 574 574 574 574 574 574 574 574 574 513 513 513 513 513 513
513 513 513 513 513 513 574 574 574 574 574 574 575 580 580 580 580 580 580 580 580 580 580 573 574 574 574 513 513
513 513 513 513 513 513 564 534 580 580 580 580 559 580 580 580 581 582 583 580 580 580 580 558 580 580 533 572 513
513 513 513 513 513 513 575 530 534 580 580 580 559 580 580 580 589 590 591 580 580 580 580 558 580 533 552 572 513
564 531 561 561 561 561 561 538 530 526 534 580 559 513 526 513 513 513 513 513 513 513 527 558 533 552 552 572 513
564 554 531 561 561 611 561 561 538 513 554 513 513 513 513 513 513 513 513 527 513 384 393 385 552 552 552 572 513
564 554 530 513 513 524 513 513 513 513 554 513 513 513 513 513 513 513 513 513 513 400 368 402 552 552 552 572 513
564 554 530 513 513 513 513 513 513 526 554 384 393 393 393 393 393 393 393 393 393 408 368 402 552 552 552 572 513
564 554 530 513 513 513 513 513 526 513 554 400 368 368 368 368 368 368 368 368 368 368 368 402 528 552 552 573 513
564 554 530 513 513 520 645 646 647 522 554 400 368 368 368 368 368 368 368 368 368 368 368 402 552 552 560 532 572
564 554 530 513 513 528 572 515 564 530 554 400 368 368 368 368 368 368 368 368 368 368 368 402 528 560 532 552 572
564 554 530 513 513 528 572 524 564 530 554 400 368 368 539 624 625 625 625 625 541 368 368 402 560 532 552 552 572
564 554 530 513 513 528 572 513 564 530 554 400 368 376 552 572 520 645 647 522 554 377 368 410 385 528 552 552 572
564 554 530 513 513 528 573 574 575 530 554 400 368 402 552 572 528 573 575 530 554 400 368 368 402 528 528 552 572
564 554 530 513 513 536 537 514 561 538 554 400 368 402 552 572 536 537 611 538 554 400 368 368 402 528 528 552 572
564 554 530 513 513 513 531 514 561 561 538 400 368 402 552 572 513 513 524 513 554 400 368 368 402 528 528 552 572
564 554 530 513 513 513 530 513 513 513 384 408 368 402 552 572 513 513 513 513 554 400 368 368 402 528 528 552 572
564 554 530 513 513 513 530 513 513 513 400 368 368 402 552 572 513 513 513 513 554 400 368 368 402 528 528 552 572
564 554 530 513 513 513 530 513 513 513 400 368 368 402 552 572 513 513 513 526 554 400 368 368 402 528 528 552 572
564 554 530 513 513 513 646 646 646 619 634 625 625 634 619 513 513 513 531 561 562 400 368 368 402 528 528 552 572
564 554 530 513 513 513 513 513 513 513 513 513 513 513 513 513 513 513 554 384 393 408 368 368 402 528 528 552 572
564 554 566 646 646 646 646 646 646 647 522 513 513 513 513 513 574 513 554 400 368 368 368 368 402 528 528 552 572
564 554 513 515 513 513 513 513 513 564 530 513 513 513 513 513 531 561 562 400 368 368 368 368 402 528 528 552 572
564 530 513 524 513 513 513 513 574 575 530 513 513 513 513 513 554 384 393 408 368 368 368 368 402 528 528 552 572
564 530 527 513 513 513 564 531 514 537 538 513 513 513 513 513 554 400 368 368 368 368 368 368 402 528 528 552 572
564 530 513 513 513 513 564 530 513 513 513 513 513 513 513 526 554 400 368 368 368 368 368 368 402 528 528 552 572
564 530 513 513 513 513 564 530 513 513 513 513 513 513 513 531 562 400 368 368 368 368 368 539 632 619 528 552 572
513 566 646 646 646 646 646 646 646 646 646 646 647 522 513 554 384 408 368 368 368 368 376 552 572 513 528 552 572
513 513 513 513 513 513 513 513 513 513 513 513 564 530 522 554 400 368 368 368 368 368 402 552 572 513 528 552 572
513 513 513 513 513 513 513 513 513 513 513 513 564 530 530 554 400 368 368 368 368 368 402 552 572 520 645 552 572
513 513 513 513 513 513 513 513 513 513 513 513 564 530 530 554 400 368 368 368 368 368 402 552 572 528 520 645 513
513 513 513 513 513 513 513 513 513 513 513 513 564 530 530 554 400 368 368 368 368 368 402 552 572 528 528 572 513
513 513 513 513 513 513 513 513 513 513 513 513 564 530 530 554 400 368 368 368 368 368 402 552 572 528 528 572 513
513 513 513 513 513 513 513 513 513 513 513 513 564 530 530 554 400 368 368 368 368 368 402 552 572 528 528 572 513
513 513 513 513 513 513 513 513 513 513 513 513 564 530 530 554 542 542 542 542 542 542 542 528 572 528 528 572 513
513 513 513 513 513 513 513 513 513 513 513 513 564 530 530 554 527 513 513 513 513 513 513 528 572 528 528 572 513
513 513 513 513 513 513 513 513 513 513 513 513 564 530 530 554 513 527 513 513 519 513 513 528 572 528 528 572 513
513 513 513 513 513 513 513 513 513 513 513 513 513 646 566 566 646 646 646 637 638 639 646 646 646 646 646 513 513