MeteorFalls_1F_2R_Layout (30x32)
513 513 513 513 513 513 513 574 574 574 574 574 574 574 574 574 574 574 574 574 574 513 513 513 513 513 513 513 513 513
513 513 513 513 513 513 564 531 561 561 561 561 561 561 561 561 561 561 561 561 532 572 513 513 513 513 513 513 513 513
513 513 513 513 513 513 564 530 513 513 513 513 513 513 513 513 513 513 513 513 552 573 574 574 574 574 513 513 513 513
513 513 513 513 513 513 575 530 513 513 513 513 513 513 513 513 513 513 513 513 560 561 561 561 561 532 573 574 574 574
574 574 574 574 574 575 531 562 574 574 574 574 574 654 597 598 598 599 597 599 653 573 574 574 513 560 561 561 561 561
561 561 561 561 561 561 562 531 561 514 561 561 561 670 605 606 606 607 605 607 669 561 561 532 573 574 574 574 574 574
561 561 561 561 561 561 561 562 574 574 574 574 574 654 597 599 597 598 598 598 599 653 573 560 561 561 561 561 561 561
513 513 513 513 513 564 531 561 561 514 561 561 561 670 605 607 605 606 606 606 607 669 561 561 561 561 532 572 513 513
513 574 574 574 574 575 554 574 574 574 574 574 654 597 598 599 597 599 597 598 598 599 653 573 574 574 552 572 513 513
564 531 561 561 561 561 562 531 561 514 561 561 670 605 606 607 605 607 605 606 606 607 669 561 561 532 552 572 513 513
564 554 531 561 561 561 561 562 574 574 574 654 597 599 597 598 598 599 513 597 598 598 599 653 573 552 552 573 574 513
564 554 554 564 531 561 561 561 561 514 561 670 605 607 605 606 606 607 652 605 606 606 607 669 532 552 560 561 532 572
564 554 554 575 530 513 513 513 513 513 513 652 513 597 598 598 599 513 652 513 513 513 513 513 661 560 561 561 552 572
564 554 554 531 538 513 513 513 513 513 652 513 513 605 606 606 607 652 513 597 599 597 598 599 661 573 574 552 552 572
564 554 554 530 525 513 513 513 513 653 654 597 598 598 599 513 513 652 513 605 607 605 606 607 669 561 532 552 552 572
564 554 554 530 513 513 513 513 652 669 670 605 606 606 607 653 645 647 654 513 513 513 513 513 513 513 552 552 552 572
564 554 554 646 646 646 647 522 513 513 513 513 513 513 513 661 572 564 662 513 597 599 597 598 598 599 552 552 552 572
564 554 554 513 513 574 575 530 513 513 513 513 597 598 599 661 573 575 662 513 605 607 605 606 606 607 552 552 552 572
564 554 554 513 575 531 537 538 513 513 653 654 605 606 607 669 537 537 670 513 513 513 513 513 513 513 552 552 552 572
564 554 554 575 531 538 513 513 513 513 661 662 513 513 513 513 652 513 513 513 513 513 513 513 513 513 552 552 552 572
564 554 554 531 538 513 513 525 513 513 669 670 513 513 513 513 513 513 513 652 513 513 513 513 513 513 552 552 552 572
564 554 554 530 513 513 513 513 513 384 393 346 347 385 513 513 513 513 513 513 513 513 513 513 520 563 646 646 552 572
564 554 554 530 384 393 393 393 393 408 368 344 345 410 393 393 385 513 513 513 513 513 513 520 552 572 513 513 552 572
564 554 554 530 400 368 368 368 368 368 336 337 368 368 368 368 402 513 513 513 513 525 513 552 552 520 563 646 646 513
564 554 554 530 356 337 368 368 336 337 344 345 368 368 368 368 402 513 513 513 513 513 513 552 552 552 572 513 513 513
564 554 554 530 364 345 336 337 344 345 368 368 368 368 368 368 402 513 513 513 513 513 513 552 552 552 572 513 513 513
564 554 554 530 400 368 344 345 368 368 368 368 368 402 566 566 566 513 513 513 520 563 646 646 552 552 572 513 513 513
564 554 554 530 400 368 368 368 368 368 368 368 368 402 513 513 513 513 513 513 552 572 513 513 552 552 572 513 513 513
564 554 554 530 400 368 368 402 566 566 566 566 566 566 513 513 513 513 513 513 552 572 520 563 646 552 572 513 513 513
564 554 554 530 400 368 368 402 513 513 519 513 513 513 513 513 513 513 513 513 552 572 552 572 520 563 513 513 513 513
564 554 554 619 634 625 625 634 619 637 593 639 646 646 646 646 646 646 646 646 646 513 552 572 552 572 513 513 513 513
513 566 566 646 646 646 646 646 646 646 646 646 646 646 646 646 646 646 646 646 646 646 646 646 646 513 513 513 513 513