MeteorFalls_B1F_2R_Layout (11x18)
513 574 574 574 574 574 574 574 574 574 513
564 531 561 561 561 561 561 561 561 532 572
564 554 531 561 561 561 561 561 532 552 572
564 554 554 513 513 513 513 513 552 552 572
564 554 554 513 513 513 513 513 552 552 572
564 554 554 384 393 393 393 385 552 552 572
564 554 554 400 368 368 368 402 552 552 572
564 554 554 400 368 368 368 402 552 552 572
564 554 554 400 368 368 368 402 552 552 572
564 554 554 400 368 368 368 402 552 552 572
564 554 554 400 368 368 368 402 552 552 572
564 554 554 400 368 368 368 402 552 552 572
564 554 554 400 368 368 368 402 552 552 572
564 554 554 400 368 368 368 402 552 552 572
564 554 554 542 542 542 542 542 552 552 572
564 554 554 513 513 519 513 513 552 552 572
564 554 646 646 637 638 639 646 646 552 572
513 646 646 646 646 646 646 646 646 646 513