MossdeepCity_StevensHouse_Layout (11x8)
646 647 517 517 517 518 517 517 517 517 517
654 655 616 525 525 526 525 525 525 617 617
662 663 624 548 548 548 548 548 548 625 625
569 547 547 547 744 745 745 746 547 547 859
569 547 547 547 752 753 721 754 547 547 867
569 547 547 547 547 547 556 547 547 547 859
569 547 547 547 547 547 547 547 547 547 867
569 547 547 520 521 547 547 547 547 547 547