MossdeepCity_GameCorner_1F_Layout (11x8)
646 647 514 515 516 518 517 560 517 622 623
654 655 522 537 524 526 525 542 616 630 631
662 663 548 548 548 548 548 568 624 638 639
569 547 547 547 547 547 547 547 547 547 547
569 547 547 547 555 586 587 556 547 547 547
569 547 547 547 555 594 595 556 547 547 547
569 547 547 547 547 547 547 547 547 546 546
569 547 547 520 521 547 547 547 547 554 554