MossdeepCity_Layout (80x40)
368 368 368 368 378 113 113 123 124 124 125 113 113 113 380 344 345 386 121 388 368 368 368 368 368 368 368 368 368 368 368 368 368 368 368 368 368 368 368 368 368 368 368 368 368 368 368 368 368 368 368 368 368 373 374 368 368 368 368 368 368 368 368 368 368 368 368 368 368 368 368 368 368 368 368 368 368 368 368 368
368 368 368 368 386 121 137 113 113 113 113 113 116 121 388 368 368 368 368 368 368 368 368 368 368 368 368 368 368 368 368 368 368 368 368 368 368 368 368 368 368 368 368 368 368 368 368 368 368 368 368 373 374 381 382 368 368 368 368 368 368 368 368 368 368 368 368 368 368 368 368 368 368 368 368 368 368 368 368 368
368 368 368 368 827 829 386 121 121 121 121 121 388 368 368 368 368 368 368 368 368 368 368 368 368 368 368 368 368 368 368 368 368 368 368 368 368 368 368 368 368 368 368 368 368 368 368 368 368 368 368 381 382 368 368 368 368 368 368 368 368 368 368 368 368 368 368 368 368 368 368 368 368 368 368 368 368 368 368 368
368 368 336 337 381 382 368 368 368 368 368 368 368 368 368 368 368 368 368 429 430 430 430 431 368 368 368 368 368 368 368 368 368 368 368 368 368 368 368 368 368 368 368 368 368 368 368 370 668 661 662 669 701 368 754 755 756 368 368 368 368 368 368 368 368 368 368 368 368 368 368 368 368 368 368 368 368 368 368 368
336 337 344 345 368 368 368 368 368 368 368 368 429 430 430 430 430 430 430 411 414 414 414 412 430 430 431 368 368 368 370 246 246 246 246 246 246 246 246 246 246 246 372 368 368 368 370 238 656 657 658 659 2 2 769 779 773 2 2 2 2 2 701 368 368 368 368 368 368 368 368 368 368 368 368 368 368 368 368 368
344 345 368 368 368 368 368 368 368 368 368 429 411 414 414 414 414 414 414 414 414 404 414 414 414 350 246 246 246 246 246 794 795 794 795 426 427 427 427 427 428 1 246 246 246 246 851 115 664 665 666 667 1 1 786 787 788 4 104 2 2 2 2 2 2 2 2 2 2 2 372 368 368 368 368 368 368 368 368 368
368 368 368 368 368 368 368 368 368 368 429 411 414 414 414 404 414 414 414 414 414 414 414 350 798 799 1 660 661 662 663 802 854 853 803 434 435 435 435 435 436 1 1 794 795 1 112 115 672 673 674 675 1 1 1 104 2 2 704 4 811 823 812 812 813 812 812 823 814 1 117 372 368 368 368 368 368 368 368 368
368 368 368 368 368 368 368 368 368 429 411 414 414 404 350 798 799 2 670 661 678 671 2 798 853 854 795 656 657 658 659 1 802 803 1 440 441 442 435 443 444 1 794 853 803 104 211 2 4 1 1 1 1 1 104 115 1 1 112 4 819 820 791 815 821 815 791 820 822 4 117 117 212 372 368 368 368 368 368 368
368 368 368 368 368 368 368 368 368 437 414 414 414 350 115 802 803 1 656 657 679 659 794 853 805 804 803 664 665 666 667 1 1 1 304 448 449 450 453 451 452 794 853 803 104 115 4 1 1 280 282 1 1 104 2 704 4 104 2 1 730 731 731 732 733 734 735 735 711 1 117 117 1 117 372 368 368 368 368 368
368 368 368 368 368 368 368 368 368 437 414 414 414 358 115 1 4 4 664 665 666 667 802 803 802 803 1 672 673 674 675 1 1 1 305 456 457 458 461 459 460 802 803 104 211 2 1 1 1 288 290 1 104 115 104 2 1 112 1 1 730 731 731 732 733 734 735 735 711 1 114 212 106 117 117 372 368 368 368 368
368 368 368 368 368 368 368 368 368 437 414 414 404 358 115 1 4 4 672 673 674 675 1 1 1 1 1 1 1 1 4 1 280 281 281 281 281 281 281 281 282 1 104 115 4 1 1 1 280 289 290 1 112 115 115 1 1 112 794 795 730 731 731 732 733 734 735 735 711 1 212 106 117 117 117 117 372 368 368 368
368 368 368 368 368 368 368 368 368 437 414 414 414 358 123 137 1 1 1 1 1 1 1 1 1 1 1 4 1 1 1 1 288 289 289 297 297 297 297 297 298 1 112 115 1 1 1 280 289 289 290 104 2 704 115 4 1 112 802 803 730 731 731 732 733 734 735 735 711 794 795 117 117 117 117 117 117 372 368 368
368 368 368 368 368 368 368 368 368 437 414 414 414 366 137 115 1 1 1 1 1 1 1 1 794 795 1 1 1 1 1 1 288 289 290 1 1 1 1 1 1 104 762 763 772 1 280 289 289 289 290 112 1 112 115 1 1 112 794 795 738 739 739 740 741 742 743 743 719 802 803 117 117 117 117 117 117 114 212 372
368 368 368 368 368 368 368 368 368 437 414 414 414 414 358 123 137 660 661 662 663 1 1 1 802 854 795 72 73 74 75 1 288 289 290 1 1 1 1 4 104 115 778 779 780 1 288 289 289 289 290 112 4 112 120 137 1 112 802 803 746 747 747 748 749 750 751 751 727 794 795 117 117 117 117 117 117 114 1 380
368 368 368 368 368 368 368 368 368 437 414 414 414 414 366 137 115 656 657 658 659 1 794 795 794 853 803 80 81 82 83 1 288 289 290 1 1 4 1 1 112 115 786 787 788 1 296 289 289 289 298 112 1 112 1 120 137 123 137 4 1 1 1 1 1 1 3 1 1 802 803 117 117 117 117 117 114 212 106 380
368 368 368 368 368 368 368 368 368 437 414 414 414 414 414 358 115 664 665 666 667 1 802 803 802 803 1 88 89 90 91 1 288 289 290 4 40 41 41 43 112 115 1 1 1 1 1 296 289 290 1 120 137 115 1 4 120 137 123 137 1 1 1 280 281 282 1 1 1 1 1 117 117 117 117 117 114 4 117 380
368 368 368 368 368 368 368 368 368 445 419 414 414 414 414 358 115 672 673 674 675 1 1 1 1 3 1 96 97 98 99 1 288 289 290 1 48 49 50 51 112 123 137 4 1 1 1 1 288 290 1 1 112 123 137 1 1 120 137 115 1 4 1 296 297 298 1 1 4 1 116 125 117 117 117 117 114 1 117 380
368 368 368 368 368 368 368 368 368 368 437 414 414 414 414 358 115 1 1 1 1 1 1 1 4 280 281 281 281 281 281 281 289 289 290 1 56 57 58 59 120 137 123 137 1 1 1 1 296 298 1 1 120 137 123 137 1 4 112 123 124 124 124 175 207 207 124 124 124 124 125 116 122 117 117 114 212 106 117 380
368 368 368 368 368 368 368 368 368 368 437 414 414 414 414 358 123 137 1 794 795 1 1 1 1 288 289 297 297 297 297 297 289 289 290 1 96 65 66 67 1 120 137 115 1 1 1 1 1 1 1 1 1 120 137 123 124 137 123 169 145 145 145 175 207 207 145 145 145 145 145 122 1 117 117 114 1 117 117 380
430 430 430 430 431 368 368 368 368 368 437 414 414 414 414 366 137 115 1 802 803 794 795 1 1 288 290 1 1 1 4 1 288 289 289 281 281 281 281 281 281 282 112 123 137 1 4 1 770 771 772 1 1 1 120 145 137 123 124 137 1 1 4 1 1 1 1 1 1 4 1 1 116 125 117 114 1 117 117 380
405 406 406 407 412 430 430 431 368 368 445 419 414 414 414 414 358 123 124 124 137 802 803 1 1 288 290 1 1 1 1 1 288 289 297 856 857 857 857 858 289 290 120 137 123 137 1 1 778 779 780 1 1 280 282 1 120 145 137 123 124 124 124 175 207 207 124 124 124 124 124 124 125 116 122 114 4 117 117 380
413 292 292 390 406 406 407 412 430 431 368 437 414 414 414 414 366 145 145 137 115 1 1 1 1 288 290 1 1 794 795 1 288 290 1 864 865 865 865 866 288 290 1 120 137 123 124 137 786 787 788 1 1 288 289 281 282 768 120 145 145 145 145 175 207 207 670 661 662 671 145 145 145 122 1 117 116 125 117 380
413 292 292 776 777 292 390 407 414 412 430 411 414 414 414 414 414 414 414 358 123 124 124 137 1 288 290 1 794 853 803 1 288 290 1 872 873 873 873 874 288 290 1 1 120 145 137 123 124 124 137 1 1 296 289 289 289 281 281 281 282 1 1 1 1 1 656 657 658 659 1 1 4 1 1 117 117 116 125 380
413 292 292 784 854 777 292 415 414 414 414 414 414 414 414 414 414 414 414 366 145 145 137 115 1 288 290 1 802 803 1 1 288 290 4 664 665 666 852 667 288 290 1 1 1 1 120 145 145 137 123 137 1 1 296 297 289 289 289 289 289 281 282 1 1 1 664 665 666 667 1 1 1 116 124 125 117 117 116 382
413 292 292 292 784 785 292 390 407 414 414 414 414 414 414 414 414 414 414 414 414 414 358 123 124 175 207 124 124 124 137 1 288 290 1 672 673 674 860 675 288 290 1 1 1 1 1 1 1 120 137 115 4 1 1 1 296 289 289 297 297 297 298 1 1 1 672 673 674 675 4 1 116 125 116 169 125 117 380 368
413 292 292 292 292 292 292 292 415 414 414 414 414 414 414 414 414 414 414 414 414 414 366 145 145 175 207 145 145 137 115 1 288 290 1 1 1 1 1 1 288 289 281 281 281 281 281 282 1 1 112 123 124 124 137 4 1 296 298 1 1 1 1 1 1 1 1 1 1 1 1 1 117 116 125 116 169 125 380 368
421 397 292 292 776 777 292 292 415 414 414 414 414 414 414 414 414 414 414 414 414 414 414 414 414 414 414 414 414 358 115 1 288 290 1 1 1 1 1 1 296 297 297 297 297 297 289 290 1 1 120 145 145 137 123 137 1 1 1 1 1 1 4 1 1 1 1 1 770 771 772 116 125 117 116 125 116 145 382 368
419 421 397 292 784 785 292 292 415 414 414 414 414 414 414 414 414 414 414 414 414 414 414 414 414 414 414 414 414 358 123 124 175 207 124 124 796 797 796 797 121 796 797 137 1 1 288 290 1 1 1 1 1 120 137 123 124 175 207 124 124 124 124 124 137 1 1 1 778 779 780 117 116 125 117 116 382 368 368 368
437 414 413 292 292 292 292 292 415 414 420 446 446 419 414 414 414 414 414 414 414 414 414 414 414 414 414 414 414 366 121 145 175 207 145 137 802 803 802 803 1 802 803 112 1 1 288 290 1 1 1 1 1 1 120 145 145 175 207 145 145 145 137 1 120 137 1 1 786 787 788 117 117 116 125 380 368 368 368 368
437 414 413 292 292 292 292 292 415 414 439 368 368 445 446 446 419 414 414 414 414 414 414 414 414 414 414 414 414 414 414 414 414 414 414 366 796 797 796 797 796 797 137 112 1 1 288 289 281 281 281 281 281 281 281 281 281 289 290 1 1 1 120 121 137 123 124 124 124 124 124 125 117 117 116 382 368 368 368 368
445 419 421 397 292 292 292 398 423 420 447 368 368 368 368 368 445 446 446 446 446 446 419 414 414 414 414 414 414 414 414 414 414 414 414 752 804 805 804 805 804 761 358 120 137 1 296 297 297 297 297 297 297 297 297 297 297 297 298 1 1 1 1 4 120 145 145 169 169 169 169 169 125 117 380 368 368 368 368 368
368 445 419 421 422 422 422 423 420 447 368 368 368 368 368 368 368 368 368 368 368 368 445 446 446 446 446 419 414 414 414 414 414 414 752 804 761 760 805 804 805 753 358 4 120 121 175 207 121 121 137 1 1 1 1 1 1 1 1 1 1 1 1 1 1 1 4 116 145 145 169 169 169 125 380 368 368 368 368 368
368 368 445 446 446 446 446 446 447 368 368 368 368 368 368 368 368 368 368 368 368 368 368 368 368 368 368 445 446 446 446 419 414 414 760 805 753 752 804 805 804 761 358 1 794 795 1 1 1 1 120 121 121 137 1 1 1 1 1 1 1 4 1 1 1 116 121 122 1 4 116 145 145 145 382 368 368 368 368 368
368 368 368 368 368 368 368 368 368 368 368 368 368 368 368 368 368 368 368 368 368 368 368 368 368 368 368 368 368 368 368 445 446 419 414 760 805 804 761 760 761 414 358 794 853 803 1 1 1 1 1 1 1 120 121 121 121 121 121 137 1 1 1 116 124 122 1 4 1 1 380 368 368 368 368 368 368 368 368 368
379 379 379 379 379 379 379 379 372 368 373 374 368 368 368 368 368 368 368 368 368 368 368 368 368 368 368 368 368 368 368 368 368 445 419 752 804 805 753 752 753 414 358 802 803 1 4 1 1 1 1 1 1 1 1 1 1 1 4 120 121 121 121 122 116 145 121 121 121 121 382 368 368 368 368 368 368 368 368 368
113 113 113 113 113 113 113 113 180 372 381 382 368 368 368 368 368 368 368 368 368 368 368 368 368 368 368 368 368 368 368 368 368 368 437 760 761 760 805 804 805 753 366 121 121 796 797 121 137 1 1 4 1 1 1 1 1 1 1 1 1 4 1 1 380 368 368 368 368 368 368 368 368 368 368 370 372 368 368 368
113 113 113 113 113 113 113 113 113 180 379 379 379 379 379 379 379 379 379 379 379 372 368 368 368 368 368 368 368 368 368 368 368 368 437 752 753 752 804 805 804 761 414 414 752 804 805 753 366 121 121 121 121 121 121 121 121 121 121 121 121 121 121 121 382 368 368 368 368 368 368 368 368 368 370 190 380 368 368 368
108 108 109 113 113 113 113 113 113 113 113 113 107 108 108 108 108 108 108 109 113 180 372 368 368 368 368 368 368 368 368 368 368 368 437 760 805 804 761 760 805 753 414 414 760 805 804 761 414 414 414 414 414 414 420 446 446 446 446 446 447 368 368 368 368 368 368 368 368 368 368 368 368 368 378 113 380 368 368 368
113 113 190 109 113 113 147 148 113 113 113 107 190 113 107 108 108 109 113 190 109 113 380 368 368 368 368 368 368 368 368 368 368 368 437 752 804 761 414 752 804 805 753 414 752 804 761 414 420 446 446 446 446 446 447 368 368 368 368 368 368 368 368 368 368 368 368 368 368 368 368 368 368 370 190 113 190 372 368 368
113 113 113 117 113 113 155 156 113 113 113 115 113 107 190 113 113 190 109 113 117 113 380 373 374 368 368 368 368 368 368 368 368 368 437 760 805 753 752 804 805 804 805 753 760 761 420 446 447 368 368 368 368 368 368 368 368 368 368 368 368 368 368 368 368 368 368 368 368 368 368 368 368 378 113 107 109 380 368 368