MossdeepCity_GameCorner_B1F_Layout (12x9)
517 517 514 515 516 517 517 517 517 517 517 517
656 525 522 523 524 525 525 525 525 525 525 656
664 548 548 548 548 548 548 548 548 548 548 664
569 547 547 547 547 547 547 547 547 547 547 547
569 547 547 547 565 566 566 567 547 547 547 547
569 547 547 547 573 574 574 575 547 547 547 547
569 547 547 547 581 582 582 583 547 547 547 547
657 547 547 547 547 547 547 547 547 547 547 546
665 547 547 547 547 547 547 547 547 547 547 554