MossdeepCity_SpaceCenter_2F_Layout (16x10)
529 537 537 760 760 760 760 760 760 760 760 760 707 708 709 537
522 696 697 768 768 768 768 768 768 768 768 768 715 716 717 697
521 886 886 870 870 870 870 870 870 870 870 870 878 870 879 886
528 753 865 752 752 865 752 752 865 752 752 865 752 752 752 752
544 854 883 883 883 883 883 883 883 883 883 883 884 752 752 752
882 870 870 870 870 870 870 870 870 870 870 870 870 752 752 752
753 752 867 868 752 867 868 752 866 868 752 867 868 752 752 752
753 752 875 876 752 875 876 752 874 876 752 875 876 752 752 752
753 752 865 752 752 865 752 752 865 752 752 865 752 752 752 752
753 752 752 752 752 752 752 752 752 752 752 752 752 752 752 752