MossdeepCity_Gym_Layout (20x30)
576 576 576 576 576 576 576 576 576 576 576 576 576 576 576 576 576 576 576 576
584 584 584 584 584 584 584 584 584 584 584 584 584 584 584 584 584 584 584 584
529 529 529 529 529 514 521 521 521 521 521 521 521 521 544 529 529 529 529 529
557 528 528 528 528 514 528 531 518 519 532 528 526 522 552 528 528 528 528 528
557 528 528 528 528 514 528 530 530 530 530 528 544 522 552 528 528 528 528 528
557 528 528 528 528 524 513 533 530 530 534 528 552 522 552 528 528 528 528 528
535 514 536 537 540 528 550 549 537 537 537 537 582 554 581 550 550 550 550 528
557 528 568 528 552 558 514 521 521 521 521 521 521 561 521 521 521 521 521 559
557 528 528 528 552 558 515 573 567 565 565 567 574 562 566 551 583 566 523 559
557 528 528 528 547 540 515 564 575 556 556 575 564 522 564 556 575 564 523 544
557 528 528 528 528 552 514 552 568 528 528 528 552 522 552 528 528 552 522 552
557 528 528 528 528 552 514 560 528 528 528 528 552 522 552 528 528 552 522 552
536 537 538 514 522 552 514 539 537 538 514 522 552 522 547 537 537 543 522 552
557 550 550 555 554 581 555 581 550 550 555 554 581 554 550 550 528 552 522 552
591 513 513 553 553 513 553 513 517 513 553 553 513 553 513 514 559 560 522 552
591 523 583 563 562 566 563 566 515 583 563 562 566 562 583 515 559 568 522 552
591 523 575 514 522 564 514 564 515 575 514 522 564 522 575 515 513 528 528 552
544 522 544 514 522 552 514 552 528 528 514 522 552 522 521 516 513 528 522 552
552 522 552 514 522 552 514 560 528 528 528 522 547 537 537 537 538 528 522 552
552 522 552 514 522 552 528 513 528 528 528 528 528 528 528 528 528 544 522 552
552 522 552 514 522 560 514 513 528 528 528 528 528 528 528 528 528 552 522 552
552 522 560 514 522 521 521 521 528 536 537 537 537 537 537 537 537 543 522 552
552 522 528 513 513 513 513 513 513 513 513 513 513 513 513 513 514 552 522 552
552 516 528 521 521 521 521 521 521 521 521 521 521 521 521 544 514 552 522 552
552 522 528 528 528 568 528 528 528 528 528 528 528 528 528 552 514 552 522 552
552 522 544 528 528 528 528 528 528 528 528 528 528 528 528 560 514 552 522 552
552 522 552 528 528 528 528 572 528 528 528 572 528 528 528 521 521 552 522 552
552 522 547 537 537 537 538 580 528 528 528 580 536 537 537 537 537 548 522 552
552 522 521 521 521 521 521 571 528 528 528 571 513 513 513 513 513 513 522 552
560 528 528 528 528 528 528 528 528 545 546 528 528 528 527 528 528 528 528 560