MossdeepCity_SpaceCenter_1F_Layout (16x10)
536 537 537 760 760 760 760 760 760 760 760 760 691 692 693 537
698 696 697 768 768 768 768 768 768 768 768 768 699 700 701 697
887 885 886 870 870 870 870 870 870 870 870 870 878 870 879 886
753 752 865 752 752 865 752 752 865 752 752 865 752 752 752 752
753 752 752 752 752 752 752 752 752 752 867 868 752 867 868 752
753 752 872 873 872 873 752 752 752 752 875 876 752 875 876 752
753 865 880 881 880 881 865 752 752 752 865 752 752 865 752 752
753 752 865 752 865 752 752 752 752 752 872 873 872 873 752 752
753 752 752 752 752 752 752 752 752 752 880 881 880 881 865 752
753 752 752 752 752 752 752 518 519 752 752 865 752 865 752 752