MtChimney_Layout (40x47)
616 638 625 624 625 625 624 625 624 625 626 626 626 625 626 796 540 649 632 636 625 635 634 796 701 540 649 624 624 624 624 625 626 626 625 625 625 626 625 625
624 625 625 624 625 625 624 625 624 625 626 626 626 635 634 796 701 539 636 632 628 634 635 541 701 531 638 624 624 624 624 625 626 626 625 625 625 626 625 625
624 625 616 638 625 625 624 616 638 625 626 626 626 626 635 541 701 540 539 633 633 633 541 540 701 649 625 624 624 624 624 625 626 626 625 625 625 626 625 635
624 625 624 625 625 625 624 624 625 625 626 626 626 626 796 540 701 701 540 701 701 701 701 701 540 649 616 638 624 624 624 625 626 626 625 625 635 634 625 626
624 625 624 625 625 625 624 624 625 625 626 626 626 626 796 701 701 701 701 701 540 701 540 701 701 649 624 616 638 624 632 628 634 626 625 625 626 625 625 626
624 625 624 625 625 625 624 624 625 635 634 626 626 626 773 701 540 701 701 701 701 701 701 701 531 638 624 624 616 638 625 625 625 626 625 625 626 625 625 626
624 625 624 625 625 625 624 632 628 634 625 639 639 639 772 533 701 701 701 701 701 701 701 540 649 625 624 624 624 625 625 625 625 626 625 635 634 625 625 626
624 625 624 625 625 625 624 625 625 625 625 625 625 625 625 796 701 540 701 701 701 701 701 701 649 616 638 624 624 625 625 625 625 626 625 626 625 625 635 634
624 625 624 625 625 625 624 625 625 625 625 635 628 628 628 541 540 701 701 701 540 701 540 701 649 624 625 624 624 625 625 625 625 626 625 626 625 625 626 625
624 625 632 636 625 625 624 625 625 625 625 626 626 626 796 540 701 701 540 701 701 701 701 531 638 638 616 638 624 625 625 625 635 634 625 626 625 635 634 625
632 636 625 624 625 625 624 616 617 618 625 626 626 639 639 532 533 701 701 540 701 531 532 624 625 616 638 616 638 625 625 625 626 625 635 634 625 626 625 625
625 624 625 632 636 625 624 624 625 626 625 639 639 618 625 625 626 532 532 532 532 638 616 638 625 624 616 638 625 625 625 625 626 625 626 625 625 626 625 635
625 624 625 625 624 625 624 632 628 634 625 625 625 639 617 618 639 617 617 617 617 617 638 625 616 638 624 625 625 625 625 625 626 625 626 625 625 626 625 626
636 632 636 625 632 636 632 636 625 625 625 625 616 617 618 626 617 617 618 625 625 616 617 617 638 625 624 625 625 625 625 625 626 625 626 625 625 626 635 634
624 625 624 625 625 624 625 632 636 625 625 625 624 625 626 639 617 618 639 617 617 638 616 617 617 617 638 625 625 625 625 625 626 625 626 625 635 634 626 635
632 636 632 636 625 624 625 625 624 625 625 625 632 628 634 625 625 639 617 617 617 617 638 625 625 625 625 625 625 625 625 625 626 635 634 625 626 635 634 626
625 624 625 624 625 632 636 625 624 625 625 625 625 625 625 625 625 625 625 625 625 625 625 625 625 625 625 625 625 625 625 635 634 626 625 635 634 626 635 634
636 624 625 624 625 625 624 625 632 636 625 625 625 625 625 625 625 625 625 625 625 625 625 625 625 625 625 625 625 625 625 626 625 626 625 626 625 626 626 625
624 624 625 632 636 625 624 625 625 632 628 636 625 625 625 625 625 625 625 625 625 625 625 625 625 625 625 625 625 625 625 626 625 626 635 634 635 634 626 635
624 632 636 625 632 636 632 628 628 628 636 624 625 625 625 625 625 625 625 625 625 625 625 625 625 625 625 625 625 625 635 634 625 626 626 625 626 625 626 626
624 625 632 636 625 632 628 628 628 636 624 632 628 636 625 625 625 625 625 625 625 625 625 625 625 625 625 625 625 635 634 625 625 626 626 625 626 635 634 626
624 625 625 632 628 636 625 625 625 624 624 625 625 632 636 625 625 625 625 625 625 625 625 625 625 625 625 625 635 634 635 628 628 634 626 625 626 626 625 626
632 628 628 636 625 632 628 636 625 624 632 628 636 625 632 628 636 625 625 635 628 628 628 628 628 687 628 628 634 635 634 635 628 628 634 635 634 626 625 626
625 625 625 632 628 636 625 624 625 632 628 636 632 628 628 636 632 628 628 634 625 625 625 625 625 625 635 628 628 634 635 634 635 628 628 634 635 634 625 626
628 628 628 636 625 632 636 632 628 636 625 632 628 636 625 632 636 625 625 635 687 628 628 628 628 628 634 625 625 635 634 635 634 635 628 628 634 635 628 634
628 628 636 624 625 625 632 628 636 632 636 625 625 632 628 636 632 628 628 634 625 625 625 625 625 625 625 625 625 626 635 634 635 634 635 628 628 634 625 625
625 625 624 632 636 625 625 625 624 625 632 628 628 636 625 632 628 636 625 625 625 625 625 625 625 625 625 635 628 634 626 625 626 625 626 625 625 625 635 628
625 625 624 625 632 628 636 625 709 636 625 625 625 632 636 625 625 632 636 625 625 625 635 628 628 628 687 634 635 628 634 635 711 635 634 625 625 635 711 625
625 625 632 636 625 708 624 625 716 624 625 625 625 625 632 628 628 636 632 628 628 628 634 625 625 625 625 635 634 625 625 626 716 626 635 628 628 634 717 625
625 625 625 632 636 717 709 628 636 632 628 628 628 628 628 636 625 632 628 628 628 628 628 628 628 628 687 634 625 625 625 626 625 626 626 625 708 625 716 708
625 625 625 625 624 716 716 625 624 625 625 625 625 625 625 632 628 628 628 628 628 628 636 625 625 625 625 625 625 625 625 626 635 711 626 625 716 625 625 716
625 625 625 625 632 628 628 636 624 625 625 625 625 654 662 662 662 662 662 662 662 662 624 625 625 625 625 625 635 628 628 634 626 716 626 708 708 635 628 628
636 625 625 625 625 625 625 624 624 625 625 625 625 655 625 550 551 545 545 546 625 625 632 628 628 628 687 628 634 625 625 625 626 635 634 717 716 626 708 625
632 628 628 636 625 625 625 624 624 625 708 708 625 655 550 558 559 553 553 554 602 602 602 602 602 602 602 602 596 595 625 635 634 626 708 716 635 634 717 708
628 628 636 624 625 625 625 624 624 625 716 717 625 655 557 566 567 561 561 562 625 625 625 625 625 625 625 625 604 603 594 593 625 626 716 635 634 708 716 716
625 625 624 632 628 636 708 624 632 628 636 716 708 655 557 574 575 569 570 549 625 625 625 625 625 625 625 625 612 625 625 601 594 593 625 626 625 716 635 710
636 625 632 628 636 624 717 709 628 636 709 636 717 655 565 582 583 577 578 599 625 625 625 625 625 625 625 625 625 625 625 626 625 601 594 593 625 635 634 716
624 625 708 625 624 624 716 716 625 624 717 624 717 655 708 708 625 625 625 625 625 625 625 625 3 625 625 625 708 708 625 626 625 626 625 601 594 593 635 628
624 708 717 708 624 632 628 636 625 624 716 624 716 655 716 716 625 625 625 625 625 625 625 625 625 625 625 625 716 716 635 634 635 711 708 626 625 601 592 609
624 716 716 717 709 628 636 624 708 632 636 624 625 659 662 662 662 662 647 625 625 625 625 645 662 662 662 662 662 635 634 635 711 717 716 626 708 626 626 601
632 710 636 716 716 625 624 624 717 625 624 709 710 628 710 636 625 625 659 625 625 625 625 660 625 625 625 625 635 634 635 634 716 716 635 634 717 626 626 626
625 717 709 628 636 625 624 624 716 625 624 716 716 625 717 709 628 710 710 710 534 534 710 710 710 628 628 710 634 635 634 708 625 625 626 625 716 626 626 626
625 716 716 625 624 708 624 632 636 708 709 710 710 636 716 717 708 717 717 717 788 788 717 717 717 708 708 717 635 634 625 716 635 710 634 625 635 634 626 626
628 628 636 625 624 717 632 636 624 716 716 716 717 709 636 717 717 717 717 717 789 789 717 717 717 717 717 716 626 625 625 635 634 717 708 625 626 625 626 626
708 708 624 708 624 717 625 624 709 628 710 636 717 717 624 717 717 717 717 717 717 717 717 717 717 717 717 635 634 708 708 626 625 717 717 625 626 708 626 626
717 717 624 717 624 717 708 624 716 625 716 624 716 717 624 716 717 717 717 717 717 717 717 717 717 717 717 626 708 717 717 626 708 716 716 708 626 717 626 626
717 717 624 717 624 716 717 632 628 628 636 632 636 717 632 636 716 717 717 717 717 717 717 717 717 717 717 626 717 717 716 626 717 708 708 717 626 717 626 626