MtPyre_3F_Layout (13x13)
740 691 692 693 751 740 751 740 751 707 708 709 740
748 699 700 701 759 748 759 748 759 715 716 717 748
806 744 743 745 743 806 806 806 743 744 743 745 806
806 742 742 742 750 750 750 750 750 742 742 742 750
743 742 742 742 742 742 742 742 742 742 742 742 742
806 742 742 742 750 750 750 750 750 742 742 742 750
806 742 742 742 742 750 750 750 742 742 742 742 750
743 742 742 742 742 742 742 742 742 742 742 742 742
806 750 750 750 750 750 750 750 750 750 742 742 742
806 750 750 750 750 750 750 750 750 750 742 742 742
743 742 742 742 742 742 742 750 750 742 742 742 742
743 742 742 750 750 742 742 750 750 742 742 750 750
743 742 742 750 750 742 1010 750 750 742 1010 750 750