MtPyre_2F_Layout (13x13)
740 707 708 709 751 740 751 740 751 691 692 693 740
748 715 716 717 759 748 759 748 759 699 700 701 748
743 744 743 745 743 743 806 806 743 744 743 745 806
743 742 742 742 742 742 750 750 742 742 742 742 750
806 750 742 742 750 750 742 742 750 750 742 742 742
806 750 742 742 742 750 742 742 750 742 742 742 742
743 742 750 750 742 742 742 742 742 742 750 750 742
743 742 750 750 742 742 742 742 742 742 750 750 742
806 750 742 742 750 750 742 742 750 750 742 742 750
806 750 742 742 750 750 742 742 750 750 742 1010 750
743 742 742 742 742 742 742 742 742 742 742 742 742
806 750 742 742 750 750 742 742 750 750 742 750 750
806 750 742 742 750 750 742 742 750 750 742 750 750