MtPyre_4F_Layout (13x13)
513 513 513 513 513 513 513 740 751 691 692 693 746
513 513 513 513 513 513 513 748 759 699 700 701 747
751 751 751 751 751 751 799 806 806 744 743 745 806
759 759 759 759 759 759 807 806 750 742 742 742 750
751 707 708 709 751 751 751 751 746 734 207 207 740
759 715 716 717 759 759 759 759 747 734 207 207 748
806 744 743 745 806 806 806 806 806 743 743 743 806
806 742 742 742 750 750 750 750 750 742 742 742 742
743 742 742 742 742 742 742 742 742 742 742 742 750
750 750 750 750 750 750 750 750 750 742 742 742 750
806 742 742 749 742 742 750 750 750 1010 742 742 742
806 742 742 742 742 742 750 750 750 750 750 750 750
806 742 1010 742 742 742 742 742 742 742 742 742 742