MtPyre_1F_Layout (22x19)
513 513 513 513 513 513 513 513 513 751 691 692 693 751 751 740 751 751 740 751 751 740
513 513 513 513 513 513 513 513 513 759 699 700 701 759 759 748 759 759 748 759 759 748
513 513 513 513 513 513 513 513 513 743 744 743 745 806 806 743 743 743 743 743 743 743
513 513 513 751 740 751 751 740 799 743 742 742 742 750 750 742 750 750 750 742 750 750
513 513 513 759 748 759 759 748 807 743 742 742 742 750 750 742 750 750 750 742 750 750
513 513 513 743 743 743 743 743 743 743 742 742 742 750 750 742 742 742 742 742 742 742
513 513 513 518 519 742 742 742 742 742 742 742 742 742 742 742 750 750 750 742 750 750
513 513 513 513 513 513 513 513 513 806 750 742 742 742 742 742 750 750 750 742 750 750
513 513 513 513 513 513 513 513 513 806 750 742 742 742 742 742 742 742 742 742 742 742
513 513 513 513 513 513 513 513 513 743 742 750 750 742 742 742 742 742 742 742 742 742
513 513 513 513 513 513 513 513 513 743 742 750 750 742 742 742 742 742 742 742 742 742
513 513 513 513 513 513 513 513 513 806 750 742 742 750 750 742 742 742 742 742 750 750
513 513 513 513 513 513 513 513 513 806 750 742 742 750 750 742 742 742 742 742 750 750
513 513 513 513 513 513 513 513 513 513 513 513 513 513 513 513 513 743 742 513 513 513
513 513 513 513 513 513 513 513 513 513 513 513 513 513 513 513 513 743 742 513 513 513
513 513 513 513 513 513 513 513 513 513 513 513 513 513 513 513 513 743 742 513 513 513
513 513 513 513 513 513 513 513 513 513 513 513 513 513 513 513 513 743 742 513 513 513
513 513 513 513 513 513 513 513 513 513 513 513 513 513 513 513 513 743 742 513 513 513
513 513 513 513 513 513 513 513 513 513 513 513 513 513 513 513 513 518 519 513 513 513