MtPyre_Exterior_Layout (38x51)
107 107 190 115 115 113 113 113 113 107 1 104 211 104 211 1 1 112 829 818 818 827 114 1 1 1 1 117 117 1 117 109 113 113 117 113 191 109
115 115 107 190 115 113 113 113 107 211 104 115 1 112 1 1 1 112 829 818 818 827 114 1 1 1 1 117 117 1 117 212 109 113 191 109 113 117
190 115 115 113 115 113 113 107 115 1 112 115 1 112 1 1 1 112 829 818 818 827 114 1 1 1 1 117 117 1 117 1 114 109 113 191 109 191
107 190 115 113 115 113 113 115 115 1 112 115 1 112 1 104 106 112 829 818 818 827 114 104 106 1 1 117 117 1 117 1 114 191 109 113 191 109
115 113 115 107 190 113 107 211 2 1 112 115 1 112 1 139 140 112 829 818 818 827 114 139 140 1 1 117 117 1 117 1 114 113 191 109 113 117
190 113 115 115 113 107 115 1 1 1 112 115 1 112 1 805 1 112 829 818 818 827 114 1 805 1 1 117 114 1 114 1 212 109 113 191 109 117
113 107 190 115 113 115 115 104 105 106 112 115 1 112 1 104 106 112 829 818 818 827 114 104 106 1 1 117 114 1 114 1 1 114 113 113 117 117
107 115 113 115 113 115 115 112 116 122 112 115 1 112 1 139 140 112 829 818 818 827 114 139 140 1 116 125 114 1 114 104 106 114 107 109 117 117
115 115 113 115 113 115 115 112 114 804 112 115 1 120 137 1 805 112 829 824 824 826 114 805 1 1 117 116 122 1 114 112 114 114 115 117 117 117
115 115 113 115 113 115 115 112 114 1 112 115 104 106 112 805 1 120 122 825 825 828 122 1 805 1 117 114 104 106 114 112 114 114 115 117 117 117
115 115 113 115 113 115 115 112 114 1 112 115 115 114 120 121 121 121 121 808 809 121 121 121 121 121 125 114 112 114 114 112 114 114 115 117 117 117
115 115 113 115 113 115 115 120 122 1 112 115 115 114 805 1 805 1 805 472 474 805 1 805 1 805 1 114 112 114 114 112 114 114 115 117 117 117
115 115 113 115 113 115 115 1 1 1 112 115 115 114 1 1 1 1 1 472 474 1 1 1 1 1 116 122 120 122 114 112 114 114 123 125 117 117
115 115 113 115 113 115 115 1 104 106 112 115 112 114 804 1 804 1 1 472 474 1 1 804 1 804 117 804 804 116 122 112 114 114 113 113 117 117
115 115 113 115 113 115 115 1 112 114 112 115 120 122 1 1 1 1 1 480 482 1 1 1 1 1 117 1 1 114 1 112 114 114 113 113 117 117
115 115 113 115 113 115 115 1 112 114 112 123 124 124 124 124 124 124 124 175 207 124 121 121 121 124 122 1 1 114 804 112 114 114 113 113 117 117
115 123 137 123 137 115 115 1 120 122 120 124 145 145 145 145 145 145 145 175 207 137 104 105 105 106 1 1 1 114 1 112 114 114 113 113 117 117
115 113 115 113 115 115 115 1 1 1 1 1 1 1 1 1 1 1 1 480 482 112 120 121 121 122 1 1 1 114 804 120 122 114 113 113 117 117
115 113 115 113 115 115 123 137 1 1 1 1 1 1 1 1 1 1 1 1 1 120 121 121 121 121 175 207 121 122 1 804 116 125 113 113 117 117
115 113 115 113 115 123 137 115 1 1 1 1 1 1 1 1 1 1 1 1 1 1 1 1 1 1 1 1 1 1 1 116 125 113 113 116 125 117
115 113 115 113 115 113 115 123 137 1 13 13 104 105 105 105 105 105 106 1 1 1 1 1 1 1 1 1 116 124 124 125 116 124 124 125 116 125
115 113 115 113 115 113 123 137 115 13 13 13 120 121 121 121 121 137 114 1 116 124 124 124 175 207 207 124 125 116 169 169 125 116 124 124 125 113
123 137 123 137 123 137 113 115 123 169 137 13 13 13 13 1 804 112 114 116 125 116 169 169 175 207 207 169 169 125 116 145 169 125 116 169 169 169
137 123 137 123 137 115 113 123 169 137 123 124 124 124 137 1 1 120 122 117 113 117 116 145 175 207 207 145 145 145 125 1 116 145 125 113 113 113
115 113 115 113 115 123 124 121 137 123 169 169 169 137 123 124 124 124 124 125 116 125 114 480 473 473 473 482 1 1 1 116 125 113 113 113 113 113
115 113 115 113 123 169 137 4 120 145 145 145 137 123 169 169 169 169 169 169 125 116 122 1 480 481 482 1 104 106 116 125 113 113 113 113 113 113
115 113 115 113 113 113 115 1 4 1 1 4 120 145 145 145 145 145 145 145 145 122 1 1 1 1 1 1 139 140 117 113 113 113 113 113 113 113
115 113 115 113 113 113 115 1 1 1 1 1 1 1 1 1 1 1 4 1 1 1 1 1 1 1 1 1 116 124 125 113 113 113 113 113 113 113
115 113 115 113 113 113 123 137 1 1 1 1 1 1 1 1 1 1 1 1 1 1 1 1 1 116 124 124 125 113 113 113 113 113 113 113 113 116
115 113 123 137 113 113 113 123 124 175 207 124 124 124 124 124 124 124 124 124 137 1 1 1 116 125 113 113 113 113 113 113 113 113 113 113 113 117
123 137 113 123 124 124 124 169 169 175 207 169 169 169 169 169 169 169 169 137 123 124 124 124 125 113 113 113 113 113 113 113 113 113 116 124 124 125
137 123 124 169 169 169 169 169 169 175 207 169 169 169 169 169 169 137 113 123 169 169 169 169 169 124 124 124 124 124 124 124 124 124 125 116 124 169
123 124 169 169 169 169 169 169 169 175 207 169 169 169 169 137 113 123 124 169 169 169 169 169 169 169 169 169 169 169 169 169 169 169 169 125 113 113
169 169 169 169 169 169 169 169 169 175 207 145 137 113 113 123 124 169 169 169 169 169 169 169 169 137 113 113 113 113 113 113 113 113 113 113 113 113
169 169 169 169 169 169 169 137 480 473 473 482 120 124 124 145 145 145 145 145 145 145 137 113 113 123 124 124 124 124 124 124 124 124 124 124 124 124
169 169 169 169 169 169 137 115 1 480 482 1 1 1 1 13 13 13 13 13 1 1 139 124 124 145 145 145 145 145 145 169 169 169 169 169 169 169
169 169 169 169 169 137 115 123 124 137 1 1 1 1 13 13 13 13 13 13 13 1 1 1 1 1 1 1 1 1 1 116 169 169 169 169 169 169
169 169 169 169 137 115 123 169 137 123 124 124 124 137 13 13 13 13 13 13 13 13 1 1 1 1 1 1 1 1 1 117 116 169 169 169 169 169
169 169 169 137 115 123 137 113 123 137 113 113 113 123 175 207 137 13 13 13 13 116 124 124 124 124 124 175 207 207 169 125 117 113 116 169 169 169
169 137 113 115 115 113 115 113 113 115 113 113 113 113 113 113 123 124 124 124 124 125 113 116 124 169 169 175 207 207 169 169 125 116 125 116 169 169
137 123 137 115 115 113 123 137 113 123 124 124 124 124 137 113 113 113 113 113 113 113 116 125 116 124 169 175 207 207 169 169 169 125 116 125 116 169
115 113 115 115 115 113 113 123 124 169 159 169 169 137 123 124 124 124 124 124 124 124 125 116 125 116 145 175 207 207 145 169 169 169 125 116 125 113
115 113 115 115 115 113 113 116 169 145 167 145 137 123 169 169 169 169 169 169 169 169 169 125 116 122 480 473 473 482 1 116 124 124 124 125 113 113
115 113 115 115 123 124 124 122 1 472 473 482 120 145 145 145 145 145 145 145 145 145 145 145 122 13 1 480 482 1 1 117 113 113 113 113 113 113
115 113 115 123 124 124 137 1 1 480 482 1 1 4 1 1 4 4 1 13 13 13 13 13 13 13 13 1 1 1 116 125 113 113 113 113 113 113
115 113 115 113 113 113 123 137 1 1 1 1 1 1 1 1 1 1 1 1 13 13 13 13 13 13 13 13 1 116 125 113 113 113 113 116 124 124
115 113 123 137 113 113 113 123 124 124 124 124 124 124 124 124 124 124 124 124 124 124 124 124 124 124 124 124 124 125 113 113 113 113 113 117 113 113
123 137 113 123 124 124 124 169 169 169 169 169 169 169 137 113 113 113 113 113 113 113 113 113 113 113 113 113 113 113 113 113 113 116 124 125 113 113
113 123 124 169 169 169 169 169 169 169 137 113 113 113 123 124 124 124 124 124 124 124 124 124 124 124 124 124 124 124 124 124 124 125 113 116 124 124
124 169 169 169 169 169 169 169 137 113 123 124 124 124 169 169 169 169 169 169 169 169 169 169 169 169 169 169 169 169 169 169 169 169 124 125 116 169
169 169 169 169 169 169 169 137 123 124 169 169 169 169 169 169 169 169 169 169 169 169 169 169 169 169 169 169 169 169 169 169 169 169 169 169 125 116