MtPyre_6F_Layout (13x13)
746 707 708 709 740 751 751 751 751 751 751 751 751
747 715 716 717 748 759 759 759 759 759 759 759 759
806 744 743 745 806 806 743 743 743 743 743 743 806
743 742 742 742 750 742 742 742 750 750 742 742 742
743 742 742 750 750 742 742 742 750 742 742 742 742
806 742 742 742 742 742 742 750 750 742 742 742 750
751 751 751 751 751 751 751 751 751 746 734 740 751
759 759 759 759 759 759 759 759 759 747 734 748 759
806 743 743 806 806 743 983 743 806 806 743 743 806
743 742 742 750 742 742 742 742 742 750 742 742 742
743 1010 742 742 742 742 742 742 742 742 742 742 742
743 742 742 750 742 742 742 742 742 750 742 742 742
806 742 742 750 750 742 742 742 750 750 742 742 750