MtPyre_5F_Layout (13x13)
740 691 692 693 751 746 513 513 513 513 513 513 513
748 699 700 701 759 747 513 513 513 513 513 513 513
806 744 743 745 806 743 783 751 751 751 751 751 751
806 742 742 742 750 742 791 759 759 759 759 759 759
751 746 734 740 751 751 751 751 751 707 708 709 751
759 747 734 748 759 759 759 759 759 715 716 717 759
806 743 743 743 806 806 806 806 806 744 743 745 806
806 742 742 742 750 742 742 742 750 742 742 742 750
743 742 742 742 742 742 742 742 742 742 742 742 742
806 750 742 742 742 750 750 750 742 742 742 750 750
743 742 750 750 750 742 749 742 750 750 750 742 1010
806 742 742 750 742 742 742 742 742 750 742 742 750
806 742 742 742 742 742 742 742 742 742 742 742 1010