MtPyre_Summit_Layout (50x37)
161 161 161 161 161 161 161 161 161 161 161 161 161 161 161 161 161 833 834 834 834 834 834 834 834 834 834 834 834 835 161 161 161 161 161 161 161 161 161 161 161 161 161 161 161 161 161 161 161 161
161 161 161 161 161 161 161 161 161 161 161 161 161 161 161 161 833 115 116 121 121 121 121 121 121 121 121 121 137 117 835 161 161 161 161 161 161 161 161 161 161 161 161 161 161 161 161 161 161 161
161 161 161 161 161 161 833 834 834 834 834 834 834 834 834 834 190 115 114 1 1 1 1 810 1 1 1 1 112 117 191 834 834 834 834 834 834 834 834 835 161 161 161 161 161 161 161 161 161 161
161 161 161 161 161 833 115 116 124 121 121 121 121 121 121 121 137 115 114 1 1 1 810 1 810 1 1 1 112 117 116 121 121 121 121 121 121 121 137 114 835 161 161 161 161 161 161 161 161 161
161 161 161 161 833 115 115 114 13 13 805 13 805 1 1 1 112 115 114 1 1 1 812 813 814 1 1 1 112 117 114 1 1 13 805 13 805 13 112 114 114 835 161 161 161 161 161 161 161 161
161 161 161 833 115 115 115 114 13 13 13 13 13 13 1 1 112 115 114 1 1 1 1 1 1 1 1 1 112 117 114 1 1 13 13 13 13 13 112 114 114 114 2 2 212 835 161 161 161 161
833 211 2 112 115 115 115 191 105 105 105 105 105 105 106 1 112 115 114 1 1 1 1 1 1 1 1 1 112 117 114 1 104 105 105 105 106 13 112 114 114 114 1 104 106 114 212 835 161 161
115 104 106 112 115 115 123 124 124 124 124 124 124 137 114 1 112 115 191 105 106 1 1 1 1 1 104 105 190 117 114 1 112 116 124 124 122 13 120 122 114 114 1 112 117 114 1 117 835 161
115 112 114 112 115 120 145 145 145 145 145 145 137 115 114 1 112 120 121 121 122 811 464 465 466 811 120 121 121 122 114 1 112 117 116 145 121 121 121 121 122 114 1 112 117 114 1 117 117 835
115 112 114 112 115 104 105 105 105 105 106 1 112 115 114 1 112 1 1 1 1 1 472 473 474 1 1 1 1 1 114 1 112 117 114 104 105 105 105 105 106 114 1 112 117 114 1 117 117 117
115 112 114 112 115 120 121 121 121 137 114 1 112 115 114 1 120 121 121 121 121 121 175 207 207 121 121 121 121 121 122 1 112 117 114 112 116 121 121 137 114 114 1 112 117 114 1 117 117 117
115 112 114 112 115 104 105 106 1 112 114 1 112 115 114 1 1 1 1 1 1 1 472 473 474 1 1 1 1 1 1 1 112 117 114 112 114 1 1 112 114 114 1 112 117 114 1 117 117 117
115 112 114 112 115 112 113 114 1 112 114 1 112 115 191 105 105 105 105 105 105 106 472 473 474 104 105 105 105 105 105 105 191 117 114 112 114 1 1 112 114 114 104 190 117 114 1 117 117 117
115 112 114 112 115 120 121 122 1 112 114 1 112 123 124 124 124 124 124 124 124 122 472 473 474 120 124 124 124 124 124 124 124 125 114 112 114 1 1 112 114 114 112 116 125 114 1 117 117 117
115 120 122 112 120 121 121 121 137 115 114 1 120 145 145 145 145 145 145 145 145 121 175 207 207 121 145 145 145 145 145 145 145 145 122 112 114 1 1 120 122 114 112 117 116 122 1 117 117 117
115 1 1 112 1 1 1 1 112 115 191 105 105 105 105 105 105 105 105 106 1 1 472 473 474 1 1 104 105 105 105 105 105 105 105 190 191 105 106 116 169 122 112 117 114 1 1 117 117 117
115 1 1 112 104 105 105 106 112 123 124 124 124 124 124 124 124 124 124 122 804 1 472 473 474 1 804 120 124 124 124 124 124 124 124 124 124 124 125 114 1 1 112 117 114 1 1 117 117 117
123 137 1 112 123 121 137 114 120 169 169 169 169 169 169 169 169 169 169 169 121 121 175 207 207 121 145 145 145 145 145 145 145 145 145 145 145 145 145 122 1 1 120 125 114 1 1 117 117 117
113 115 1 112 1 1 112 114 1 1 1 1 1 1 1 1 1 1 1 1 1 1 472 473 474 1 1 1 1 1 1 1 1 1 1 104 105 105 105 105 106 1 116 121 122 1 116 125 117 117
113 115 1 120 124 137 115 191 106 1 1 104 105 105 105 105 105 105 105 105 106 1 472 473 474 1 104 105 106 1 1 1 1 1 104 123 124 124 124 124 125 106 114 1 1 1 117 116 125 117
113 115 1 1 1 112 123 137 114 1 1 120 137 116 121 121 121 121 137 113 114 1 472 473 474 1 112 113 114 1 104 105 106 1 120 145 145 145 145 137 116 122 114 1 1 116 125 117 113 117
113 123 137 1 1 112 1 112 114 1 1 1 112 114 104 105 106 1 112 113 114 1 472 473 474 1 112 113 114 1 112 113 114 1 1 1 1 1 1 112 114 1 114 1 1 117 113 117 113 117
113 113 123 137 1 112 1 112 114 804 1 804 112 114 112 113 114 1 112 113 114 1 472 473 474 1 112 113 114 1 120 121 122 1 1 804 1 804 1 112 114 1 114 1 1 117 116 125 113 117
137 113 113 115 1 120 137 115 114 1 1 1 112 114 120 121 122 1 112 113 114 1 472 473 474 1 112 113 114 805 1 1 1 1 1 13 13 13 13 112 114 1 114 1 116 125 117 113 113 117
115 113 113 115 1 1 112 115 114 1 1 1 112 114 1 1 1 805 112 113 114 1 472 473 474 1 112 113 114 1 1 805 1 1 13 13 13 13 13 112 117 116 122 1 117 113 117 113 113 117
115 113 113 115 1 1 112 115 114 804 1 804 112 114 1 805 1 1 112 113 114 1 472 473 474 1 112 113 114 1 104 105 106 13 13 804 13 804 13 112 117 114 1 1 117 116 125 113 116 125
115 113 113 123 124 137 112 115 114 1 1 1 112 114 104 105 106 1 112 113 114 1 472 473 474 1 112 113 114 1 112 113 114 13 13 13 13 13 13 112 117 114 1 1 117 117 113 113 117 113
115 113 113 113 113 115 112 115 191 105 105 105 191 114 112 113 114 1 112 113 114 1 472 473 474 1 112 113 114 1 120 121 122 104 105 105 105 105 105 190 117 114 1 1 117 117 113 116 125 116
115 113 113 113 113 115 112 123 121 121 121 121 121 122 120 121 122 1 112 113 114 1 480 481 482 1 112 113 114 805 1 1 1 120 121 121 121 121 121 121 122 114 1 116 125 117 113 117 113 117
115 113 113 113 113 115 120 137 1 1 1 1 1 1 1 1 1 805 112 113 114 1 1 1 1 1 112 113 114 1 1 805 1 1 1 1 1 1 1 1 1 114 1 117 113 117 113 117 113 117
115 113 113 113 113 115 1 120 124 124 124 137 1 1 1 805 1 1 120 121 122 1 1 1 1 1 120 121 122 1 1 1 1 1 1 1 1 1 116 124 124 122 1 117 116 125 113 117 113 117
115 113 113 113 113 115 1 1 1 1 1 120 124 121 121 121 121 121 121 121 121 121 816 817 817 121 121 121 121 121 121 121 121 121 121 121 121 121 122 1 1 1 1 117 117 113 113 117 113 117
123 124 137 113 113 123 137 1 1 1 1 1 1 1 1 1 1 1 1 1 1 1 815 832 830 1 1 1 1 1 1 1 1 1 1 1 1 1 1 1 1 1 1 117 117 113 113 117 113 117
113 113 123 169 137 113 123 137 1 1 1 1 1 805 1 1 1 805 1 1 1 805 823 818 831 805 1 1 1 805 1 1 1 805 1 1 1 1 1 1 1 1 116 125 117 113 113 117 113 117
124 124 137 113 123 124 137 123 124 137 1 1 1 1 1 1 1 1 1 1 1 1 823 818 831 1 1 1 1 1 1 1 1 1 1 1 1 1 1 1 1 116 125 113 117 116 124 125 113 117
113 113 123 124 124 137 115 113 113 115 1 1 1 804 1 1 1 804 1 1 1 1 823 818 831 1 1 1 1 804 1 1 1 804 1 1 1 1 1 1 1 117 116 124 125 117 113 116 124 125
113 113 113 113 113 115 115 113 113 123 124 124 124 124 124 124 124 124 124 137 1 1 823 818 831 1 1 116 121 121 121 121 121 121 121 121 121 121 121 121 121 125 117 113 113 117 116 125 113 116