NewMauville_Entrance_Layout (9x9)
116 124 124 707 708 709 124 124 137
117 116 169 715 716 717 169 137 115
117 117 976 974 976 975 976 980 115
117 117 976 976 976 976 976 980 115
117 117 976 976 976 976 976 980 115
117 117 976 976 976 976 976 980 115
117 117 976 976 967 976 976 980 115
117 191 982 977 978 979 982 190 115
191 108 108 108 108 108 108 108 190