NewMauville_Inside_Layout (41x41)
520 520 520 616 543 680 543 543 543 543 695 543 543 543 543 618 520 520 520 520 520 520 520 520 616 543 543 665 666 543 543 543 543 543 543 543 543 543 543 543 618
520 520 520 624 551 688 689 551 551 551 703 551 727 727 726 626 520 520 520 520 520 520 520 520 624 727 551 673 674 724 725 551 720 721 722 723 726 727 724 725 626
520 520 520 624 629 696 697 629 559 559 711 559 751 735 734 652 543 543 543 543 543 694 543 543 651 735 629 681 682 732 733 629 728 729 730 731 734 735 732 733 626
520 520 520 624 637 654 567 567 567 567 719 567 567 653 645 660 551 551 551 551 551 702 551 551 659 637 528 528 528 740 741 637 736 737 738 739 637 712 740 741 626
520 520 520 624 637 662 551 551 551 551 551 551 551 661 637 639 559 559 559 559 559 710 559 559 559 638 528 528 528 639 559 638 744 745 746 747 637 528 639 559 626
616 543 543 651 637 652 665 666 618 520 520 520 520 624 637 654 567 567 567 567 567 718 567 567 653 645 528 528 528 528 528 528 639 559 559 559 638 528 528 528 626
624 551 691 659 637 660 673 674 626 520 520 520 520 624 637 662 551 551 551 551 551 551 551 551 661 637 528 528 528 528 528 528 528 574 528 528 528 528 705 704 626
624 629 699 559 638 639 681 682 626 520 520 616 543 651 637 652 543 665 666 618 520 520 520 520 624 637 528 705 528 528 528 528 528 528 528 528 705 528 704 704 626
649 633 623 669 645 670 623 567 650 520 520 624 726 659 637 660 551 673 674 626 520 520 520 520 632 633 567 567 567 567 567 567 567 567 567 567 567 567 567 567 634
624 551 631 677 637 678 631 551 626 520 520 624 734 559 638 639 559 681 682 626 520 520 520 520 640 551 551 551 551 551 551 551 551 551 551 551 551 551 551 551 642
624 629 559 559 638 639 559 559 626 520 520 624 637 566 528 528 528 558 528 626 520 520 520 520 520 520 520 520 520 520 520 520 520 520 520 520 520 520 520 520 520
624 637 558 528 528 528 566 528 626 520 520 632 633 567 567 567 567 567 567 634 520 520 520 520 520 520 520 520 520 520 520 520 520 520 520 520 520 520 520 520 520
649 633 567 669 645 670 567 567 650 520 520 640 551 551 551 551 551 551 551 642 520 520 520 520 520 520 520 520 520 520 520 520 520 520 520 520 520 520 520 520 520
624 724 725 677 637 678 551 551 626 520 520 616 543 680 543 543 543 543 543 665 648 543 543 543 543 543 618 520 520 520 520 520 520 520 520 520 520 520 520 520 520
624 732 733 629 638 639 559 559 626 520 520 624 551 688 689 551 551 726 690 673 656 551 724 725 726 727 626 520 520 520 520 520 520 520 520 520 520 520 520 520 520
624 740 741 637 528 528 528 528 626 520 520 624 629 696 697 629 559 750 708 681 656 629 732 733 734 735 626 520 520 520 520 520 520 520 520 520 520 520 520 520 520
624 629 559 638 528 528 528 528 652 543 695 651 637 528 528 528 528 528 528 528 664 637 740 741 637 528 626 520 520 520 520 520 520 520 520 520 520 520 520 520 520
624 637 705 528 528 528 528 528 660 551 703 659 637 528 528 528 528 528 528 528 672 637 639 559 638 528 626 520 520 520 520 520 520 520 520 520 520 520 520 520 520
624 707 528 528 675 676 528 528 639 559 711 559 638 528 528 528 528 528 528 528 639 638 528 528 528 558 626 520 520 520 520 520 520 520 520 520 520 520 520 520 520
624 706 600 528 683 684 528 528 654 567 719 653 645 528 670 567 567 567 567 658 567 623 567 567 623 567 650 520 520 520 520 520 520 520 520 520 520 520 520 520 520
624 706 705 600 528 712 528 528 662 551 551 661 637 528 678 551 551 551 551 656 551 631 551 551 726 727 626 520 520 520 520 520 520 520 520 520 520 520 520 520 520
649 633 623 567 623 567 623 567 650 520 520 624 637 528 639 559 559 559 559 656 629 559 559 559 750 735 626 520 520 671 543 543 543 543 680 543 679 520 520 520 520
624 551 631 551 631 691 631 692 626 520 520 624 637 528 528 528 566 528 528 656 637 528 528 528 528 528 652 543 694 608 551 692 692 551 688 689 609 543 543 543 618
624 629 559 559 559 699 559 700 626 520 520 624 637 528 528 528 528 528 705 656 637 528 528 528 528 528 660 551 702 659 629 700 701 559 696 697 660 551 551 551 626
624 637 705 528 705 704 705 704 652 543 694 651 663 567 669 645 670 567 567 657 647 669 645 528 528 528 639 559 710 559 638 528 528 528 528 528 639 559 559 559 626
624 707 528 528 528 705 704 704 660 551 702 659 678 551 677 637 678 691 692 656 551 677 637 528 528 528 654 567 718 653 645 528 528 528 528 528 654 567 653 645 626
624 707 704 528 566 528 528 528 639 559 710 559 559 559 559 638 639 699 700 664 629 559 638 528 528 528 662 551 551 661 637 528 528 528 528 528 662 551 661 637 626
624 706 704 528 528 528 528 528 654 567 718 653 645 704 528 528 528 528 528 672 637 528 528 528 528 528 626 520 520 632 633 567 567 567 567 567 634 520 624 637 626
624 706 704 528 528 528 704 704 662 551 551 661 637 704 705 528 528 528 528 639 638 528 528 528 528 528 626 520 520 640 551 551 551 551 551 551 642 520 624 637 626
632 633 653 645 528 654 567 567 634 520 520 632 633 567 567 567 567 567 567 567 567 567 567 567 567 567 634 520 520 520 520 520 520 520 520 520 520 520 624 637 626
640 551 661 637 528 662 551 551 642 520 520 640 551 551 551 551 551 551 551 551 551 551 551 551 551 551 642 520 520 520 520 520 520 520 520 520 520 520 624 637 626
520 520 624 637 528 626 520 520 520 520 520 520 520 520 520 520 520 520 520 520 520 520 520 520 520 520 520 520 520 520 520 520 520 520 520 520 520 520 624 637 626
520 520 624 637 528 626 520 520 520 520 520 520 520 616 665 666 648 543 543 543 543 618 520 520 520 520 616 665 666 543 543 604 622 605 665 666 679 520 624 637 626
520 520 624 637 528 626 520 520 520 520 520 520 520 624 673 674 656 551 691 690 691 626 520 520 520 520 624 673 674 690 692 659 630 660 673 674 609 694 651 637 626
520 520 624 637 528 652 543 543 543 543 543 543 543 651 693 682 656 629 699 698 699 652 543 695 543 543 651 693 682 698 700 559 559 559 681 682 660 702 659 637 626
520 520 624 637 528 660 551 691 691 690 691 551 551 659 637 528 664 637 528 528 528 660 551 703 551 551 659 637 528 528 528 528 528 528 528 528 639 710 559 638 626
520 520 624 637 528 639 559 699 699 698 699 559 559 559 638 528 672 637 558 528 528 639 559 711 559 559 559 638 528 528 528 670 623 567 567 567 654 718 567 567 634
520 520 632 633 567 567 567 567 567 567 567 567 567 653 645 528 639 638 528 528 528 654 567 719 567 567 653 645 528 528 528 678 631 692 692 551 662 551 551 551 642
520 520 640 551 551 551 551 551 551 551 551 551 551 661 637 528 528 528 528 528 528 662 551 551 551 551 661 637 528 528 566 639 559 700 701 559 626 520 520 520 520
520 520 520 520 520 520 520 520 520 520 520 520 520 632 633 567 567 567 567 567 567 634 520 520 520 520 632 633 567 567 567 567 567 567 567 567 634 520 520 520 520
520 520 520 520 520 520 520 520 520 520 520 520 520 640 551 551 551 551 551 551 551 642 520 520 520 520 640 551 551 551 551 551 551 551 551 551 642 520 520 520 520