OldaleTown_Layout (20x20)
468 469 468 469 468 469 468 469 1 464 466 1 468 469 468 469 468 469 468 469
476 477 476 477 484 485 484 487 464 473 474 1 486 485 484 485 476 477 476 477
468 469 468 469 1 1 1 1 472 473 473 466 1 1 1 1 468 469 468 469
476 477 484 487 1 1 1 1 472 473 473 474 1 40 41 41 645 485 484 477
468 469 1 1 620 621 621 622 472 473 473 474 1 48 49 50 51 1 468 469
476 477 1 4 628 629 629 630 472 473 473 473 466 56 57 58 59 1 476 477
468 469 4 1 636 639 637 638 472 473 473 473 474 96 65 66 67 1 468 469
476 477 1 4 644 647 655 646 472 481 481 481 473 465 465 465 465 466 486 485
468 469 4 1 1 464 465 465 474 1 1 4 472 473 473 473 473 473 466 1
484 487 1 464 465 473 473 473 474 4 1 3 472 473 473 473 473 473 482 1
518 1 464 473 473 473 473 473 474 1 4 1 472 473 473 473 473 482 1 1
519 463 480 481 481 473 473 473 473 465 465 465 473 473 473 481 482 1 462 463
468 471 1 1 1 480 481 473 473 473 473 473 473 473 474 1 1 1 470 469
476 477 1 1 1 72 73 642 643 473 473 473 473 481 620 621 621 622 476 477
468 469 1 1 1 80 81 82 83 473 473 473 474 1 628 629 629 630 468 469
476 477 462 463 1 88 89 90 91 472 473 473 474 1 636 639 637 638 476 477
468 469 468 471 1 96 97 98 99 472 473 473 482 1 644 647 655 646 468 469
476 477 476 477 1 1 1 464 465 473 473 474 1 1 1 1 462 463 476 477
468 469 468 469 1 1 1 472 473 473 473 474 1 1 1 1 470 469 468 469
476 477 476 477 462 463 462 632 473 473 473 482 462 463 462 463 476 477 476 477