PacifidlogTown_House2_Layout (10x9)
912 954 955 948 949 913 913 915 913 914
920 710 711 956 957 921 921 542 937 922
928 962 963 964 965 929 929 923 945 930
951 916 917 917 917 917 917 917 918 931
951 924 925 925 938 939 943 925 926 931
929 924 925 942 946 947 925 925 926 931
929 932 933 933 933 933 933 933 934 931
929 931 931 931 931 931 931 931 931 931
998 931 931 931 940 941 931 931 931 999