PacifidlogTown_Layout (20x40)
113 113 113 113 113 113 113 113 113 113 113 113 113 113 113 113 113 113 113 113
113 113 113 113 113 113 113 113 113 113 113 113 113 113 113 113 113 113 113 113
113 113 113 113 113 113 113 113 113 113 113 113 113 113 113 113 113 113 113 116
124 124 137 113 113 113 113 113 113 113 113 113 113 113 113 113 116 124 124 125
137 113 123 137 113 113 113 113 113 113 113 113 113 113 116 124 125 113 113 113
123 137 113 123 121 124 124 124 124 124 124 124 124 124 125 113 113 116 124 124
137 123 124 169 169 169 137 113 113 113 113 113 113 116 169 124 124 125 113 116
123 169 169 169 169 137 123 121 124 124 124 124 124 125 116 169 169 169 124 125
393 393 393 393 385 123 169 169 169 169 169 169 169 169 125 384 393 393 393 393
368 368 514 368 410 393 393 393 393 393 393 393 393 393 393 408 368 368 373 374
520 521 522 523 524 368 368 368 368 368 368 368 368 368 368 368 514 368 381 382
528 529 530 531 532 368 368 368 368 368 368 368 368 368 520 521 522 523 524 368
536 537 538 539 540 368 368 560 561 562 563 368 368 368 528 529 530 531 532 368
536 545 545 545 540 368 520 80 81 82 83 524 368 515 536 537 538 539 540 368
544 545 545 545 548 368 528 88 89 90 91 532 368 515 544 545 545 545 548 368
552 553 553 554 556 368 536 584 97 98 587 540 368 515 552 553 554 553 556 368
368 515 515 600 515 368 536 3 545 545 545 540 368 515 515 515 600 515 368 368
368 515 515 608 592 593 544 545 545 545 545 548 592 593 592 593 608 515 515 368
368 515 515 515 515 515 552 553 554 553 553 556 368 515 368 368 368 514 368 368
368 368 368 514 368 368 368 368 600 368 515 368 368 368 368 520 521 522 523 524
368 520 521 522 523 524 368 368 608 368 515 368 368 368 368 528 529 530 531 532
368 528 529 530 531 532 368 368 600 368 515 368 514 368 368 536 537 538 539 540
368 536 537 538 539 540 368 368 608 368 520 521 522 523 524 544 545 545 545 548
368 544 545 545 545 548 368 368 600 368 528 529 530 531 532 552 553 554 553 556
515 552 553 554 553 556 515 515 608 368 536 537 538 539 540 368 368 600 368 368
515 368 368 600 368 368 368 368 600 368 544 545 545 545 548 368 368 608 368 368
368 368 368 608 592 593 592 593 608 368 552 553 554 553 556 368 368 600 515 515
368 368 368 368 368 368 368 368 600 592 593 592 593 592 593 592 593 608 515 515
368 368 368 368 368 368 368 368 608 368 368 368 368 368 368 368 368 368 368 368
373 374 368 368 368 368 368 368 368 368 368 368 368 368 368 368 368 368 368 368
381 382 368 368 368 368 368 368 368 368 368 368 368 368 368 368 373 374 368 368
368 368 370 379 379 379 379 379 379 379 379 379 379 379 379 372 381 382 368 368
379 379 180 113 113 113 113 107 108 108 108 108 108 109 113 180 379 379 379 379
113 113 113 113 107 108 108 190 113 113 113 113 113 191 108 108 108 109 113 113
107 108 108 190 190 113 113 113 113 113 113 113 113 113 113 113 113 191 108 108
190 113 113 113 113 113 113 113 113 113 113 113 113 113 113 113 113 113 113 113
113 113 113 113 113 113 113 113 113 113 113 113 113 113 113 113 113 113 113 113
113 113 113 113 113 113 113 113 113 113 113 113 113 113 113 113 113 113 113 113
113 113 113 113 113 113 113 113 113 113 113 113 113 113 113 113 113 113 113 113
113 113 113 113 113 113 113 113 113 113 113 113 113 113 113 113 113 113 113 113