PacifidlogTown_House1_Layout (10x9)
912 913 948 949 913 913 913 913 919 914
920 936 956 957 921 921 952 953 927 922
928 944 964 965 929 951 960 961 935 930
929 916 917 917 917 917 917 917 918 931
929 924 925 942 938 939 943 925 926 931
951 924 925 942 946 947 943 925 926 931
929 932 933 933 933 933 933 933 934 931
951 931 931 931 931 931 931 931 931 931
998 931 931 931 940 941 931 931 931 999