PetalburgWoods_Layout (48x44)
468 469 468 469 468 469 468 469 468 469 468 469 476 477 517 517 476 477 468 469 468 469 468 469 468 469 468 469 468 469 468 469 468 469 468 469 468 469 468 469 468 469 468 469 468 469 468 469
476 477 476 477 476 477 476 477 476 477 476 477 468 469 517 517 468 469 476 477 476 477 476 477 476 477 476 477 476 477 476 477 476 477 476 477 476 477 476 477 476 477 476 477 476 477 476 477
468 469 468 469 468 469 468 469 468 469 468 469 476 477 517 517 476 477 468 469 468 469 468 469 468 469 468 469 468 469 468 469 468 469 468 469 468 469 468 469 468 469 468 469 468 469 468 469
476 477 476 477 476 477 476 477 476 477 476 477 468 469 517 517 468 469 476 477 476 477 476 477 476 477 476 477 476 477 476 477 484 485 484 485 484 485 484 485 484 485 484 485 476 477 476 477
468 469 468 469 468 469 468 469 468 469 468 469 484 487 517 517 486 485 468 469 468 469 468 469 468 469 468 469 468 469 468 469 1 1 1 1 1 1 13 13 13 13 13 13 468 469 468 469
476 477 476 477 476 477 476 477 476 477 476 477 329 329 515 515 329 329 476 477 476 477 476 477 476 477 484 498 499 498 499 487 1 1 1 1 1 454 455 454 455 13 13 13 486 485 476 477
468 469 468 469 468 469 468 469 468 469 468 469 1 1 1 1 1 1 468 469 468 469 468 469 468 469 1 468 469 468 469 1 1 1 1 1 1 470 469 468 471 13 13 13 1 1 468 469
476 477 476 477 484 485 484 485 484 485 484 487 1 1 1 1 1 1 476 477 476 477 476 477 484 487 1 486 485 484 487 1 1 1 1 1 1 476 477 476 477 13 13 1 1 1 476 477
468 469 468 469 1 1 1 13 13 13 13 27 1 1 1 1 1 1 468 469 468 469 468 469 13 13 1 1 1 1 1 1 13 13 13 1 1 468 469 468 469 213 135 135 135 214 468 469
476 477 476 477 1 13 13 13 13 13 13 1 1 1 1 1 1 1 486 485 484 485 484 487 13 13 13 1 462 463 454 455 454 455 13 13 1 486 485 484 487 1 1 1 1 1 476 477
468 469 468 469 13 13 13 13 13 13 13 1 1 1 1 1 1 1 1 1 1 13 13 13 13 13 13 13 470 469 468 469 468 471 13 13 13 1 1 1 1 1 1 1 1 13 468 469
476 477 476 477 13 13 13 13 454 455 462 463 462 463 1 1 1 1 462 463 462 463 454 455 454 455 454 455 476 477 476 477 476 477 454 455 454 455 462 463 1 1 1 1 13 13 476 477
468 469 468 469 1 13 13 13 470 469 468 469 468 471 1 1 1 1 470 469 468 469 468 469 468 469 468 469 468 469 468 469 468 469 468 469 468 469 468 471 1 1 1 13 13 13 468 469
476 477 476 477 1 1 1 1 476 477 476 477 476 477 1 1 1 1 486 498 499 498 499 498 499 498 499 498 499 498 499 498 499 498 499 498 499 498 499 498 463 1 1 13 13 13 476 477
468 469 468 469 1 1 1 1 468 469 468 469 468 469 213 135 135 135 214 468 469 468 469 468 469 468 469 468 469 468 469 468 469 468 469 468 469 468 469 468 471 1 1 13 13 13 468 469
476 477 476 477 1 1 1 13 486 485 484 485 484 487 1 1 1 1 1 486 485 484 485 484 485 484 485 484 498 499 498 499 498 499 498 499 498 499 498 499 498 463 1 13 13 13 476 477
468 469 468 469 1 13 13 13 13 13 13 1 1 1 1 1 1 1 1 1 1 1 1 1 1 1 1 1 468 469 468 469 468 469 468 469 468 469 468 469 468 471 1 13 13 13 468 469
476 477 476 477 13 13 13 13 13 13 13 1 1 1 1 1 1 13 13 13 13 1 1 1 1 1 1 1 476 477 476 477 476 477 476 477 476 477 476 477 476 477 1 1 13 13 476 477
468 469 468 469 13 13 13 13 13 13 13 1 1 1 1 1 13 13 13 13 13 13 13 13 13 1 1 1 468 469 468 469 468 469 468 469 468 469 468 469 468 469 1 1 1 13 468 469
476 477 476 477 462 455 454 455 454 455 462 463 1 1 1 1 454 455 454 455 454 455 454 455 454 455 1 1 476 477 476 477 476 477 484 485 476 477 476 477 476 477 1 1 1 1 476 477
468 469 468 469 468 469 468 469 468 469 468 471 1 1 1 1 470 469 468 469 468 469 468 469 468 471 1 1 468 469 468 469 468 469 1 1 468 469 468 469 468 469 213 135 135 214 468 469
476 477 476 477 476 477 476 477 476 477 476 477 1 1 1 1 476 477 476 477 476 477 476 477 476 477 1 1 476 477 476 477 484 487 1 1 486 485 476 477 476 477 13 1 1 1 476 477
468 469 468 469 468 469 468 469 468 469 468 469 213 135 135 214 468 469 468 469 468 469 468 469 468 469 1 1 468 469 468 469 13 1 1 1 1 1 468 469 468 469 13 13 1 1 468 469
476 477 476 477 476 477 484 485 484 485 484 487 1 1 1 1 486 485 484 485 484 485 484 485 484 487 1 1 476 477 476 477 13 1 1 1 1 1 486 485 484 487 13 13 13 1 476 477
468 469 468 469 468 469 1 1 1 1 1 1 1 1 1 1 1 1 13 13 13 13 13 13 13 13 1 1 468 469 468 469 13 13 1 1 1 1 1 1 13 13 13 13 13 1 468 469
476 477 476 477 484 487 13 13 13 1 1 1 1 1 1 1 1 1 1 13 13 13 13 13 13 1 1 1 476 477 476 477 13 13 13 1 462 463 1 13 13 13 13 13 13 13 476 477
468 469 468 469 1 13 13 13 13 13 13 13 13 1 1 1 1 1 1 1 1 1 1 1 1 1 1 1 468 469 468 469 13 13 13 13 470 471 1 13 13 13 13 13 13 13 468 469
476 477 476 477 13 13 13 13 13 13 454 455 454 455 462 463 1 1 1 1 1 1 462 463 462 463 462 463 476 477 476 477 13 13 13 13 476 477 462 455 13 13 13 13 454 455 476 477
468 469 468 469 13 13 13 13 13 13 470 469 468 469 468 471 1 1 1 1 1 1 470 469 468 469 468 469 468 469 468 469 13 13 13 13 468 469 468 471 13 13 13 13 470 469 468 469
476 477 476 477 13 13 13 13 13 13 476 477 476 477 476 477 1 1 1 1 1 1 476 477 476 477 476 477 476 477 476 477 1 13 13 13 476 477 476 477 462 455 454 455 476 477 476 477
468 469 468 469 13 13 13 13 13 13 468 469 468 469 468 469 213 135 135 135 135 214 468 469 468 469 468 469 468 469 468 469 1 1 1 13 468 469 468 469 468 469 468 469 468 469 468 469
476 477 476 477 13 13 13 13 13 13 486 485 484 485 484 487 1 1 1 1 1 1 486 485 484 485 476 477 476 477 476 477 1 1 1 1 476 477 476 477 476 477 476 477 476 477 476 477
468 469 468 469 1 13 13 13 13 13 13 13 13 13 27 1 1 1 1 1 1 1 13 13 13 13 468 469 468 469 468 469 213 135 135 214 468 469 468 469 468 469 468 469 468 469 468 469
476 477 476 477 462 463 1 13 13 13 13 13 13 1 1 1 1 1 1 1 1 13 13 13 13 13 486 485 484 485 484 487 1 1 1 1 486 485 484 485 484 485 476 477 476 477 476 477
468 469 468 469 468 471 1 1 1 1 1 1 1 1 1 1 1 1 1 1 1 13 13 13 13 13 13 13 1 1 1 1 1 1 1 1 13 13 13 13 13 13 468 469 468 469 468 469
476 477 476 477 476 477 462 463 462 463 462 463 462 463 1 1 1 1 1 1 462 455 454 455 454 455 454 463 462 463 462 463 462 463 1 1 1 13 13 1 13 13 476 477 476 477 476 477
468 469 468 469 468 469 468 469 468 469 468 469 468 471 1 1 1 1 1 1 470 469 468 469 468 469 468 469 468 469 468 469 468 471 1 1 1 13 13 13 13 13 468 469 468 469 468 469
476 477 476 477 476 477 476 477 476 477 476 477 476 477 1 1 1 1 1 1 476 477 476 477 476 477 476 477 476 477 476 477 476 477 1 1 1 1 13 13 454 455 476 477 476 477 476 477
468 469 468 469 468 469 468 469 468 469 468 469 468 469 329 329 516 516 329 329 468 469 468 469 468 469 468 469 468 469 468 469 468 469 329 329 516 516 329 329 470 469 468 469 468 469 468 469
476 477 476 477 476 477 476 477 476 477 476 477 476 477 462 463 517 517 462 463 476 477 476 477 476 477 476 477 476 477 476 477 476 477 462 463 517 517 462 463 476 477 476 477 476 477 476 477
468 469 468 469 468 469 468 469 468 469 468 469 468 469 468 471 517 517 470 469 468 469 468 469 468 469 468 469 468 469 468 469 468 469 468 471 517 517 470 469 468 469 468 469 468 469 468 469
476 477 476 477 476 477 476 477 476 477 476 477 476 477 476 477 517 517 476 477 476 477 476 477 476 477 476 477 476 477 476 477 476 477 476 477 517 517 476 477 476 477 476 477 476 477 476 477
468 469 468 469 468 469 468 469 468 469 468 469 468 469 468 469 517 517 468 469 468 469 468 469 468 469 468 469 468 469 468 469 468 469 468 469 517 517 468 469 468 469 468 469 468 469 468 469
476 477 476 477 476 477 476 477 476 477 476 477 476 477 476 477 517 517 476 477 476 477 476 477 476 477 476 477 476 477 476 477 476 477 476 477 517 517 476 477 476 477 476 477 476 477 476 477