PetalburgCity_Gym_Layout (9x112)
514 632 633 541 542 543 634 635 516
522 640 641 523 523 523 642 643 524
530 648 649 531 531 531 650 651 532
521 513 513 513 513 513 513 513 513
521 513 513 552 553 554 513 513 513
521 513 513 560 561 562 513 513 513
521 513 513 568 569 570 513 513 513
521 513 513 513 513 513 513 513 513
520 520 520 520 520 520 520 520 520
520 520 520 520 520 520 520 520 520
520 520 520 520 520 520 520 520 520
520 520 520 520 520 520 520 520 520
520 520 520 520 520 520 520 520 520
514 515 515 541 542 543 515 536 516
522 523 523 523 523 523 523 544 524
530 531 531 531 531 531 531 531 532
521 577 578 579 580 581 582 583 513
521 585 586 587 588 589 590 591 513
521 593 594 595 596 597 598 599 513
521 601 602 603 604 605 606 607 513
521 513 513 513 513 513 513 513 513
520 520 520 520 520 520 520 520 520
520 520 520 520 520 520 520 520 520
520 520 520 520 520 520 520 520 520
520 520 520 520 520 520 520 520 520
520 520 520 520 520 520 520 520 520
514 536 515 541 542 543 515 515 516
522 544 523 523 523 523 523 523 524
530 531 531 531 531 531 531 531 532
521 577 578 579 580 581 582 583 513
521 585 586 587 588 589 590 591 513
521 593 594 595 596 597 598 599 513
521 601 602 603 604 605 606 607 513
521 513 513 513 513 513 513 513 513
520 520 520 520 520 520 520 520 520
520 520 520 520 520 520 520 520 520
520 520 520 520 520 520 520 520 520
520 520 520 520 520 520 520 520 520
520 520 520 520 520 520 520 520 520
514 515 515 541 542 543 515 536 516
522 523 523 523 523 523 523 544 524
530 531 531 531 531 531 531 531 532
521 577 578 579 580 581 582 583 513
521 585 586 587 588 589 590 591 513
521 593 594 595 596 597 598 599 513
521 601 602 603 604 605 606 607 513
521 513 513 513 513 513 513 513 513
520 520 520 520 520 520 520 520 520
520 520 520 520 520 520 520 520 520
520 520 520 520 520 520 520 520 520
520 520 520 520 520 520 520 520 520
520 520 520 520 520 520 520 520 520
514 536 515 541 542 543 515 536 516
522 544 523 523 523 523 523 544 524
530 531 531 531 531 531 531 531 532
521 577 578 579 580 581 582 583 513
521 585 586 587 588 589 590 591 513
521 593 594 595 596 597 598 599 513
521 601 602 603 604 605 606 607 513
521 513 513 513 513 513 513 513 513
520 520 520 520 520 520 520 520 520
520 520 520 520 520 520 520 520 520
520 520 520 520 520 520 520 520 520
520 520 520 520 520 520 520 520 520
520 520 520 520 520 520 520 520 520
514 536 515 541 542 543 515 515 516
522 544 523 523 523 523 523 523 524
530 531 531 531 531 531 531 531 532
521 577 578 579 580 581 582 583 513
521 585 586 587 588 589 590 591 513
521 593 594 595 596 597 598 599 513
521 601 602 603 604 605 606 607 513
521 513 513 513 513 513 513 513 513
520 520 520 520 520 520 520 520 520
520 520 520 520 520 520 520 520 520
520 520 520 520 520 520 520 520 520
520 520 520 520 520 520 520 520 520
520 520 520 520 520 520 520 520 520
514 536 515 541 542 543 515 536 516
522 544 523 523 523 523 523 544 524
530 531 531 531 531 531 531 531 532
521 577 578 579 580 581 582 583 513
521 585 586 587 588 589 590 591 513
521 593 594 595 596 597 598 599 513
521 601 602 603 604 605 606 607 513
521 513 513 513 513 513 513 513 513
520 520 520 520 520 520 520 520 520
520 520 520 520 520 520 520 520 520
520 520 520 520 520 520 520 520 520
520 520 520 520 520 520 520 520 520
520 520 520 520 520 520 520 520 520
514 536 515 541 542 543 515 536 516
522 544 523 523 523 523 523 544 524
530 531 531 531 531 531 531 531 532
521 577 578 579 580 581 582 583 513
521 585 586 587 588 589 590 591 513
521 593 594 595 596 597 598 599 513
521 601 602 603 604 605 606 607 513
521 513 513 513 513 513 513 513 513
520 520 520 520 520 520 520 520 520
520 520 520 520 520 520 520 520 520
520 520 520 520 520 520 520 520 520
520 520 520 520 520 520 520 520 520
520 520 520 520 520 520 520 520 520
514 536 515 541 542 543 515 536 516
522 544 523 523 523 523 523 544 524
530 531 531 531 531 531 531 531 532
521 513 513 513 513 513 513 513 513
521 513 513 513 513 513 513 513 513
521 576 513 513 513 513 513 576 513
521 584 555 513 513 513 513 584 555
521 531 563 513 528 529 513 531 563