PetalburgCity_Layout (30x30)
468 469 468 469 468 469 468 469 468 469 468 469 468 469 468 469 468 469 468 469 468 469 468 469 468 469 468 469 468 469
476 477 476 477 597 590 589 590 589 590 598 498 499 498 499 498 499 498 499 485 484 485 484 485 484 485 476 477 476 477
468 469 468 469 580 8 9 9 9 10 582 468 469 468 469 468 469 468 469 1 1 1 176 177 177 178 468 469 468 469
476 477 476 477 588 16 17 17 17 18 588 486 485 484 485 484 485 484 487 176 177 177 192 161 161 186 476 477 476 477
468 469 468 469 596 24 11 25 11 26 588 575 426 427 427 427 427 428 575 184 161 161 161 161 161 186 468 469 468 469
476 477 476 477 4 32 19 33 19 34 588 588 434 435 435 435 435 436 588 184 161 161 161 161 161 186 476 477 476 477
468 469 468 469 4 4 280 282 4 4 588 588 440 441 442 435 443 444 588 184 161 161 161 161 161 186 468 469 468 469
476 477 476 477 4 4 288 290 4 4 588 588 448 449 450 453 451 452 588 184 161 161 161 161 161 186 476 477 476 477
468 469 468 469 1 1 288 290 1 572 614 588 456 457 458 461 459 460 588 184 161 161 161 161 161 186 468 469 468 469
476 477 484 487 1 1 288 290 3 612 613 596 1 1 280 281 282 304 596 2 2 2 2 2 592 593 600 601 476 477
468 469 1 1 1 1 288 290 1 1 1 1 1 1 288 289 290 305 1 1 1 1 1 1 48 49 50 51 468 469
486 487 1 1 1 1 288 290 1 1 1 1 1 1 288 289 290 1 1 1 1 1 1 1 56 57 58 59 476 477
1 1 280 281 281 281 289 289 281 281 281 281 281 281 289 289 290 1 1 1 1 1 1 1 96 65 66 67 468 469
462 463 296 297 297 297 297 594 595 297 297 297 297 297 297 289 290 1 1 72 73 74 75 1 1 280 282 1 476 477
468 471 176 177 177 177 178 470 471 1 1 1 1 1 1 288 290 1 1 80 81 82 83 1 1 288 290 1 468 469
476 477 184 161 161 161 186 476 477 1 1 1 1 1 1 288 290 1 1 88 89 90 91 1 1 288 290 1 486 485
468 469 184 161 161 161 186 468 469 8 9 9 10 1 1 288 290 3 1 96 97 98 99 1 1 288 290 1 1 1
476 477 184 161 161 161 186 476 477 16 17 17 18 1 1 288 289 281 281 281 281 281 281 281 281 289 289 282 1 1
468 469 184 161 161 161 186 468 469 24 25 11 26 1 1 288 289 297 297 297 297 297 297 297 297 297 297 298 1 1
476 477 184 161 161 161 186 486 487 32 33 19 34 1 1 288 290 1 1 1 1 1 1 1 1 1 462 463 462 463
468 469 184 161 161 161 186 1 1 1 513 1 1 1 1 288 290 1 572 573 573 573 573 573 573 574 470 469 468 469
476 477 184 161 161 161 186 1 1 1 1 1 1 1 1 288 290 1 580 8 9 9 10 581 581 582 476 477 476 477
468 469 184 161 161 161 186 1 1 1 1 1 1 1 1 288 290 1 588 16 17 17 18 7 7 588 468 469 468 469
476 477 184 161 161 161 194 177 177 177 177 178 462 463 1 288 290 1 596 24 25 11 26 7 7 588 476 477 476 477
468 469 184 161 161 161 161 161 161 161 161 186 470 471 4 288 290 4 1 32 33 19 34 4 4 588 468 469 468 469
476 477 184 161 161 161 161 161 161 161 161 186 476 477 1 288 289 281 281 281 281 282 1 4 4 588 476 477 476 477
468 469 184 161 161 161 161 161 161 161 161 186 468 469 4 296 297 297 297 297 297 298 1 1 1 596 468 469 468 469
476 477 184 161 161 510 511 510 511 510 511 186 476 477 462 463 462 463 462 463 462 463 462 463 462 463 476 477 476 477
468 469 2 2 2 508 509 508 509 508 509 2 468 469 468 469 468 469 468 469 468 469 468 469 468 469 468 469 468 469
476 477 462 463 462 499 498 499 498 499 498 463 476 477 476 477 476 477 476 477 476 477 476 477 476 477 476 477 476 477