PokemonCenter_2F_Layout (14x9)
520 521 524 575 588 604 575 589 604 575 590 604 575 527
528 529 4 583 596 612 583 597 612 583 598 612 583 535
536 537 540 591 616 542 591 616 542 591 616 542 591 610
544 514 514 599 624 605 599 624 605 599 624 605 599 559
664 665 514 613 619 514 607 619 514 607 619 514 607 559
672 673 514 615 549 514 615 549 514 615 549 514 615 611
680 681 514 606 514 514 514 514 606 514 514 514 514 551
544 514 514 614 564 550 564 550 614 564 550 564 550 551
552 514 514 514 514 514 514 514 514 514 514 514 514 567