PokeMart_Layout (11x8)
528 546 530 531 531 531 547 548 547 548 533
536 580 554 539 539 539 552 553 552 553 541
544 520 562 523 520 520 560 561 545 561 549
568 569 570 518 513 513 513 513 513 513 557
576 577 578 518 513 513 555 556 516 513 555
522 520 520 514 513 513 563 564 518 513 563
522 513 513 513 513 513 571 572 518 513 571
532 513 513 534 535 513 527 520 514 513 540