RecordCorner_Layout (20x10)
513 513 513 656 657 663 663 663 660 661 661 662 663 663 663 658 659 513 513 513
513 513 513 664 665 671 671 671 668 669 669 670 671 671 671 666 667 513 513 513
513 513 513 672 673 679 679 679 676 677 677 678 679 679 679 674 675 513 513 513
513 513 513 680 681 708 708 692 708 708 708 708 694 708 708 682 683 513 513 513
513 513 513 680 681 708 684 700 696 697 698 699 702 686 708 682 683 513 513 513
513 513 513 680 681 708 708 693 704 705 706 707 695 708 708 682 683 513 513 513
513 513 513 680 681 708 685 701 712 713 714 715 703 687 708 682 683 513 513 513
513 513 513 680 681 708 708 710 710 710 710 710 710 708 708 682 683 513 513 513
513 513 513 688 689 708 708 708 708 708 708 708 708 708 708 690 691 513 513 513
513 513 513 513 513 513 513 513 546 546 546 546 513 513 513 513 513 513 513 513