Route101_Layout (20x20)
468 469 468 469 468 469 468 471 472 473 474 1 470 469 468 469 468 469 468 469
476 477 484 485 484 485 484 487 480 481 482 1 486 485 484 485 476 477 476 477
468 469 13 13 13 1 1 1 1 1 1 1 1 13 13 13 468 469 468 469
484 487 13 13 13 13 1 1 1 1 1 1 13 13 13 13 484 485 476 477
13 13 13 13 13 13 1 1 1 1 1 1 13 13 13 13 13 13 468 469
454 455 13 13 13 1 1 1 1 1 1 462 455 13 13 13 13 13 486 485
468 471 13 13 1 1 110 135 135 135 214 470 471 454 455 13 13 1 1 1
476 477 213 135 135 135 142 1 1 1 1 476 477 468 471 1 1 464 466 1
468 469 462 463 1 1 1 1 1 1 1 468 469 484 487 1 464 473 474 1
476 477 468 471 1 3 1 464 465 466 1 486 487 13 13 1 480 473 473 466
468 469 476 477 1 464 465 473 473 474 1 13 13 13 13 13 1 480 473 474
476 477 468 469 1 480 473 473 473 482 1 13 13 13 13 13 13 1 480 482
468 469 484 487 1 1 480 481 482 1 1 13 13 13 13 13 13 1 1 1
484 487 13 13 1 1 1 1 213 135 135 214 454 455 13 13 13 1 462 463
13 13 13 13 13 1 1 1 1 1 1 1 470 471 13 13 1 1 470 469
454 455 13 13 13 13 1 1 1 1 1 1 476 477 454 455 462 463 476 477
468 471 13 13 13 13 1 1 1 1 1 1 468 469 468 469 468 469 468 469
476 477 454 455 454 463 462 463 462 463 1 1 476 477 476 477 476 477 476 477
468 469 468 469 468 469 468 469 468 471 1 1 468 469 468 469 468 469 468 469
476 477 476 477 476 477 476 477 476 477 1 1 476 477 476 477 476 477 476 477