Route111_Layout (40x140)
113 113 147 148 113 113 113 113 113 113 113 113 147 148 113 113 113 113 123 124 124 124 124 124 137 113 113 113 113 113 113 113 113 113 113 113 113 113 113 113
113 113 155 156 113 113 113 147 148 113 113 113 155 156 116 124 124 137 113 113 113 113 113 113 123 124 124 124 124 137 113 113 113 116 124 416 137 113 113 113
113 113 113 113 113 113 113 155 156 113 113 113 113 116 125 147 148 123 124 124 124 124 124 124 169 169 137 147 148 123 124 124 124 125 113 113 115 113 113 113
113 113 113 113 113 113 113 113 113 113 116 124 124 125 113 155 156 113 113 113 113 113 113 113 113 113 115 155 156 113 113 113 113 113 113 107 190 147 148 113
124 124 124 137 113 113 113 113 116 124 125 113 113 113 113 113 116 121 121 121 121 121 121 121 121 137 115 113 113 113 113 113 113 113 113 115 113 155 156 113
113 113 113 123 124 124 124 124 125 113 113 116 121 121 121 121 122 331 332 332 333 331 332 332 333 112 123 137 113 113 113 113 113 113 113 123 137 113 113 113
121 121 121 121 137 113 113 113 113 113 116 122 1 3 1 1 1 275 276 276 277 275 276 276 277 120 137 123 616 232 617 124 137 113 113 113 115 113 113 113
1 1 1 1 120 121 121 121 121 121 122 1 1 1 1 1 1 1 1 1 1 1 1 1 1 1 120 121 624 232 625 137 115 113 113 113 115 113 113 113
281 281 281 281 281 281 281 281 281 281 281 281 281 282 1 1 1 1 1 1 1 1 1 1 1 1 1 1 1 1 1 112 115 113 113 113 115 113 113 113
297 297 297 297 297 297 297 297 297 297 297 289 289 289 281 281 281 281 282 1 1 1 1 1 1 1 1 1 1 1 1 112 115 113 113 113 115 113 147 148
1 1 1 1 1 1 1 1 1 1 1 296 297 297 297 297 289 289 290 1 1 1 1 1 1 14 1 1 1 1 1 112 115 113 113 113 115 113 155 156
105 105 105 105 105 106 1 1 1 1 1 1 1 1 1 1 296 297 289 282 1 1 1 1 14 198 1 1 1 1 1 112 115 113 113 113 115 113 113 113
108 108 108 109 113 191 105 106 14 14 14 1 1 1 1 1 1 1 296 298 255 1 1 1 198 198 14 1 1 1 1 112 115 113 113 113 115 113 113 113
113 147 148 117 147 148 113 114 198 198 198 14 14 14 213 135 135 135 135 135 142 1 1 1 198 198 198 1 1 1 1 112 115 113 113 113 123 137 113 113
113 155 156 117 155 156 113 114 198 198 198 198 198 198 14 1 1 1 280 282 1 1 1 1 198 198 198 1 1 1 1 112 123 137 113 113 113 115 113 113
113 113 113 117 113 147 148 114 198 198 198 198 198 198 198 14 1 1 296 298 1 1 1 14 198 8 9 9 10 1 1 120 137 115 113 113 113 115 113 113
113 113 116 125 113 155 156 114 198 198 198 198 198 198 198 198 213 135 135 135 214 1 1 198 198 16 17 17 18 464 465 466 112 115 113 113 113 123 137 113
124 124 125 113 116 121 121 122 198 198 198 198 198 23 23 198 1 280 282 1 1 1 1 198 198 24 25 11 26 472 473 474 112 115 113 113 113 113 115 113
113 116 121 121 122 14 14 14 198 198 198 198 198 30 31 198 1 296 298 1 1 1 14 198 198 32 33 19 34 480 481 482 112 115 113 113 113 113 115 113
121 122 14 14 14 198 198 198 198 198 198 23 23 38 39 23 1 1 213 135 135 214 198 198 198 3 1 1 1 1 1 1 112 115 113 113 113 113 115 113
14 14 198 198 198 198 198 198 198 198 23 1 280 281 281 282 280 282 1 1 1 1 23 23 23 1 1 1 1 1 1 1 112 115 113 113 113 113 115 113
198 198 198 198 198 198 198 198 198 23 1 280 289 289 289 298 296 289 282 1 1 1 1 14 14 14 518 518 518 518 1 104 190 115 113 113 113 107 190 113
198 198 198 198 198 198 198 198 23 1 1 288 289 289 298 1 1 296 298 1 1 1 14 198 198 23 518 518 518 518 1 112 107 190 113 113 113 115 113 113
198 198 198 198 198 198 198 23 213 135 214 288 289 290 213 135 135 135 214 14 14 14 198 198 23 104 105 105 105 105 105 190 115 113 113 113 113 115 113 113
198 198 198 198 198 198 23 280 281 281 281 289 289 290 1 1 1 1 14 198 23 23 23 23 104 190 113 113 113 107 108 108 190 113 113 113 113 115 113 113
198 198 198 198 23 23 1 288 289 289 297 297 297 298 1 1 1 1 23 23 104 105 105 105 190 107 108 108 108 190 113 113 113 113 113 113 113 115 113 113
198 198 23 23 213 135 214 288 289 290 213 135 214 104 105 105 105 105 105 105 190 107 108 108 108 190 147 108 108 148 113 113 113 113 113 113 113 115 113 113
23 23 1 1 1 1 1 288 289 290 1 1 1 112 113 113 107 108 108 108 108 190 113 113 147 148 155 424 124 156 113 113 113 113 113 107 108 190 113 113
1 1 1 280 281 281 281 289 289 290 1 1 224 112 107 108 190 113 113 113 113 113 113 113 155 156 113 113 113 113 113 113 113 113 107 190 113 113 113 113
1 1 1 288 289 289 289 289 289 290 1 104 105 190 115 147 148 113 113 113 113 113 113 113 113 113 113 113 113 113 113 113 113 113 115 113 113 113 113 113
1 1 1 296 297 297 297 289 289 290 1 112 113 107 190 155 156 113 113 113 113 113 113 113 113 113 113 113 147 148 113 113 113 113 115 113 113 113 113 113
14 14 1 1 1 280 282 288 289 290 1 112 113 115 113 113 113 113 113 113 113 113 147 148 113 113 113 113 155 156 113 147 148 113 123 424 137 113 113 113
198 198 14 14 1 296 298 288 289 290 1 112 113 115 113 113 113 113 113 113 113 113 155 156 116 124 124 124 124 137 113 155 156 113 113 113 123 124 137 113
198 198 198 198 14 14 1 288 289 290 224 112 113 115 113 113 113 113 113 116 124 124 124 124 125 113 147 148 113 123 124 124 124 124 124 124 137 113 115 113
198 198 198 198 198 198 1 296 289 290 1 112 113 123 137 113 113 113 113 117 113 147 148 113 113 113 155 156 116 145 145 145 145 424 137 113 115 113 115 113
23 23 23 23 23 23 1 1 288 290 1 120 121 137 115 113 113 113 113 117 113 155 156 113 113 113 113 116 146 289 289 289 289 289 136 113 115 113 115 113
105 105 105 105 105 105 106 1 296 298 1 280 282 112 123 124 616 232 617 125 113 113 116 121 424 121 121 146 289 289 289 289 289 289 136 113 123 137 115 113
113 113 113 113 113 113 114 224 1 280 282 296 298 120 145 145 624 232 625 145 121 121 146 592 593 594 289 289 289 289 289 289 584 586 144 137 113 115 115 113
108 108 108 108 109 113 191 105 106 296 298 1 1 280 281 281 281 281 281 584 594 289 289 592 593 594 289 289 584 586 289 289 600 602 289 136 113 115 115 113
113 113 113 113 117 113 113 113 114 1 1 280 281 289 289 289 289 289 584 593 594 289 289 592 593 602 289 289 600 593 586 289 289 289 128 190 113 115 115 113
108 108 108 109 191 109 113 113 114 224 1 288 289 289 289 289 289 289 592 593 593 585 585 593 594 289 289 226 289 600 602 289 289 128 190 113 113 115 115 113
113 113 113 117 113 117 113 113 114 1 1 288 289 289 289 226 584 585 593 593 593 593 593 593 593 585 586 289 289 289 289 128 129 190 113 147 148 115 115 113
113 113 113 191 109 191 109 113 114 280 281 289 289 289 289 584 593 226 587 588 593 593 593 593 593 593 593 586 289 289 289 136 113 113 113 155 156 115 115 113
113 113 113 113 191 109 191 109 138 289 289 289 289 289 289 592 593 593 144 146 593 593 593 593 593 226 593 594 289 289 289 136 113 147 148 113 113 115 115 113
113 107 108 109 113 117 113 117 138 289 289 289 289 289 584 593 593 593 593 593 593 593 593 593 593 593 226 593 585 586 289 136 113 155 156 113 113 115 115 113
107 191 113 191 109 117 113 117 138 289 289 163 164 289 600 601 601 601 601 601 593 593 593 593 593 593 593 593 593 593 585 144 137 113 113 113 113 115 123 124
115 113 113 113 117 117 113 117 191 129 130 171 172 289 289 289 289 289 289 289 600 601 601 601 601 601 601 593 593 587 588 585 136 113 113 113 113 115 113 113
115 113 113 113 117 117 113 117 113 113 138 585 585 586 289 289 289 289 289 289 289 289 289 289 289 289 289 592 593 144 146 593 144 137 113 113 113 115 113 113
115 113 113 113 117 117 113 191 109 113 138 593 593 593 585 585 585 585 586 289 289 289 289 289 289 289 289 592 593 593 593 593 593 136 113 113 113 115 113 113
115 113 113 113 117 117 113 113 117 113 138 593 593 593 593 593 593 593 593 585 585 585 586 289 289 289 289 592 593 593 593 593 593 136 113 113 113 123 137 113
123 137 113 113 117 191 108 109 191 109 138 593 593 593 593 593 593 593 593 593 593 593 593 585 586 289 289 600 601 601 601 593 593 144 424 137 113 113 115 113
113 115 113 113 191 109 113 117 113 117 138 593 587 588 593 593 593 593 593 593 593 593 593 593 594 289 289 289 289 289 289 592 593 593 593 136 113 113 115 113
113 115 113 113 113 117 113 191 109 117 138 593 144 146 226 593 593 593 593 593 593 593 593 593 594 289 289 289 289 289 289 592 593 593 593 136 113 113 115 113
113 123 137 113 113 117 113 113 117 117 138 226 593 593 593 593 593 593 593 593 593 593 593 593 594 289 289 289 289 289 289 592 593 593 593 136 113 113 115 113
137 113 115 113 116 125 113 113 117 117 138 593 593 593 593 593 593 593 593 593 593 593 593 593 593 585 586 289 289 289 584 593 593 593 593 144 137 113 123 137
115 113 123 124 125 113 113 113 117 117 138 226 593 593 593 593 593 593 593 226 593 593 593 593 593 593 593 586 289 289 592 593 593 593 587 588 136 147 148 115
115 113 113 113 113 113 113 116 125 117 138 593 593 593 593 593 593 593 593 593 593 593 593 593 593 601 601 602 289 289 592 593 593 593 144 146 136 155 156 115
115 113 113 113 113 116 124 125 113 117 138 593 593 593 593 593 593 593 601 601 601 601 601 601 602 289 289 289 289 289 592 593 593 593 593 593 136 113 113 115
123 137 113 113 116 125 113 113 113 117 138 593 593 593 593 601 601 602 289 289 289 289 289 289 289 289 289 289 289 289 592 593 593 601 601 601 144 137 113 115
113 123 124 124 125 113 113 116 124 125 138 593 593 593 602 289 289 289 289 289 289 289 289 289 289 289 289 289 289 289 592 593 594 289 289 289 592 136 113 115
113 113 113 113 113 116 124 125 116 145 146 601 601 602 289 289 289 289 289 289 289 289 289 289 289 289 289 289 289 289 592 593 594 289 289 289 592 136 113 115
124 124 124 124 124 125 113 113 138 289 289 289 289 289 289 128 129 129 130 289 289 289 584 585 585 586 289 289 289 289 600 601 602 289 289 289 592 136 113 115
206 206 206 206 206 145 121 121 146 289 289 289 289 289 289 136 113 113 138 289 289 289 592 593 593 594 289 289 289 289 289 289 289 289 289 289 592 136 113 115
198 198 198 198 198 1 1 296 297 297 297 297 289 289 289 136 113 113 138 289 289 289 592 593 593 594 289 289 289 289 289 289 289 289 289 584 593 136 113 115
198 198 198 23 23 1 1 1 280 282 1 1 296 297 297 136 113 113 138 289 289 289 592 593 593 593 585 585 585 585 585 586 289 289 584 593 593 136 113 115
23 23 23 1 280 282 1 1 296 289 282 1 1 1 1 112 113 113 191 129 130 289 592 593 593 593 593 593 593 593 593 593 585 585 593 593 593 136 113 115
1 1 1 1 296 298 1 3 1 296 298 1 1 280 282 112 113 113 113 113 138 584 593 593 593 593 593 593 593 593 593 593 593 593 593 226 593 144 137 115
1 1 1 1 1 1 1 1 1 1 1 1 1 296 298 112 113 113 113 113 138 592 593 593 593 593 593 593 593 593 593 593 593 593 593 593 593 593 136 115
1 1 1 1 1 1 1 1 280 281 281 281 282 1 1 120 137 113 113 113 138 592 593 593 593 593 593 593 593 593 593 593 593 593 593 587 588 593 136 115
281 281 281 281 281 281 281 281 289 289 289 289 290 1 280 282 112 113 113 113 138 592 593 593 593 593 593 593 593 593 593 593 593 593 593 144 146 593 136 115
297 297 297 297 297 297 297 297 297 289 289 289 290 1 296 298 112 113 113 113 138 600 593 593 593 593 226 593 593 593 593 601 601 593 593 593 593 593 136 115
1 1 1 1 1 1 1 1 1 296 297 289 290 1 1 1 112 113 113 113 191 130 592 593 593 593 593 593 593 593 594 289 289 600 593 593 593 593 136 115
105 105 105 105 105 105 105 106 1 1 1 288 290 1 1 224 112 113 113 113 113 138 600 593 593 593 593 593 593 593 594 289 289 289 592 593 593 593 136 115
113 113 113 113 113 113 113 138 224 1 1 288 290 1 1 1 112 107 108 109 113 138 289 600 601 593 593 593 593 593 593 586 289 289 592 593 593 593 136 115
113 113 113 113 113 113 113 138 1 1 1 288 290 1 1 104 190 115 113 117 113 138 289 289 289 592 593 593 593 593 593 594 289 289 592 593 593 226 136 115
108 108 109 113 113 113 113 138 538 1 1 288 290 1 224 112 107 190 113 117 113 138 289 289 289 592 593 593 593 593 593 593 585 585 593 593 593 593 136 115
113 113 191 108 109 113 113 138 473 466 1 288 290 1 104 190 115 113 113 117 113 138 289 584 585 593 593 593 593 593 593 593 593 593 593 593 593 593 136 115
113 113 113 113 117 113 113 138 542 546 1 288 290 1 112 107 190 113 113 117 113 138 289 592 593 593 593 593 601 601 593 593 593 593 593 593 593 594 136 115
113 113 113 113 117 113 113 138 198 546 1 288 290 104 190 115 113 113 113 117 113 138 289 592 593 593 593 594 289 289 592 593 593 593 593 593 593 602 136 115
113 113 113 113 117 113 113 138 198 546 1 288 290 112 107 190 113 113 113 117 113 138 289 592 593 593 593 594 289 289 592 593 593 593 593 593 594 289 136 115
113 113 116 124 125 113 116 557 550 546 1 288 290 112 115 113 113 113 113 117 116 146 584 593 593 593 593 594 289 584 593 593 593 593 593 593 594 289 136 115
113 113 117 113 113 113 138 542 473 474 1 288 290 112 115 113 113 113 113 117 138 584 593 593 593 593 593 593 585 593 593 593 593 593 593 593 594 289 136 115
113 113 117 113 113 113 138 550 473 482 1 288 290 112 115 113 113 113 113 117 138 592 593 593 593 587 588 593 593 593 593 593 587 588 593 593 594 128 190 115
113 113 117 113 113 116 122 481 482 1 1 288 290 112 115 113 113 113 113 117 138 592 593 593 593 144 146 601 601 601 601 601 144 146 593 593 594 136 113 115
113 113 117 113 113 138 1 27 1 1 1 288 290 112 123 124 137 113 113 117 138 592 593 593 593 593 602 289 128 129 164 289 600 593 593 593 594 136 107 190
113 116 125 113 113 138 1 1 1 1 1 288 290 120 556 137 115 113 113 117 191 588 593 593 593 594 289 128 115 113 117 164 289 592 593 593 594 136 115 113
113 117 113 113 116 557 537 538 131 132 1 288 290 1 1 112 123 137 113 191 148 138 593 587 588 594 289 136 123 100 125 138 289 592 587 588 594 136 115 113
113 117 113 113 138 542 542 546 139 140 1 288 290 1 1 120 137 115 113 113 117 138 593 144 146 594 289 144 121 167 121 146 289 592 144 146 594 136 115 113
113 117 113 116 557 550 198 546 1 1 1 296 298 1 1 1 112 115 113 113 117 138 600 593 593 602 289 289 289 289 289 289 289 600 593 593 602 136 115 113
116 125 113 138 542 542 198 546 224 1 1 1 1 1 1 14 112 123 137 113 117 138 289 600 602 289 289 289 289 289 289 289 289 289 600 602 289 136 115 113
117 113 113 138 198 198 550 546 1 1 1 1 14 14 14 198 112 113 115 113 117 191 130 289 289 163 164 289 289 289 289 289 163 164 289 128 129 190 115 113
117 113 116 557 550 198 545 546 1 1 1 1 22 198 198 198 112 113 115 113 191 148 191 129 130 171 172 289 289 289 289 289 171 172 289 136 113 113 115 113
117 113 138 539 541 550 545 545 537 538 1 1 1 22 22 22 120 137 123 137 113 191 108 148 138 289 289 289 584 585 586 289 289 289 289 136 113 113 115 113
117 113 138 555 557 545 545 545 545 546 1 1 1 1 1 1 224 120 137 115 113 113 113 117 191 129 130 289 600 601 602 289 289 289 289 136 113 113 115 113
117 113 191 540 541 545 545 542 542 545 537 538 1 1 1 1 1 1 112 123 124 137 113 191 108 148 138 289 289 289 289 289 584 585 585 136 113 113 115 113
191 109 113 113 191 540 541 550 550 545 545 545 538 1 1 1 1 280 136 225 113 115 225 113 113 117 191 129 130 289 289 289 592 593 587 190 113 113 115 113
113 117 113 225 113 113 191 540 540 540 540 541 546 1 1 1 1 288 144 137 113 123 137 113 113 191 108 148 138 289 289 584 593 587 190 113 113 107 190 113
113 191 108 108 109 113 113 113 113 113 113 191 540 106 224 1 1 288 289 144 137 225 123 137 147 148 113 117 191 130 584 593 593 136 113 113 113 115 113 113
113 113 113 113 191 108 108 108 108 108 109 113 225 549 281 282 1 296 297 226 144 121 137 115 155 156 113 117 113 138 592 593 593 136 113 147 148 115 113 113
113 113 113 113 113 113 225 113 147 148 191 108 109 191 129 130 282 1 1 288 163 164 136 123 137 113 113 191 148 138 592 593 593 136 113 155 156 115 113 113
113 113 113 113 113 113 113 113 155 156 113 113 117 147 148 549 163 132 1 288 171 172 144 137 123 137 113 113 117 138 592 593 593 136 113 113 113 115 113 113
108 108 108 108 109 147 148 113 113 113 225 116 125 155 156 549 171 140 1 288 289 289 289 144 137 115 113 113 117 138 600 593 593 144 137 113 107 190 113 113
113 113 113 113 117 155 156 113 116 124 124 125 113 225 116 146 290 1 1 296 297 226 289 289 136 115 113 113 117 138 289 600 593 593 136 113 115 113 113 113
113 113 116 124 125 113 116 124 125 113 113 116 121 121 146 289 298 131 132 1 1 296 289 226 136 123 137 113 117 191 129 130 600 593 136 113 115 113 113 113
113 116 125 113 113 116 125 116 124 124 124 146 289 289 297 298 1 139 140 1 1 1 296 289 136 113 115 113 191 148 113 138 289 600 136 113 115 113 113 113
113 117 113 116 124 125 116 125 195 177 177 196 297 298 1 1 1 1 1 1 1 1 1 288 144 137 115 113 113 117 113 138 289 128 190 113 115 113 113 113
113 117 116 125 116 124 125 195 192 161 161 194 177 178 14 14 1 1 1 1 1 1 1 296 297 136 115 113 113 117 113 191 129 190 113 113 115 113 113 113
113 117 117 113 117 195 177 192 161 161 161 161 161 186 198 198 14 1 1 1 1 1 1 1 14 112 115 113 113 191 148 113 113 113 113 113 115 113 113 113
116 125 117 116 125 184 161 161 161 161 186 211 2 2 22 22 22 1 1 1 1 1 1 14 198 112 123 137 113 113 191 108 148 113 113 113 115 113 113 113
117 113 117 117 195 192 161 161 161 186 211 638 679 679 679 639 1 1 14 14 14 1 1 198 22 112 113 115 113 113 113 113 191 148 113 107 190 113 113 113
117 116 125 117 184 161 161 161 161 186 312 646 687 687 687 647 329 314 198 198 22 1 1 22 1 120 137 115 113 113 113 113 113 191 108 190 113 113 113 113
117 117 113 117 184 161 161 161 161 186 320 654 695 695 695 655 1 322 198 198 1 1 1 1 131 132 112 123 137 113 113 113 113 113 113 113 113 113 113 113
117 117 116 122 184 161 161 161 161 186 320 662 678 641 678 663 1 322 198 22 1 1 1 1 139 140 112 113 115 113 113 113 113 113 113 107 108 108 108 108
117 117 802 1 184 161 161 161 161 186 320 670 668 649 668 671 1 322 22 1 1 1 1 14 14 1 120 137 115 113 113 113 107 108 108 190 113 113 113 113
117 117 802 1 184 161 161 161 161 186 328 329 329 1 329 329 3 330 1 1 1 1 14 198 198 14 14 112 115 113 113 107 190 113 113 113 113 113 113 113
117 117 191 611 184 161 161 161 161 186 14 14 464 465 466 1 1 1 1 1 1 1 22 198 198 198 198 112 123 137 113 115 113 113 113 113 113 113 113 113
117 191 109 802 212 184 161 161 161 186 22 198 480 481 482 1 1 1 1 14 14 1 1 22 198 198 198 120 137 115 113 115 113 113 113 113 113 113 113 113
191 109 117 191 611 184 161 161 161 194 178 22 1 1 1 1 1 1 1 198 198 1 1 1 22 22 22 1 112 115 113 123 137 113 113 113 113 113 113 113
113 117 117 113 802 212 184 161 161 161 194 177 177 178 14 14 1 1 1 22 22 1 1 1 1 1 131 132 112 123 124 137 123 124 137 113 113 113 113 113
113 117 117 113 802 1 212 184 161 161 161 161 161 186 198 198 14 1 1 1 1 1 1 1 1 1 139 140 120 145 137 115 113 113 115 113 113 113 113 113
113 117 117 113 191 610 611 2 2 2 2 2 2 2 198 198 198 14 14 1 1 1 1 1 1 14 14 1 131 132 112 123 137 113 115 113 113 113 113 113
113 117 191 109 113 113 191 610 610 610 610 610 610 611 22 22 198 198 22 1 1 1 1 1 1 198 198 14 139 140 112 113 115 113 123 124 137 113 113 113
113 191 109 191 108 108 108 108 108 108 109 113 113 191 105 106 198 198 116 121 121 175 207 207 137 198 198 198 14 14 112 113 115 113 113 113 123 137 113 113
113 113 191 109 113 113 113 113 113 113 117 113 113 113 113 802 22 22 114 14 1 1 1 1 112 22 22 22 198 198 112 113 123 124 137 113 113 123 137 113
113 113 113 117 113 113 113 113 113 113 117 113 113 113 113 114 1 116 122 22 4 1 1 1 120 124 137 4 22 22 112 113 113 113 123 124 137 113 115 113
124 124 124 125 113 113 113 116 124 124 125 113 113 113 113 114 1 114 14 1 116 175 207 207 121 137 123 124 137 1 120 137 113 113 113 113 115 113 115 113
113 113 113 113 116 124 124 125 113 113 113 113 113 113 113 114 116 122 22 116 122 1 1 1 3 120 145 137 123 124 137 123 137 113 113 113 115 113 123 137
113 116 124 124 125 113 113 113 113 113 113 113 116 543 543 122 117 116 121 122 14 256 257 258 1 1 14 120 145 137 120 137 120 137 113 113 115 113 113 123
124 125 113 113 113 116 543 121 543 543 543 543 122 198 23 116 125 114 14 14 22 264 265 266 1 1 198 14 14 112 4 112 14 112 113 113 123 137 113 113
113 113 113 113 116 122 22 1 22 198 22 23 1 23 1 117 116 122 198 23 4 264 265 266 1 4 23 198 23 112 1 112 22 112 113 113 113 123 137 113
543 543 121 543 122 1 4 1 1 23 116 543 543 124 124 125 114 4 23 1 1 264 265 266 1 1 1 23 1 112 14 120 137 112 113 113 113 113 123 124
198 198 1 22 1 1 1 116 121 121 122 198 198 116 145 145 122 1 1 1 1 264 265 266 1 1 1 1 1 112 22 14 112 120 543 137 113 113 113 113
23 23 1 1 116 121 121 122 14 14 4 23 23 114 1 1 1 1 1 1 1 264 265 266 1 14 14 1 4 112 1 22 112 1 23 120 137 113 113 113
121 121 121 121 122 14 1 1 22 22 116 121 121 122 1 256 257 257 257 257 257 265 265 266 1 198 198 1 1 120 137 1 120 543 137 1 120 124 124 124
1 14 1 1 1 22 1 116 121 121 122 14 1 1 1 264 265 265 265 265 265 265 265 266 1 23 23 1 14 14 120 121 137 23 120 121 137 113 113 113
1 22 14 1 1 116 121 122 1 1 14 198 1 1 1 264 265 265 273 273 273 273 273 274 1 1 1 1 198 23 1 1 112 1 1 4 120 124 124 124
1 1 22 116 121 122 697 1 1 4 22 23 1 1 1 264 265 266 1 1 1 1 1 1 1 1 1 4 23 1 1 1 120 121 121 121 145 145 145 145
121 121 121 122 1 4 689 657 657 657 657 657 642 1 1 264 265 266 1 1 640 657 657 657 657 657 657 657 657 657 657 657 657 657 1 14 14 14 14 14
1 1 1 1 1 1 1 1 1 1 4 1 650 1 1 264 265 266 1 1 648 1 4 1 14 14 14 14 14 14 14 14 14 14 14 198 198 198 22 198
1 1 1 1 1 1 1 4 1 1 1 4 650 1 1 264 265 266 1 1 648 1 1 14 198 198 198 198 198 198 198 198 198 198 198 198 198 22 1 22