Route123_Layout (140x20)
198 198 198 199 198 199 198 198 199 22 199 199 22 22 22 22 22 22 22 22 22 199 199 199 199 199 22 199 199 199 199 199 199 199 199 199 199 199 198 198 199 198 198 198 22 22 22 22 22 22 22 22 22 22 22 22 22 22 22 22 199 199 199 198 198 198 198 22 22 22 22 198 199 198 22 22 22 22 22 22 22 22 22 22 22 199 199 199 198 199 198 199 198 199 199 400 368 368 368 368 368 368 368 368 368 368 368 368 368 368 368 368 368 368 368 368 368 402 69 1 1 71 400 368 368 368 368 368 368 368 368 368 368 368 368 368 368 368 368 368
198 198 198 198 199 198 199 199 198 320 22 22 1 1 1 1 1 1 1 1 1 199 199 199 199 199 320 199 199 199 199 199 199 199 199 199 198 198 199 199 199 22 22 22 1 1 104 105 105 105 105 105 105 105 105 105 105 105 105 106 199 199 199 199 198 22 22 13 13 13 13 22 199 198 13 1 13 13 254 224 331 332 332 332 333 199 199 198 199 198 199 198 199 199 198 400 368 403 403 368 368 368 368 368 368 368 368 368 368 368 368 368 368 368 368 368 368 402 69 1 1 71 400 368 368 368 368 368 368 368 368 368 368 368 368 368 368 368 368 368
198 198 198 199 198 199 198 198 199 320 321 329 329 329 329 329 329 329 329 313 1 22 22 22 22 22 320 199 199 199 199 199 199 199 199 199 199 199 22 22 22 1 1 1 1 1 112 113 113 113 113 113 113 113 113 113 113 113 113 114 199 199 199 198 22 1 13 13 13 13 13 13 199 198 13 13 13 13 133 1 275 276 276 276 277 199 199 199 198 199 198 199 198 198 198 29 29 199 199 403 368 368 368 368 368 368 368 368 368 368 368 368 368 368 368 368 368 402 69 1 1 71 400 368 368 368 368 368 368 368 368 368 368 368 368 368 368 368 368 368
198 198 198 198 199 198 199 199 198 320 322 627 629 1 627 629 1 627 629 320 1 8 9 9 10 1 320 199 199 199 199 199 199 199 22 22 22 22 1 1 1 1 1 1 224 1 120 416 121 416 121 121 121 137 113 113 113 113 113 114 199 199 199 22 1 1 13 13 13 13 13 13 22 198 13 13 13 13 133 1 1 1 1 1 1 22 199 198 199 198 199 198 198 198 198 199 198 198 199 199 403 368 368 368 368 368 368 368 368 368 368 368 368 368 368 368 368 402 69 1 1 71 400 368 368 368 368 368 368 368 368 368 368 368 368 368 368 368 368 368
198 198 198 199 198 199 198 198 199 320 322 635 637 1 635 637 1 635 637 320 1 16 17 17 18 1 320 199 199 199 199 199 199 199 176 177 177 177 177 177 177 178 1 1 1 1 1 1 254 1 1 13 13 120 137 113 113 113 113 114 199 199 199 1 1 1 13 13 13 13 13 13 13 22 13 13 13 13 133 1 1 1 1 1 1 1 22 22 22 22 22 22 22 198 199 199 199 199 199 199 199 403 368 368 368 368 368 368 368 368 368 368 368 368 368 368 368 402 69 1 1 71 400 368 368 368 368 368 368 368 368 368 368 368 368 368 368 368 368 368
198 198 198 198 198 198 199 198 22 320 322 627 629 1 627 629 1 627 629 320 1 24 25 11 26 1 320 199 199 199 199 199 22 22 184 161 161 161 161 161 161 186 1 1 1 1 1 1 133 1 13 13 13 13 120 121 121 416 631 639 198 198 199 213 135 135 135 135 135 214 15 13 13 1 1 1 13 13 133 1 1 1 1 13 13 1 1 14 14 14 14 14 1 198 198 199 198 198 199 199 199 199 403 403 368 368 368 368 368 368 368 368 368 368 368 368 368 402 69 1 1 71 400 368 368 368 368 368 368 368 368 368 368 368 368 368 368 368 368 368
198 198 198 199 198 199 22 22 1 320 322 635 637 1 635 637 1 635 637 320 1 32 33 19 34 1 320 199 22 22 22 22 1 1 184 161 161 161 161 161 161 186 1 1 1 1 1 1 133 13 13 13 13 13 213 111 1 1 22 198 198 198 22 1 1 1 1 1 1 15 198 13 1 1 1 1 1 1 133 1 1 1 13 13 13 13 13 22 199 199 199 199 1 199 199 199 199 199 199 199 199 198 198 198 403 403 368 368 368 368 368 368 368 368 368 368 368 402 69 1 1 71 400 368 368 368 368 368 368 368 368 368 368 368 368 368 368 403 403 403
199 198 198 198 22 22 1 1 1 320 307 329 329 1 1 1 1 329 329 306 3 1 1 1 1 1 320 22 1 254 224 1 1 1 184 161 161 161 161 161 161 186 1 1 1 1 1 1 133 13 13 13 13 13 13 133 1 1 1 199 199 22 1 1 1 1 1 1 1 198 198 15 1 1 1 1 1 1 262 15 15 13 13 13 13 13 13 13 199 198 199 199 1 199 199 199 199 199 199 199 199 198 198 198 198 198 403 368 368 368 368 368 368 368 368 368 368 402 69 1 1 71 400 368 368 368 368 368 368 368 368 368 368 368 368 403 403 199 199 199
199 23 23 23 1 1 1 1 1 320 14 14 1 1 1 1 1 1 1 1 1 1 1 1 1 1 320 1 1 133 1 1 1 1 184 161 161 161 161 161 161 186 1 1 1 1 1 1 262 37 37 13 13 13 13 133 1 1 1 199 22 1 1 1 1 1 1 1 1 22 198 198 15 224 1 1 1 1 15 198 198 37 13 13 13 13 13 13 22 199 199 199 1 199 199 199 199 199 199 199 199 199 199 199 199 198 198 403 403 368 368 368 368 368 368 368 368 402 69 1 1 71 400 368 368 368 368 368 368 368 368 368 403 403 403 199 198 199 199 199
23 1 1 1 1 1 1 1 1 320 199 22 1 1 1 1 1 1 1 1 1 464 466 1 1 1 320 1 1 133 1 1 1 1 2 2 2 2 2 2 2 2 1 1 1 224 1 15 15 198 198 37 13 13 13 133 1 15 1 22 213 135 135 135 135 214 15 13 13 13 198 198 198 15 1 1 1 1 198 198 198 198 37 13 13 13 13 13 13 199 199 199 1 22 22 22 22 22 22 22 22 22 199 199 199 198 198 198 198 403 403 403 403 403 368 368 368 402 69 1 1 71 400 368 368 403 403 403 403 403 403 403 198 199 198 199 198 199 198 199
1 1 1 1 1 1 1 1 1 320 22 1 1 1 1 1 1 1 1 1 1 472 474 1 1 1 320 1 1 133 1 1 14 14 14 1 1 1 1 1 1 1 1 1 1 1 15 198 198 198 198 198 13 13 1 133 15 198 1 1 1 1 1 1 1 1 198 37 13 13 22 22 198 198 1 1 1 1 22 198 198 198 198 37 13 13 13 13 13 22 199 199 1 14 14 14 14 14 14 14 14 1 199 199 199 199 199 198 198 199 198 199 199 199 62 62 62 3 1 1 1 1 62 62 62 199 198 199 198 199 198 199 198 198 198 198 198 198 198 199
1 1 1 1 1 1 1 1 1 328 329 329 329 329 329 329 329 329 329 329 1 472 474 1 329 329 306 1 1 141 135 135 199 199 199 14 213 135 135 135 135 135 111 14 14 14 198 198 198 198 198 198 1 1 1 262 198 198 1 1 1 1 1 1 1 15 198 198 13 13 13 13 22 22 213 135 135 135 214 198 198 198 198 22 1 1 1 13 13 13 22 22 1 22 22 22 22 22 199 199 199 1 199 199 199 198 199 198 199 198 199 198 199 22 1 224 1 1 1 280 282 1 1 224 1 22 199 198 199 198 22 22 22 22 22 22 22 22 22 198
15 15 15 15 1 1 1 1 1 1 3 1 1 4 1 1 4 1 1 4 1 472 474 1 4 1 1 1 1 1 1 1 22 199 199 199 1 1 1 1 1 1 133 199 199 199 199 198 198 198 198 22 1 1 1 15 198 22 1 1 1 1 1 1 15 198 198 198 37 13 13 13 13 1 1 1 1 1 1 22 22 22 22 1 1 1 1 1 1 1 1 1 1 1 1 13 13 13 199 199 199 1 199 199 199 199 199 198 22 22 22 22 22 1 1 1 1 1 280 289 290 1 1 1 1 1 198 198 198 198 1 14 14 14 14 14 14 14 14 199
199 199 199 199 15 15 1 1 1 1 1 1 1 1 1 1 1 1 1 1 1 472 474 1 1 1 1 1 1 1 1 1 1 22 22 22 4 1 1 4 1 1 133 22 198 198 198 199 199 199 22 1 1 1 1 22 22 213 135 135 135 135 135 214 198 198 198 198 198 37 37 13 13 1 1 1 1 1 1 1 1 254 1 1 224 1 1 1 1 1 1 1 1 13 13 13 13 13 22 22 22 1 22 198 198 198 198 22 331 332 332 332 333 1 1 280 281 281 289 289 298 1 1 1 1 1 22 22 22 22 1 198 198 198 198 198 198 198 199 198
198 198 199 199 198 198 15 1 464 465 465 465 465 465 465 465 465 465 465 465 465 473 473 465 465 465 465 465 465 465 465 465 465 465 465 465 465 465 465 466 1 1 133 1 22 22 198 198 198 198 213 135 135 135 135 135 111 1 1 1 1 1 1 1 22 22 198 198 198 198 22 13 1 1 1 1 280 281 281 282 1 133 280 281 281 281 282 1 1 1 1 1 1 13 13 13 13 13 13 13 1 1 1 22 22 22 22 1 275 276 276 276 277 280 281 289 289 289 289 298 1 1 1 1 14 14 14 14 14 1 14 198 198 198 198 198 198 199 198 199
199 199 198 198 199 198 198 15 480 481 481 481 481 481 481 481 481 481 481 481 481 481 481 481 481 481 481 481 481 481 481 481 481 481 481 481 481 481 481 482 1 1 133 1 1 1 22 22 22 22 1 1 1 1 1 1 133 1 280 281 281 281 281 281 282 1 22 22 22 22 1 254 1 280 281 281 289 289 297 298 1 133 296 297 297 289 289 281 281 281 282 224 1 13 13 13 13 13 13 13 1 1 280 281 281 281 281 281 281 281 281 281 281 289 289 289 297 297 298 1 1 224 14 14 198 198 198 198 198 1 198 198 198 198 198 198 198 198 199 198
199 199 198 199 199 198 199 199 15 15 1 1 1 1 1 1 1 1 1 1 1 1 1 1 1 1 1 1 1 1 1 1 1 14 14 14 14 1 1 1 1 1 133 1 1 280 281 281 281 281 281 281 282 1 1 1 133 1 296 297 297 297 297 289 289 281 281 281 281 282 1 133 1 296 297 297 297 298 1 1 1 133 1 1 1 296 297 297 297 297 298 14 37 37 37 13 13 13 13 13 1 1 296 297 297 297 297 297 297 297 297 297 297 297 297 298 1 1 1 1 14 14 199 199 199 198 198 198 198 1 198 198 198 198 198 198 198 198 199 198
199 198 199 198 199 198 199 199 199 199 64 329 1 329 329 329 329 329 329 329 329 329 329 329 64 64 329 329 329 329 329 1 64 198 198 198 198 14 14 14 1 1 133 15 1 296 297 297 297 297 297 297 298 1 1 1 262 15 15 1 1 1 1 296 297 297 297 297 297 298 1 133 1 1 1 1 1 1 1 224 1 262 14 14 1 1 1 14 14 14 14 198 198 198 198 37 37 37 37 13 1 1 1 1 1 1 1 1 224 1 1 1 1 1 14 14 14 14 14 14 199 198 199 198 198 198 198 198 198 1 22 22 22 22 22 22 22 22 22 22
199 199 198 199 198 199 198 198 199 198 199 14 14 14 14 14 14 14 14 14 14 14 14 14 199 199 14 1 15 15 14 14 198 199 198 198 198 198 198 198 14 14 262 199 15 15 1 1 1 1 224 1 15 15 15 15 15 198 198 15 15 15 15 1 1 1 1 224 1 1 1 262 15 15 15 1 1 1 15 15 15 14 198 198 14 14 14 198 198 199 198 198 198 199 198 198 198 198 198 14 14 224 1 1 1 1 1 1 1 14 14 14 14 14 198 198 198 198 198 199 198 199 198 198 198 198 198 198 198 14 14 14 14 14 14 14 14 14 14 1
199 198 199 198 199 198 199 199 198 199 198 199 198 198 199 198 199 198 198 198 198 198 198 198 198 198 198 15 198 198 198 199 198 199 198 199 199 198 199 199 199 199 14 199 199 199 15 15 15 15 15 15 199 198 198 198 198 198 198 198 198 198 198 15 15 15 15 15 15 15 15 15 199 199 199 15 15 15 199 199 199 198 198 198 199 198 199 198 199 198 199 198 199 198 199 198 198 198 199 198 199 14 14 14 14 14 14 14 14 198 198 199 198 199 199 198 199 198 199 198 199 198 199 198 199 198 198 198 198 198 198 198 198 198 198 198 198 198 198 14