Route121_SafariZoneEntrance_Layout (18x14)
648 648 648 648 648 648 648 648 648 653 648 648 605 648 648 651 648 648
656 656 656 656 656 656 668 656 656 661 656 668 4 656 656 659 656 656
632 624 624 624 624 624 680 724 664 665 665 681 613 632 624 624 624 624
640 616 616 616 616 616 688 673 672 673 673 689 640 616 712 616 616 698
604 616 616 616 616 616 625 601 602 601 602 624 633 616 616 616 616 698
612 616 534 535 616 616 616 609 610 609 610 616 616 616 616 616 616 616
1 1 1 1 1 1 1 1 1 1 1 1 640 616 616 616 707 707
1 1 1 1 1 1 1 1 1 1 1 1 604 616 616 616 720 721
1 1 1 1 1 1 1 1 1 1 1 1 612 616 616 616 720 632
1 1 1 1 1 1 1 1 1 1 1 1 640 616 616 616 720 640
1 1 1 1 1 1 1 1 1 1 1 1 640 616 616 616 720 722
1 1 1 1 1 1 1 1 1 1 1 1 640 616 616 616 721 721
1 1 1 1 1 1 1 1 1 1 1 1 604 616 616 616 625 723
1 1 1 1 1 1 1 1 1 1 1 1 612 616 534 535 616 628