Route112_Layout (40x60)
198 198 198 198 198 198 198 198 198 198 198 198 198 198 198 198 198 198 198 198 198 198 198 198 198 198 198 198 198 198 198 198 198 198 198 198 198 198 198 198
198 198 198 198 198 198 198 198 198 198 198 198 198 198 198 198 198 198 198 198 198 198 198 198 198 198 198 198 198 198 198 198 198 198 198 198 198 198 198 198
198 198 198 198 198 198 198 198 198 198 198 198 198 198 198 198 198 198 198 198 198 198 198 198 198 198 198 198 198 198 198 198 198 198 198 198 198 198 198 198
198 198 198 198 198 198 198 198 198 198 198 198 198 198 198 198 198 198 198 198 198 198 198 198 198 198 198 198 198 198 198 198 198 198 198 198 198 198 198 198
198 198 198 198 198 198 198 198 198 23 23 23 23 23 23 198 198 198 198 198 198 198 198 198 198 198 198 198 198 198 198 198 198 198 198 198 198 198 198 198
790 790 790 790 790 790 790 790 790 620 620 620 620 621 1 23 198 198 198 198 198 23 23 23 198 198 23 23 23 23 23 23 198 198 198 22 22 198 198 198
617 617 617 617 618 625 625 625 625 625 625 625 625 639 620 620 790 790 790 790 790 620 620 621 23 198 331 332 332 332 332 333 22 22 22 13 13 22 22 198
617 617 617 618 639 617 617 617 617 618 625 625 625 625 625 625 625 625 625 625 625 625 625 626 621 23 275 276 276 276 276 277 224 13 13 13 13 13 224 22
617 617 618 639 618 625 625 625 625 639 617 617 618 625 625 625 625 625 625 625 625 625 625 626 796 619 621 1 1 1 1 1 13 13 13 13 13 1 1 1
617 618 639 618 626 618 616 617 617 617 618 625 626 617 617 617 617 618 625 625 635 628 598 634 796 627 629 1 1 1 1 1 1 13 13 1 1 1 1 1
618 639 618 626 626 626 639 618 625 528 639 618 639 617 617 617 618 626 625 635 634 635 606 628 629 1 1 1 13 13 13 1 1 1 1 14 14 1 1 1
639 618 626 626 626 639 618 626 618 536 528 626 617 618 625 625 626 626 625 626 635 629 1 1 1 1 1 13 13 13 13 13 13 14 14 198 198 14 14 14
625 626 626 626 639 618 626 626 626 618 536 639 618 626 625 625 626 626 625 626 626 1 1 1 1 1 13 13 13 13 13 224 37 198 198 198 198 198 198 198
595 626 626 626 625 626 626 626 626 639 618 625 626 626 617 618 639 639 618 639 639 620 621 1 1 1 619 621 37 37 37 37 198 198 198 198 198 198 198 198
603 592 593 626 625 626 626 626 639 618 639 618 626 626 625 626 625 625 626 618 625 625 626 620 620 621 627 629 198 198 198 198 198 198 198 198 198 198 198 198
635 634 601 592 596 593 626 626 625 626 528 626 626 639 618 626 617 618 639 639 617 618 639 617 618 639 620 621 23 198 198 198 198 198 198 198 198 23 23 23
634 635 634 626 604 601 592 593 625 626 536 626 639 618 626 626 625 626 618 528 625 626 617 618 626 625 625 639 621 23 23 23 198 198 198 198 198 104 105 105
628 634 635 634 612 626 626 601 594 593 625 626 625 626 626 626 528 626 626 536 528 626 528 626 639 617 618 528 626 620 620 621 23 198 198 198 198 112 113 113
625 635 634 625 625 626 626 626 625 601 594 593 625 626 626 626 536 626 626 625 536 626 538 639 618 625 626 536 639 617 618 639 621 23 23 23 198 112 107 108
628 634 625 625 635 634 626 626 625 626 625 601 597 592 593 626 635 634 626 625 635 634 538 625 626 528 639 617 618 625 639 618 639 620 620 621 23 112 115 113
628 628 628 628 634 635 634 626 635 634 625 626 605 626 601 592 593 635 634 635 634 528 536 625 626 538 528 528 639 617 618 639 617 617 618 639 621 112 115 107
625 625 635 628 628 634 635 634 626 625 635 634 613 626 626 626 601 592 595 626 625 536 625 635 634 538 538 538 528 528 639 617 617 618 626 625 796 112 115 115
529 628 634 635 628 628 634 635 634 635 634 625 635 634 626 626 626 626 603 592 595 635 628 634 528 538 536 536 538 538 625 625 528 626 639 618 796 112 115 115
536 635 628 634 625 635 529 634 625 626 625 635 634 635 634 626 626 626 625 626 603 592 595 625 536 536 625 544 545 545 547 548 536 626 625 626 796 112 115 115
628 634 635 529 628 634 536 625 635 634 625 626 625 626 635 634 626 626 528 626 625 626 603 594 596 602 602 552 553 553 555 556 548 639 618 626 796 112 115 115
628 628 634 536 625 625 635 628 634 528 635 634 635 634 626 635 634 626 538 626 625 626 625 625 604 625 625 560 561 561 563 564 573 528 626 626 796 112 115 115
635 529 529 529 628 628 634 625 625 536 626 528 626 635 634 626 625 626 536 626 635 634 528 625 612 625 528 568 569 570 571 572 573 538 626 626 796 112 115 115
634 536 536 536 635 529 628 628 628 628 634 536 626 626 635 634 635 634 625 626 626 528 536 528 528 528 536 576 577 578 579 580 581 536 626 626 796 112 115 115
529 628 628 628 634 536 635 529 529 628 628 628 634 626 626 625 626 625 635 634 626 538 528 538 538 536 625 625 625 625 625 528 528 635 634 626 796 112 115 115
536 635 628 628 628 628 634 536 536 635 628 529 529 634 626 635 634 625 626 528 626 538 538 538 536 625 625 625 625 625 528 538 538 626 625 626 796 112 115 115
628 634 635 628 628 628 628 628 628 634 625 536 536 635 634 626 528 528 626 538 626 538 538 536 662 662 625 625 662 662 538 536 536 626 635 634 796 112 115 115
628 628 634 635 529 529 628 628 628 529 529 628 628 634 635 634 538 538 626 536 626 538 538 625 625 625 625 625 625 528 538 635 529 634 626 528 796 112 115 115
529 529 529 634 536 536 625 625 625 536 536 635 628 628 634 625 536 536 626 635 634 538 536 625 625 625 625 625 528 536 536 626 538 635 634 536 796 112 115 115
536 536 536 635 529 529 529 529 628 628 628 634 625 625 635 628 628 628 634 626 625 536 625 625 625 625 625 625 538 635 628 634 536 626 625 635 629 112 115 115
529 529 529 523 536 536 536 536 625 625 625 625 625 635 634 625 635 628 628 634 625 625 625 625 625 625 625 528 538 626 635 628 628 634 635 629 104 190 115 123
515 515 515 515 529 529 628 529 628 628 628 598 628 634 635 628 634 625 625 625 625 625 625 625 625 625 625 538 538 626 626 635 529 529 629 1 112 113 115 113
536 536 536 536 536 536 625 536 635 628 628 606 628 628 634 625 625 625 625 625 625 625 625 625 625 625 625 538 538 626 626 796 198 198 15 104 190 113 115 113
529 529 529 529 529 529 529 529 523 625 625 625 625 625 625 625 625 625 625 625 625 625 3 625 625 625 528 538 536 626 626 796 198 198 198 112 107 108 190 113
515 515 515 515 515 515 198 198 515 528 528 625 625 625 625 625 625 625 625 625 625 625 625 625 625 625 536 536 635 634 626 796 198 198 198 112 115 113 113 113
515 515 515 515 515 515 515 515 515 515 536 625 625 625 625 625 625 625 625 625 625 625 625 625 625 625 635 628 634 625 626 796 198 198 198 112 123 137 113 113
198 515 515 515 515 515 515 515 515 515 529 529 636 625 625 625 625 625 625 625 625 625 625 635 628 628 634 635 628 628 634 796 198 198 198 120 137 115 113 113
198 515 515 515 515 515 515 515 515 515 198 198 627 628 628 628 628 628 628 628 175 207 628 634 635 628 628 634 635 529 529 629 198 198 198 15 112 123 124 124
198 198 515 515 515 515 515 515 515 515 198 198 760 751 633 633 633 628 628 628 175 207 628 628 634 635 633 633 629 23 23 14 198 198 198 198 120 206 206 206
198 198 198 198 198 198 198 198 198 198 198 198 750 750 1 760 756 751 633 633 175 207 633 633 633 629 13 13 13 13 13 23 23 23 198 198 15 198 198 198
198 515 515 198 198 198 198 198 198 198 22 22 750 750 1 750 1 750 1 3 280 282 1 1 1 13 13 13 13 13 13 13 13 13 23 23 198 198 198 198
198 198 198 198 198 198 513 513 198 198 760 756 758 750 1 750 1 750 1 1 288 290 1 1 1 13 13 13 13 13 13 13 13 13 1 1 23 23 23 23
22 198 198 198 198 198 521 521 198 198 750 1 1 750 1 750 1 750 1 1 288 290 1 619 620 620 620 620 620 620 621 13 13 13 1 1 1 1 1 1
1 22 198 198 198 22 514 514 198 198 750 1 1 750 1 750 1 750 1 1 288 290 1 627 633 636 625 625 625 625 639 621 1 1 1 1 1 1 1 1
1 1 22 22 22 1 1 1 22 198 750 1 1 750 1 750 1 750 1 1 288 290 1 1 1 627 633 633 633 633 636 796 1 1 1 1 1 1 1 1
281 281 282 1 3 1 1 1 1 22 750 1 1 750 1 750 1 750 1 1 288 290 1 1 1 1 1 1 1 1 627 629 1 1 1 280 281 281 281 281
297 289 289 281 281 281 282 1 1 1 750 1 1 750 1 750 1 750 1 1 288 289 281 281 281 281 281 281 281 281 281 281 281 281 281 289 289 289 297 297
1 296 297 297 297 297 298 1 1 1 750 1 1 750 1 750 1 750 1 1 296 297 297 297 297 297 297 297 297 297 297 297 297 297 297 297 297 298 1 1
1 1 1 1 1 1 1 1 1 1 763 14 14 763 14 763 15 750 1 1 1 1 1 1 1 1 1 1 1 1 1 1 1 1 1 1 1 1 104 105
14 1 1 1 1 1 1 1 1 14 198 198 198 198 198 198 198 763 329 329 329 329 329 329 64 64 64 64 64 64 329 329 329 329 329 104 105 105 190 113
198 14 14 14 14 14 14 14 14 198 198 198 198 198 198 198 198 198 15 15 15 15 15 15 198 198 198 198 198 198 14 14 14 14 14 112 113 113 113 113
198 198 198 198 198 198 198 198 198 198 198 198 198 198 198 198 198 198 198 198 198 198 198 198 198 198 198 198 198 198 198 198 198 198 23 112 113 113 107 108
198 198 22 198 198 198 198 22 198 198 198 198 198 198 198 198 198 198 198 198 198 198 198 198 198 198 198 198 23 23 23 23 23 23 104 190 113 107 190 113
22 22 619 790 790 790 790 621 22 198 198 198 198 22 22 198 198 198 198 198 198 198 198 198 23 23 23 23 104 105 105 105 105 105 190 107 108 190 113 113
619 620 638 625 625 625 625 639 620 790 790 790 790 620 621 22 23 198 198 198 198 198 198 23 104 105 105 105 190 113 113 107 108 108 108 190 113 113 113 113
638 625 625 625 625 625 625 625 625 625 625 625 625 625 639 620 621 198 198 198 198 198 198 104 190 113 113 113 113 107 108 190 113 113 113 113 113 113 113 113