Route110_TrickHouseEnd_Layout (12x8)
533 749 750 751 739 535 533 535 740 530 531 532
541 757 758 759 747 543 541 543 748 538 523 540
545 765 766 767 755 545 545 545 756 545 545 545
545 553 553 553 553 553 580 553 553 553 553 553
545 553 553 553 553 590 591 553 553 553 553 553
545 553 553 553 580 598 599 580 553 553 553 553
545 553 553 553 553 553 553 553 553 553 553 553
545 553 553 553 553 553 553 553 553 553 553 553