Route121_Layout (80x20)
198 198 198 198 117 114 468 469 468 469 468 469 468 469 468 469 468 469 468 469 468 469 468 469 468 469 600 468 469 468 469 468 469 468 469 816 817 817 817 818 468 469 1 602 117 114 468 469 468 469 468 469 468 469 468 469 468 469 468 469 468 469 468 469 468 469 468 469 468 469 468 469 468 469 468 469 468 469 468 469
198 198 198 198 117 114 476 477 476 477 476 477 476 477 484 485 484 485 476 477 476 477 476 477 476 477 600 486 485 484 485 484 485 484 487 816 817 817 817 818 486 487 1 602 117 114 486 485 486 485 486 485 484 485 476 477 476 477 486 485 486 485 486 485 486 485 486 485 476 477 476 477 476 477 476 477 476 477 476 477
198 198 23 23 117 114 468 469 468 469 468 469 468 469 627 332 332 629 468 469 468 469 468 469 468 469 600 1 4 1 4 1 4 1 4 816 817 817 817 818 1 4 1 602 117 114 1 1 4 1 4 1 4 1 468 469 468 469 4 1 1 1 4 1 4 1 4 1 468 469 468 469 468 469 468 469 468 469 468 469
23 23 1 1 117 114 476 477 476 477 476 477 476 477 635 276 276 637 486 485 484 485 484 485 484 487 600 4 1 4 1 4 1 4 1 824 825 825 825 826 4 1 1 602 117 114 1 4 1 4 1 4 1 1 486 485 484 487 1 4 1 1 1 4 1 4 1 4 486 485 484 485 484 485 484 485 484 485 484 485
124 124 124 124 125 114 468 469 468 469 468 469 468 469 13 13 13 592 593 593 593 593 593 593 593 593 593 593 593 593 593 593 593 593 593 819 804 805 806 821 593 593 593 594 117 114 592 593 593 593 593 593 593 593 593 593 593 593 593 593 593 593 593 593 594 1 592 593 593 593 593 593 593 833 593 593 593 593 593 594
145 145 145 145 145 68 486 485 484 485 484 485 484 487 13 13 13 13 1 1 1 1 1 13 13 13 1 1 1 1 1 1 462 463 1 834 836 813 837 835 1 116 121 121 125 114 1 1 1 1 1 1 1 1 13 13 13 13 13 1 1 1 1 1 1 1 1 1 13 13 13 13 1 602 1 1 1 1 1 1
1 1 1 1 1 1 1 1 1 1 1 1 1 1 1 1 1 1 1 1 1 1 13 13 13 13 13 1 1 1 1 1 470 471 1 1 1 1 1 3 1 114 30 31 116 122 1 1 1 1 1 1 1 1 1 13 13 13 13 13 13 13 1 1 1 1 1 13 13 13 13 13 13 602 1 1 1 1 1 1
1 1 1 1 1 1 1 1 1 1 1 1 1 1 1 1 1 1 1 1 1 1 13 13 13 13 13 1 1 1 1 1 476 477 462 463 1 1 1 1 1 114 38 39 114 592 593 593 593 593 594 1 1 592 593 593 594 1 1 1 592 594 1 1 592 593 593 593 593 593 593 593 593 594 1 1 1 1 1 1
1 1 1 1 4 280 281 281 281 281 281 281 282 1 1 1 1 1 1 1 1 13 13 13 13 13 13 13 1 1 1 1 468 469 468 471 116 175 207 121 121 122 1 1 114 13 13 1 1 1 1 1 1 1 1 1 602 1 1 1 600 602 1 1 600 1 1 1 1 1 1 1 1 602 1 1 1 1 1 1
1 4 1 280 281 289 289 297 297 297 297 297 298 1 13 13 13 592 593 593 593 593 593 593 593 593 593 593 593 594 1 1 486 485 484 487 114 1 1 1 1 1 1 1 114 13 13 13 592 593 593 593 593 594 1 592 594 1 1 1 600 602 1 1 592 593 593 593 593 593 593 593 593 594 1 1 1 1 462 463
281 281 281 289 289 289 298 1 1 1 1 1 13 13 13 13 13 13 13 13 13 13 13 1 116 124 124 124 124 124 175 207 124 124 124 124 122 1 1 1 1 1 1 1 114 13 13 13 13 13 13 13 1 1 1 1 602 13 13 1 600 602 1 1 1 1 13 13 13 13 13 13 1 1 1 1 462 463 470 469
297 297 297 297 297 298 1 1 462 463 462 455 454 455 454 455 13 13 13 13 116 124 124 124 125 116 145 145 145 145 175 207 145 145 145 145 145 121 121 121 416 121 175 207 122 592 593 593 593 593 593 593 593 593 593 593 594 13 13 13 600 602 1 1 1 13 13 13 13 13 13 1 1 1 1 1 470 469 484 485
1 1 4 1 1 4 1 1 470 469 468 469 468 469 468 471 116 124 124 124 125 116 145 145 145 122 1 1 1 1 1 1 1 1 1 1 1 1 13 13 13 13 13 1 1 1 1 1 1 1 1 1 1 1 1 13 13 13 13 13 600 602 592 593 593 593 593 593 593 593 593 594 1 1 1 1 486 485 116 124
4 1 1 1 1 1 1 1 486 485 484 487 484 485 484 487 117 116 416 145 169 122 1 1 1 1 1 116 121 121 175 207 121 121 137 1 1 1 1 13 13 13 13 13 13 13 1 1 1 1 1 1 1 1 1 13 13 13 13 13 600 602 1 259 260 260 260 260 261 1 1 1 1 1 116 124 124 124 125 384
121 121 121 496 497 121 121 121 124 124 124 124 124 124 124 124 125 117 1 1 1 1 1 116 124 124 124 125 93 94 94 94 3 95 123 124 124 124 124 137 13 13 13 13 13 13 13 1 1 1 1 1 1 1 13 13 13 13 13 13 592 594 1 725 733 733 733 733 741 1 1 1 1 1 117 384 393 393 393 408
1 1 1 470 471 1 1 1 116 169 169 169 169 169 169 169 169 125 116 124 124 124 124 125 384 393 393 385 93 94 94 94 94 95 384 393 393 393 385 123 124 124 124 124 124 124 124 124 124 124 124 124 124 124 124 124 124 124 124 124 124 124 124 124 124 124 124 124 124 124 124 124 124 124 125 400 368 368 368 368
462 463 1 486 487 116 124 124 125 113 113 113 113 113 113 116 169 169 125 384 393 393 393 393 408 368 336 357 93 94 94 94 94 95 356 337 368 368 410 393 393 393 393 393 393 393 393 393 393 393 393 393 393 393 393 393 393 393 393 393 393 393 393 393 393 393 393 393 393 393 393 393 393 393 393 408 368 368 368 368
470 471 1 116 124 125 116 169 169 124 124 124 124 124 124 125 384 393 393 408 368 368 368 368 368 368 344 365 93 94 94 94 94 95 364 345 336 337 368 368 368 368 368 368 368 368 368 368 368 368 368 368 368 368 368 368 368 368 368 368 368 368 368 368 368 368 368 368 368 368 368 368 368 368 368 368 368 368 368 368
486 487 116 125 113 113 117 384 393 393 393 393 393 393 393 393 408 368 368 368 368 368 368 368 368 336 337 402 101 94 94 94 94 103 400 368 344 345 336 337 336 337 368 368 368 368 368 368 368 368 368 368 368 368 368 368 368 368 368 368 368 368 368 368 368 368 368 368 368 368 368 368 368 368 368 368 368 368 368 368
1 116 125 113 116 124 125 400 368 368 368 368 368 368 368 368 368 368 368 368 368 368 368 368 368 344 345 410 393 393 393 393 393 393 408 368 368 368 344 345 344 345 368 368 368 368 368 368 368 368 368 368 368 368 368 368 368 368 368 368 368 368 368 368 368 368 368 368 368 368 368 368 368 368 368 368 368 368 368 368