Route133_Layout (80x40)
368 368 368 368 373 374 373 374 336 337 368 368 368 368 336 337 368 368 368 368 368 368 373 374 368 368 368 368 336 337 336 337 368 368 368 368 373 374 336 337 336 337 336 337 368 368 368 336 337 368 368 336 337 368 368 373 374 336 337 373 374 368 368 368 368 336 337 336 337 373 374 336 337 373 374 368 368 368 336 337
336 337 368 368 381 382 381 382 344 345 368 368 373 374 344 345 336 337 373 374 336 337 381 382 336 337 373 374 344 345 344 345 368 368 336 337 381 382 344 345 344 345 344 345 368 373 374 344 345 336 337 344 345 336 337 381 382 344 345 381 382 336 337 373 374 344 345 344 345 381 382 344 345 381 382 336 337 368 344 345
344 345 373 374 368 368 368 368 368 368 373 374 381 382 368 368 344 345 381 382 344 345 611 611 344 345 381 382 368 368 368 368 336 337 344 345 368 368 368 368 368 368 368 336 337 381 382 368 368 344 345 368 368 344 345 611 611 368 368 368 368 344 345 381 382 611 611 611 611 611 368 368 368 368 368 344 345 336 337 368
368 368 381 382 368 368 368 368 368 368 381 382 368 368 368 368 368 368 368 368 611 611 611 611 611 368 368 368 368 368 368 368 344 345 611 368 368 368 368 368 368 368 368 344 345 368 368 368 368 368 368 368 611 611 611 611 611 611 611 368 368 368 611 611 611 611 611 611 611 611 611 611 611 368 368 368 368 344 345 368
611 611 368 368 368 368 368 368 368 368 368 368 368 368 368 368 611 611 611 611 611 611 611 611 611 611 611 611 611 611 611 611 611 611 611 611 336 337 652 652 652 611 611 611 611 611 368 368 368 368 368 611 611 611 611 611 611 611 611 611 611 611 611 611 611 611 611 611 611 611 611 611 611 611 611 611 611 611 611 611
611 611 611 611 368 368 368 368 373 374 368 368 373 374 368 368 368 373 374 611 611 611 611 598 582 582 582 599 611 611 611 611 643 643 643 611 344 345 652 652 611 611 611 368 368 368 368 368 611 611 611 611 611 611 611 611 611 611 611 611 611 611 611 611 611 598 582 582 582 582 582 582 582 582 582 582 582 582 599 611
611 611 611 611 611 368 373 374 381 382 368 368 381 382 368 368 368 381 382 598 582 582 582 574 414 414 414 607 611 611 611 611 336 337 643 643 611 611 611 611 611 611 611 611 611 611 611 611 611 611 611 611 611 611 611 611 611 611 611 611 611 611 611 611 611 606 414 414 414 414 414 414 414 414 414 414 414 414 607 611
611 611 611 611 611 611 381 382 429 430 430 430 430 430 430 430 430 430 430 411 350 343 343 343 343 351 591 615 611 611 611 611 344 345 611 652 652 652 652 652 611 611 611 611 611 611 611 611 611 611 611 643 643 643 643 643 643 611 611 611 611 611 611 611 611 614 583 583 590 414 414 414 414 414 414 414 414 414 607 611
611 611 611 598 582 582 582 582 411 414 414 414 350 343 343 343 343 343 343 343 180 223 223 116 121 367 607 611 611 611 611 611 611 652 652 652 652 611 611 611 611 611 611 611 611 611 611 611 611 611 611 611 611 611 611 643 643 643 643 643 643 643 643 611 611 611 611 611 614 583 583 590 414 414 414 414 414 414 607 611
611 611 611 606 350 343 351 414 414 414 414 414 358 223 223 223 223 223 223 223 116 121 121 367 414 414 607 611 611 611 611 652 652 652 652 611 611 611 611 611 611 611 611 611 611 611 611 611 611 611 598 582 582 582 599 611 611 611 611 611 643 643 643 643 643 643 611 611 611 611 611 614 583 590 414 414 414 414 607 611
611 611 598 574 358 223 190 351 414 414 350 343 190 223 116 121 121 121 121 121 367 414 414 414 591 583 615 611 611 652 652 652 611 611 611 611 611 611 611 611 611 611 611 611 611 611 611 611 611 611 606 414 414 414 575 582 582 599 611 611 611 611 611 643 643 643 643 643 643 643 611 611 611 614 583 583 583 583 615 611
611 611 606 350 190 223 223 191 343 343 190 116 121 121 367 414 414 414 414 414 414 414 591 583 615 611 611 652 652 652 611 611 611 611 611 611 611 611 611 611 611 611 611 643 643 643 643 611 611 611 614 590 414 414 414 414 414 575 582 582 599 611 611 611 611 611 643 643 643 643 643 643 643 611 611 611 611 611 611 611
611 598 574 358 223 223 223 223 223 223 223 399 414 414 414 414 414 414 414 591 583 583 615 611 611 652 652 652 611 611 611 373 379 379 379 379 379 379 379 379 379 379 379 379 372 643 643 643 643 611 611 614 590 414 414 414 414 414 414 414 575 582 582 599 611 611 611 611 611 643 643 643 643 643 643 611 611 611 611 611
611 606 414 358 223 223 116 121 121 121 121 367 414 591 583 583 583 583 583 615 611 611 652 652 652 652 652 611 373 379 379 180 223 223 223 223 223 223 223 223 223 223 223 223 180 379 379 372 643 643 611 611 614 590 414 414 414 414 414 414 414 414 414 575 582 582 599 611 611 611 611 611 643 643 643 643 643 611 611 611
611 606 414 366 121 121 367 414 414 414 414 414 414 607 611 611 611 611 611 652 652 652 652 652 611 611 611 373 180 223 223 223 116 121 121 121 121 121 121 121 121 121 121 137 223 223 223 180 379 372 643 611 611 614 590 414 414 414 414 414 414 414 414 414 414 414 575 582 582 599 611 611 611 611 611 611 611 611 611 611
611 606 414 414 414 414 414 414 414 591 583 583 583 615 611 611 652 652 652 652 652 611 611 611 373 379 379 180 223 116 121 121 146 292 292 292 292 292 292 292 292 292 292 144 121 121 121 137 223 380 643 643 611 611 614 590 414 414 414 414 414 414 414 414 414 414 414 414 414 607 611 611 611 611 611 611 611 611 611 611
611 614 583 590 414 414 414 414 591 615 611 611 611 611 611 611 611 611 611 611 611 611 373 379 180 116 121 121 121 146 292 398 422 422 422 422 397 292 292 398 422 422 422 397 292 292 292 136 223 180 372 611 611 611 611 614 583 583 583 583 583 583 583 583 583 583 583 583 583 615 611 643 643 643 611 611 611 611 611 611
611 611 611 614 583 583 583 583 615 611 611 611 611 611 611 611 611 611 611 611 611 611 378 116 121 367 422 422 422 422 422 423 420 446 446 419 421 422 422 423 420 446 419 421 422 422 422 366 121 137 180 372 611 611 611 611 611 611 611 611 611 611 611 611 611 611 611 611 611 611 611 336 337 643 643 643 611 611 611 611
611 611 611 611 611 611 611 611 611 611 611 611 611 611 611 611 611 611 611 611 611 611 381 382 445 446 446 446 446 446 446 446 447 368 368 445 446 446 446 446 447 368 445 446 446 446 446 446 447 381 121 382 611 611 611 611 611 611 611 611 611 611 611 611 611 611 611 611 611 611 611 344 345 611 643 643 643 611 611 611
611 611 611 611 611 611 611 611 611 611 611 611 611 611 611 611 611 611 611 611 611 611 611 368 368 368 368 368 368 368 368 368 368 368 368 368 368 368 368 368 368 368 368 368 368 368 368 368 368 611 611 611 611 611 611 611 611 611 611 611 611 611 611 611 611 611 611 611 611 611 611 611 611 611 611 643 643 643 643 611
611 611 611 611 611 611 611 611 611 611 611 611 611 611 611 611 611 611 611 611 611 611 368 368 368 368 368 368 368 368 368 368 368 368 368 368 368 368 368 368 368 368 368 368 368 368 368 611 611 611 611 611 611 611 611 611 611 611 611 611 611 611 611 611 611 611 611 611 611 611 611 611 611 611 611 611 611 611 611 611
611 611 611 611 611 611 611 611 611 611 611 611 611 611 611 611 611 611 611 611 611 611 611 611 368 368 368 368 368 368 368 368 368 368 368 368 368 368 368 368 368 368 368 368 368 611 611 611 611 611 611 611 611 611 611 611 611 611 611 611 611 611 611 611 611 611 611 611 611 611 611 611 611 611 611 611 611 611 611 611
611 611 611 611 611 611 611 611 611 611 611 611 611 611 611 611 611 611 611 611 611 611 611 336 337 368 368 336 337 368 368 368 368 336 337 368 368 368 368 368 368 368 368 373 379 379 379 379 379 379 379 379 379 379 372 611 611 611 336 337 611 611 336 337 611 611 611 336 337 336 337 611 611 611 611 611 336 337 336 337
611 611 611 611 611 611 611 611 611 611 611 611 611 611 611 611 611 611 611 611 336 337 611 344 345 336 337 344 345 336 337 336 337 344 345 368 368 368 368 373 379 379 379 180 223 223 223 223 223 223 223 223 223 223 180 372 336 337 344 345 611 611 344 345 611 336 337 344 345 344 345 336 337 611 336 337 344 345 344 345
611 611 611 611 611 611 611 611 611 611 611 611 611 611 611 611 611 373 374 611 344 345 611 611 611 344 345 368 368 344 345 344 345 368 368 368 368 368 373 180 223 116 121 121 121 121 121 137 223 116 121 121 121 121 121 382 344 345 611 611 611 611 611 611 611 344 345 368 368 368 368 344 345 611 344 345 335 335 335 335
611 611 611 611 611 611 611 611 611 611 611 611 611 611 611 373 374 381 382 620 620 620 611 611 611 368 368 368 368 368 368 368 368 368 368 368 373 379 180 223 116 367 414 414 404 414 414 366 137 138 414 414 404 414 414 575 599 611 611 611 611 611 368 368 368 368 368 368 368 368 368 368 368 336 337 335 335 335 335 335
582 599 611 611 611 611 611 611 611 611 611 611 611 373 374 381 382 620 620 620 620 611 611 611 611 611 611 611 368 368 368 368 368 373 379 379 180 116 121 121 367 414 414 414 414 404 414 414 366 367 414 414 414 414 414 414 575 599 611 611 368 368 368 368 368 368 368 368 368 368 368 336 337 344 345 335 335 335 335 335
414 607 611 611 611 611 611 611 611 611 611 373 374 381 382 620 620 620 620 611 611 611 611 611 611 611 611 611 611 611 368 368 373 180 223 223 116 367 414 414 414 414 414 350 351 414 414 414 414 414 414 404 350 351 414 414 414 607 611 368 368 368 368 368 368 368 368 368 368 368 368 344 345 335 335 335 335 335 335 335
414 607 611 611 611 611 611 611 611 611 611 381 382 620 620 620 620 611 611 611 611 611 611 611 611 611 611 611 611 611 611 611 381 121 121 121 367 414 414 404 414 414 414 366 367 414 414 414 414 414 414 414 358 359 350 351 414 607 611 611 368 368 368 368 368 368 368 368 368 368 368 336 337 335 335 335 335 335 335 335
414 607 611 611 611 611 611 611 611 611 611 611 620 620 620 611 611 611 611 611 611 611 611 611 611 611 611 611 611 611 611 611 611 611 611 611 606 414 414 414 414 350 351 414 414 414 414 414 414 414 414 414 366 367 358 359 414 607 611 611 611 368 368 368 368 368 368 368 368 368 368 344 345 335 335 335 335 335 335 335
414 607 611 611 611 611 611 611 611 611 611 611 611 611 611 611 611 611 611 611 611 611 611 611 611 611 611 611 611 611 611 611 611 611 611 611 614 583 590 414 414 358 359 414 404 414 414 414 414 414 414 414 414 414 366 367 414 607 611 611 611 611 611 368 368 368 368 368 368 368 611 611 336 337 335 335 335 335 335 335
414 607 611 611 611 611 611 611 611 611 611 611 611 611 611 611 611 611 611 611 611 611 611 611 611 611 611 611 611 611 611 611 611 611 611 611 611 611 606 414 414 366 367 414 414 414 414 591 583 583 583 590 414 414 414 414 591 615 611 611 611 611 611 611 611 368 368 336 337 643 611 611 344 345 336 337 335 335 335 335
414 607 611 611 611 611 611 611 611 611 611 611 604 604 604 611 611 611 611 611 611 611 611 611 611 611 611 611 611 611 611 611 611 611 611 611 611 611 614 590 414 414 414 414 414 591 583 615 611 611 611 614 583 583 583 583 615 611 611 611 611 611 611 611 611 611 611 344 345 643 643 643 611 611 344 345 336 337 336 337
591 615 611 611 611 611 611 611 611 611 611 611 336 337 604 604 604 604 611 611 611 611 611 611 611 611 611 611 611 611 611 611 611 611 611 611 611 611 611 614 590 414 414 414 591 615 611 611 611 611 611 611 611 611 611 611 611 611 611 611 611 611 611 611 611 611 611 611 611 611 643 643 643 643 611 611 344 345 344 345
615 611 611 611 611 611 611 611 611 611 611 611 344 345 336 337 604 604 604 604 604 611 611 611 611 611 611 611 611 611 611 611 611 611 611 611 611 611 611 611 614 583 583 583 615 611 611 611 611 611 611 611 611 611 611 611 611 611 611 611 611 611 611 611 611 611 611 611 611 368 336 337 643 643 643 643 611 611 611 611
611 611 611 611 611 611 611 611 611 611 611 611 611 611 344 345 373 374 336 337 604 604 604 611 611 611 611 611 611 611 611 611 611 368 368 368 368 368 368 368 611 611 611 611 611 611 611 611 611 611 611 611 611 611 611 611 611 611 611 611 611 611 611 611 373 374 611 611 368 368 344 345 368 368 643 643 643 643 611 611
373 374 611 611 611 611 611 611 611 611 611 611 373 374 368 368 381 382 344 345 611 611 611 611 611 611 336 337 611 611 611 611 336 337 368 368 368 368 368 336 337 373 374 611 611 611 611 611 611 611 611 611 611 368 368 368 373 374 368 368 336 337 373 374 381 382 368 368 368 368 368 368 368 368 368 368 336 337 336 337
381 382 611 611 611 611 611 611 373 374 336 337 381 382 368 368 368 368 373 374 611 611 611 611 611 611 344 345 373 374 336 337 344 345 368 368 368 368 368 344 345 381 382 336 337 611 611 611 611 368 368 336 337 373 374 368 381 382 336 337 344 345 381 382 336 337 368 368 373 374 368 368 368 368 336 337 344 345 344 345
368 368 336 337 336 337 373 374 381 382 344 345 368 368 368 368 368 368 381 382 373 374 373 374 336 337 373 374 381 382 344 345 368 336 337 373 374 336 337 373 374 368 368 344 345 336 337 373 374 373 374 344 345 381 382 336 337 368 344 345 368 368 368 368 344 345 373 374 381 382 336 337 373 374 344 345 368 368 368 368
368 368 344 345 344 345 381 382 368 368 368 368 368 368 368 368 368 368 368 368 381 382 381 382 344 345 381 382 368 368 368 368 368 344 345 381 382 344 345 381 382 368 368 368 368 344 345 381 382 381 382 368 368 368 368 344 345 368 368 368 368 368 368 368 368 368 381 382 368 368 344 345 381 382 368 368 368 368 368 368