Route108_Layout (60x20)
368 368 368 368 368 368 368 368 368 368 368 368 368 368 368 368 336 337 368 368 429 430 430 430 430 430 430 430 430 430 430 430 430 431 368 368 368 368 368 368 368 368 368 368 368 368 368 336 337 368 368 368 368 368 368 368 368 368 368 368
336 337 368 368 368 368 368 368 368 368 368 368 368 368 368 368 344 345 368 429 411 414 404 414 414 350 351 414 404 350 351 414 414 354 337 368 368 368 368 368 368 368 368 368 368 368 368 344 345 368 368 368 368 368 368 368 368 368 336 337
344 345 429 430 430 431 368 336 337 368 368 368 368 368 368 368 368 368 336 355 350 351 414 404 404 366 367 404 414 366 367 404 404 362 345 368 368 368 429 430 430 430 430 431 368 336 337 368 368 368 368 373 374 368 373 374 336 337 344 345
368 336 355 350 351 354 337 344 345 429 430 430 431 368 336 337 368 368 344 363 366 367 414 414 414 350 351 414 849 850 851 852 404 439 368 373 374 336 355 350 351 414 404 354 337 344 345 373 374 368 368 381 382 368 381 382 344 345 368 368
368 344 363 366 367 362 345 368 336 355 350 351 354 337 344 345 373 374 368 445 446 446 446 446 419 366 367 856 857 858 859 860 861 439 368 381 382 344 363 366 367 404 414 362 345 368 368 381 382 336 337 368 336 337 368 368 368 368 368 368
368 368 445 446 446 447 368 368 344 363 366 367 362 345 368 368 381 382 368 368 368 368 368 368 445 419 414 864 865 866 867 868 869 439 368 368 368 368 445 419 414 414 420 447 368 368 368 368 368 344 345 368 344 345 368 368 368 368 368 368
368 368 368 368 368 368 368 368 368 445 446 446 447 368 368 368 368 368 368 368 368 368 368 368 368 445 446 419 873 874 875 420 446 447 368 368 368 368 368 445 446 446 447 368 368 368 368 368 368 368 368 368 368 368 368 368 368 368 368 368
368 368 368 368 368 368 368 368 368 368 368 368 368 368 368 368 368 368 368 368 368 368 368 368 368 368 368 445 446 446 446 447 368 368 368 368 368 368 368 368 368 368 368 368 368 368 368 368 368 368 368 368 368 368 368 368 368 368 368 368
368 368 368 368 368 368 368 368 368 368 368 368 368 368 368 368 368 368 368 368 368 368 368 368 368 368 368 368 368 368 368 368 368 368 368 368 368 368 368 368 368 368 368 368 368 368 368 368 368 368 368 368 368 368 368 368 368 368 368 368
368 368 368 368 368 368 368 368 368 368 368 368 368 368 368 368 368 368 368 368 368 368 368 368 368 368 368 368 368 368 368 368 368 368 368 368 368 368 368 368 368 368 368 368 368 368 368 368 368 368 368 368 368 368 368 368 368 368 368 368
368 368 368 368 368 368 368 368 368 368 368 368 368 368 368 368 368 368 368 368 368 368 368 368 368 368 368 368 368 368 368 368 368 368 368 368 368 368 368 368 368 368 368 368 368 368 368 368 368 368 368 368 368 368 368 368 368 368 368 368
368 368 368 368 368 368 368 368 368 368 368 368 368 368 368 368 368 368 368 368 368 368 368 368 368 368 368 368 368 368 368 368 368 368 368 368 368 368 368 368 368 368 368 368 368 368 368 368 368 368 368 368 368 368 368 368 368 368 368 368
368 368 368 368 368 368 368 368 368 368 368 368 368 368 368 368 368 368 368 368 368 368 368 368 368 373 374 368 368 368 368 368 368 368 368 368 368 368 368 368 368 336 337 368 429 430 430 431 368 368 368 368 368 368 368 368 368 368 368 368
368 368 368 336 337 368 368 368 368 368 368 368 368 368 368 368 368 368 368 368 368 368 368 368 368 381 382 368 368 368 368 368 368 368 368 368 429 430 430 431 368 344 345 429 411 404 414 412 431 368 368 368 368 368 368 368 368 368 368 368
368 368 368 344 345 368 368 368 368 368 368 368 368 368 368 368 368 368 368 429 430 430 430 431 368 368 368 368 336 337 368 368 336 337 368 368 445 419 404 439 368 368 368 437 414 404 414 414 439 368 368 429 430 430 431 368 368 368 368 368
368 336 337 368 368 336 337 373 374 368 368 368 368 368 429 430 430 431 368 445 419 404 414 439 368 368 373 374 344 345 373 374 344 345 368 368 368 445 446 447 373 374 368 445 446 446 446 446 447 368 336 355 350 351 354 337 368 368 368 368
368 344 345 368 368 344 345 381 382 373 374 368 368 336 355 350 351 354 337 368 445 446 446 447 336 337 381 382 368 368 381 382 368 373 374 368 368 336 337 368 381 382 336 337 368 368 336 337 373 374 344 363 366 367 362 345 368 368 368 368
336 337 368 368 368 368 368 368 368 381 382 336 337 344 363 366 367 362 345 368 336 337 373 374 344 345 368 368 368 368 368 368 368 381 382 336 337 344 345 373 374 368 344 345 336 337 344 345 381 382 368 445 446 446 447 368 336 337 336 337
344 345 368 368 368 368 368 368 368 368 368 344 345 368 445 446 446 447 336 337 344 345 381 382 368 368 368 336 337 368 368 368 368 368 368 344 345 368 368 381 382 368 368 368 344 345 368 368 368 368 368 336 337 368 368 368 344 345 344 345
368 368 368 368 368 368 368 368 368 368 368 368 368 368 368 368 368 368 344 345 368 368 368 368 368 368 368 344 345 368 368 368 368 368 368 368 368 368 368 368 368 368 368 368 368 368 368 368 368 368 368 344 345 368 368 368 368 368 368 368