Route120_Layout (40x100)
198 199 198 199 198 199 198 198 198 22 22 22 199 199 199 22 22 22 22 22 22 198 198 199 198 198 198 198 198 199 198 199 198 199 198 199 198 199 198 199
199 198 199 198 199 198 199 199 199 15 15 1 22 22 22 1 15 15 15 15 1 22 22 22 22 22 22 22 22 199 199 199 199 199 199 199 199 199 198 198
198 199 198 199 198 199 199 199 198 198 198 15 15 15 15 15 198 198 198 22 1 1 1 1 1 1 1 1 1 22 22 22 22 199 199 199 199 199 199 199
199 199 198 198 22 23 198 198 198 198 198 198 198 198 198 198 22 22 22 1 1 1 1 1 1 1 1 3 1 1 1 1 1 22 22 22 199 199 198 198
22 22 22 22 1 1 22 22 22 22 22 22 22 22 22 22 1 1 280 281 281 281 281 281 281 281 281 281 281 281 281 282 1 1 1 1 22 22 199 198
1 1 1 1 1 1 1 1 1 1 1 1 1 1 280 281 281 281 289 289 289 289 297 297 297 297 297 297 297 297 297 298 1 1 1 1 1 1 22 198
1 1 1 1 1 1 280 281 281 281 281 281 281 281 289 289 289 289 297 297 297 298 21 21 21 21 21 21 21 21 21 21 21 1 1 1 1 1 1 198
1 1 1 1 1 1 296 297 297 297 297 297 297 297 297 297 297 298 1 1 1 21 21 21 21 21 21 21 21 21 21 21 21 21 21 21 1 1 1 22
1 1 1 1 15 15 15 1 1 1 1 1 1 1 1 1 1 1 1 15 21 21 21 21 21 21 21 21 21 520 21 21 21 21 21 21 21 1 1 1
1 15 15 15 198 198 198 15 1 1 1 1 1 1 1 1 1 1 1 198 21 21 21 21 21 641 642 643 21 21 21 21 21 21 21 520 21 21 1 14
14 198 198 198 198 198 198 198 116 124 124 124 124 124 124 124 124 124 137 23 520 520 520 520 520 624 625 626 21 21 21 21 21 21 21 21 21 21 14 198
199 198 199 198 198 198 198 198 117 116 169 169 169 169 169 169 169 137 123 124 175 124 124 124 137 1 1 1 21 21 21 520 21 21 21 21 21 520 198 198
198 198 198 198 198 198 198 198 117 117 195 177 177 177 177 177 178 120 432 169 175 169 169 137 123 124 124 137 21 21 21 21 21 21 21 21 520 14 198 198
199 198 198 198 198 198 198 198 117 117 184 161 161 161 161 161 186 1 1 1 1 1 1 120 169 169 137 115 520 21 21 21 520 520 520 520 1 198 198 198
198 198 198 198 198 23 23 23 117 117 184 161 161 161 161 161 194 177 177 177 177 177 177 177 177 196 115 115 1 520 520 520 1 1 1 1 14 198 198 198
198 198 198 198 23 1 1 1 751 695 661 663 663 757 663 663 663 663 663 663 663 663 663 663 663 662 695 751 1 1 1 1 1 1 14 14 198 198 198 198
198 198 198 198 1 1 1 1 759 703 669 671 671 671 671 671 671 671 671 671 671 671 671 671 671 670 703 759 1 1 1 1 1 14 198 198 198 198 198 198
198 198 198 23 1 1 1 1 117 117 184 161 161 756 161 161 161 161 161 161 161 161 161 161 161 186 115 115 1 14 14 14 14 198 198 198 198 198 198 198
198 198 198 1 1 1 1 1 117 117 622 631 631 631 631 631 631 631 631 631 631 631 631 631 631 623 115 115 14 198 198 198 198 198 198 198 198 198 199 199
198 198 198 1 1 1 1 1 117 117 622 631 631 631 631 631 631 631 631 631 631 631 631 631 631 623 115 115 198 198 198 198 198 198 198 198 198 198 199 199
198 198 198 1 1 1 1 1 551 551 184 161 161 161 161 161 161 161 152 153 154 161 161 161 161 186 115 115 199 199 198 198 198 198 198 198 198 198 199 199
198 198 23 1 1 1 1 1 199 199 569 154 161 161 161 161 161 152 238 113 239 154 161 161 161 186 115 115 199 199 198 198 198 198 198 198 198 198 199 199
198 198 1 1 1 1 1 1 199 199 15 117 184 161 161 161 161 160 123 679 125 162 161 152 526 644 644 644 199 199 727 735 743 198 198 198 198 198 199 199
198 23 1 1 200 202 1 1 198 198 198 117 184 45 45 45 161 168 121 687 121 170 152 238 14 199 199 199 199 199 624 625 626 23 23 23 23 23 199 199
198 1 1 1 216 218 1 1 23 199 199 644 644 199 199 199 45 45 45 45 45 203 115 115 199 199 199 199 199 199 14 1 1 331 332 332 332 333 198 198
23 1 1 1 1 1 1 1 648 638 199 199 199 199 199 199 199 199 199 199 199 644 644 644 199 199 199 199 199 199 199 1 1 275 276 276 276 277 198 198
1 1 1 1 1 648 650 1 656 657 638 638 199 199 199 199 199 199 199 199 199 199 199 199 199 199 199 199 199 199 199 14 1 1 1 1 1 14 198 198
1 1 1 1 1 664 657 650 656 657 657 657 638 638 199 199 199 199 199 638 638 638 638 638 199 199 199 199 199 199 199 199 1 1 1 1 14 199 198 198
15 1 1 200 202 1 664 666 656 628 629 657 657 657 638 638 638 638 638 657 657 657 657 657 638 638 638 638 638 638 199 199 14 14 1 1 199 199 198 198
198 1 1 216 218 1 1 1 664 636 637 657 657 657 657 657 657 657 657 657 628 629 657 657 657 657 657 657 657 658 23 199 199 199 14 1 199 199 198 198
198 15 1 1 1 1 1 1 1 664 665 657 657 630 630 657 657 657 657 657 636 637 657 657 657 657 657 657 657 658 1 23 199 199 199 1 199 199 198 198
198 198 15 15 15 1 1 1 200 202 1 664 657 199 199 657 657 628 629 657 630 657 657 628 629 657 630 630 657 658 1 1 23 199 199 1 199 199 198 198
198 198 198 198 198 15 15 1 216 209 202 1 656 638 638 657 628 209 637 630 199 630 628 209 637 630 199 199 657 658 1 1 1 23 23 1 199 199 198 198
198 198 198 198 198 198 198 15 1 216 218 1 664 657 657 657 636 637 657 199 638 638 208 210 657 199 199 638 657 628 202 1 1 1 1 1 199 199 198 198
198 198 198 198 198 198 198 198 15 15 1 1 1 656 657 630 657 657 657 638 657 657 636 209 629 638 638 657 628 209 637 650 1 1 1 1 199 199 198 199
198 198 198 198 198 198 198 198 198 198 15 15 15 664 630 199 630 657 657 657 628 629 657 208 210 657 657 628 209 210 657 658 1 1 1 14 199 199 198 198
198 198 198 198 198 198 198 198 198 198 198 198 198 15 199 199 199 657 657 628 209 637 657 636 637 657 657 636 217 637 657 658 1 1 1 199 199 199 199 199
198 198 198 198 198 198 198 198 198 198 198 198 23 199 199 199 199 630 657 636 637 657 657 665 665 665 657 657 657 657 657 666 1 1 1 199 199 199 199 199
29 29 29 29 29 29 2 2 29 29 29 29 106 23 23 199 199 199 630 665 665 665 666 1 1 1 664 657 657 657 666 1 1 1 1 199 199 199 199 199
198 198 198 198 198 198 14 14 198 198 198 198 29 212 106 23 199 199 199 14 14 14 14 14 1 1 1 664 665 666 1 1 1 1 1 23 23 199 199 199
198 198 198 198 198 198 198 198 198 198 198 198 198 14 117 106 199 199 199 199 199 199 199 199 21 21 21 21 1 21 21 21 21 21 21 21 21 199 199 199
198 198 198 198 198 198 198 23 198 198 198 198 198 198 117 114 23 199 199 199 199 199 199 199 21 21 21 21 1 21 21 21 21 21 21 21 21 199 199 199
29 29 29 29 29 29 29 562 23 23 23 23 23 23 29 212 562 23 199 199 23 23 23 23 520 520 520 520 1 520 520 520 520 520 520 21 21 23 199 199
198 198 198 198 198 198 198 114 2 2 2 29 212 562 198 14 117 562 23 23 21 21 21 21 21 21 21 21 1 21 21 21 21 21 1 21 21 21 199 199
198 198 198 198 198 198 198 29 29 29 562 198 14 114 198 198 117 570 21 21 21 21 21 21 21 21 21 21 1 21 21 21 21 21 1 21 21 21 199 199
198 198 198 198 198 198 198 198 198 198 114 198 198 114 23 23 117 570 21 520 520 520 520 520 520 520 520 520 1 520 520 520 520 520 1 520 520 21 199 199
198 198 198 198 198 198 198 198 198 23 114 23 23 2 212 562 117 570 21 1 21 21 21 21 21 21 21 21 21 21 21 21 21 21 21 21 21 21 199 199
198 198 198 198 198 198 23 23 23 1 2 2 29 29 562 117 117 570 21 1 21 21 21 21 21 21 21 21 21 21 21 21 21 21 21 21 21 21 23 199
198 198 198 23 23 23 1 1 1 1 1 1 23 198 117 117 117 570 21 1 520 520 520 520 520 520 520 520 520 520 520 520 520 520 520 520 520 21 21 199
198 198 23 1 1 1 1 1 200 202 1 1 1 23 117 117 117 570 21 1 21 21 21 21 21 21 21 21 21 21 21 21 21 21 21 21 1 21 21 199
198 23 1 560 562 1 1 1 216 218 560 562 1 1 117 117 117 570 21 1 21 21 21 21 21 21 21 21 21 21 21 21 21 21 21 21 1 21 21 199
198 1 1 576 578 1 1 1 1 1 576 578 1 1 117 117 117 570 21 1 520 520 520 520 520 520 520 520 21 21 520 520 520 520 520 520 1 21 21 23
198 1 1 1 1 1 560 561 562 1 1 1 1 1 117 117 117 570 21 21 21 21 21 21 21 21 21 21 21 21 1 21 21 21 21 21 21 21 21 21
23 1 1 1 1 560 115 113 117 562 1 1 1 1 117 117 117 570 21 21 21 21 21 21 21 21 21 21 21 21 1 21 21 21 21 21 21 641 642 643
1 560 562 1 1 568 123 100 125 570 1 1 560 562 117 117 117 570 21 21 520 520 520 520 520 520 520 520 520 520 1 520 520 520 520 520 520 624 625 626
1 576 578 1 1 576 121 167 145 578 1 1 576 578 117 117 117 570 21 21 1 21 21 21 21 21 21 21 21 21 21 21 21 21 21 21 1 21 21 21
1 1 1 1 1 1 1 1 1 1 1 1 1 1 117 117 117 570 520 520 21 21 21 21 21 21 21 21 21 21 21 21 21 21 21 21 1 21 21 21
200 202 1 1 1 1 200 201 202 1 1 1 1 1 117 117 117 570 15 15 520 520 520 520 520 520 520 520 520 520 520 520 520 520 520 520 1 21 21 21
216 218 1 560 562 1 208 209 210 1 560 562 1 1 117 117 117 570 198 198 15 1 1 1 21 21 21 21 21 21 21 21 21 21 21 21 21 21 21 21
1 1 1 576 578 200 209 217 218 1 576 578 1 1 117 117 117 570 198 198 198 524 521 517 21 21 21 21 21 21 21 21 21 21 21 21 21 21 21 21
1 1 1 1 1 216 218 1 1 1 1 1 1 1 117 117 117 570 198 23 23 515 1 1 520 520 520 520 520 520 520 520 520 520 520 520 520 520 520 520
1 1 200 202 1 1 1 1 200 202 1 200 202 1 117 117 117 570 23 1 1 515 1 1 1 1 1 1 1 1 1 1 14 14 516 521 521 521 517 14
14 1 216 218 1 200 202 1 216 218 1 216 218 1 117 117 117 570 1 1 1 515 1 116 124 124 124 124 432 124 432 137 199 199 14 1 1 1 1 199
198 1 1 1 1 216 209 202 1 1 1 1 1 1 117 117 117 570 1 1 516 523 15 117 113 113 113 113 113 113 113 115 199 199 199 14 1 1 1 199
198 14 14 1 1 1 216 218 1 1 1 1 1 1 117 117 117 570 1 1 1 15 198 117 113 113 113 113 113 113 113 115 23 199 199 199 1 1 1 199
198 198 198 14 14 14 14 1 1 1 116 124 175 124 125 117 117 570 1 1 1 198 198 117 195 177 177 177 177 177 196 123 137 199 199 199 1 1 1 199
198 198 198 198 198 198 198 14 1 1 117 116 175 145 145 578 117 570 1 1 1 23 23 117 184 161 161 161 161 161 194 196 115 23 23 23 1 1 1 199
198 198 198 198 198 198 198 198 14 1 117 570 1 1 1 1 117 570 200 202 1 1 1 711 645 647 647 647 647 647 647 646 711 1 1 1 1 1 1 199
198 198 198 198 198 198 198 198 198 14 117 570 1 21 21 21 117 570 216 218 1 1 1 719 653 655 655 655 655 655 655 654 719 1 1 1 1 1 15 199
198 198 198 198 198 198 198 198 23 23 117 570 21 21 21 21 117 570 15 1 1 1 1 117 622 631 631 631 631 631 631 623 115 1 1 1 1 15 198 199
23 23 23 23 23 23 23 23 116 124 125 570 21 21 21 21 117 570 198 15 1 1 1 117 622 631 631 631 631 631 631 623 115 1 1 1 15 198 198 199
124 124 124 124 124 124 124 124 125 116 145 578 21 21 21 520 117 570 198 198 1 1 1 117 184 161 161 161 161 161 161 186 115 15 15 15 198 198 198 199
206 206 206 206 206 206 206 206 206 578 1 21 21 21 21 116 125 570 198 23 200 202 1 117 184 161 161 161 161 161 161 186 115 198 198 198 198 198 198 199
199 199 199 199 199 199 199 199 199 15 1 21 21 21 21 117 116 578 23 1 208 209 202 117 184 161 161 161 161 161 161 186 115 198 198 198 198 198 198 198
199 199 199 199 199 199 199 199 199 23 1 520 21 21 21 117 570 1 1 1 216 217 218 117 184 161 161 161 161 161 161 186 115 198 198 198 198 198 198 198
199 199 199 199 727 735 743 199 23 1 1 1 21 21 520 117 570 1 200 202 1 1 1 117 184 161 161 161 161 161 161 186 115 198 198 198 198 198 198 198
199 199 199 199 624 625 626 23 1 1 1 1 21 21 116 125 570 1 216 218 1 116 175 578 184 161 161 161 161 161 161 186 115 198 198 198 198 198 198 198
199 199 199 23 1 1 1 1 1 200 202 1 520 520 117 116 578 1 1 1 1 570 1 1 212 184 161 161 161 161 152 620 620 2 2 2 2 2 2 2
199 199 23 259 260 260 260 260 261 216 218 1 1 1 117 570 1 1 1 200 202 570 1 1 1 184 161 161 161 152 238 560 211 2 2 29 29 29 29 29
23 23 1 667 659 660 660 660 668 1 1 1 1 1 117 570 1 1 1 216 218 570 1 1 1 2 2 2 2 568 115 115 1 15 15 198 198 198 198 198
176 177 177 177 177 177 177 177 178 1 1 1 200 202 117 570 1 1 1 1 1 570 1 1 1 1 1 1 1 568 115 115 1 198 198 198 198 198 198 198
184 161 161 161 161 161 161 161 186 14 14 1 216 218 117 570 1 200 202 1 21 570 1 1 15 15 15 15 15 568 115 115 1 198 198 198 198 198 198 198
184 161 161 161 161 161 161 161 186 199 199 1 1 1 117 570 200 209 218 21 21 2 2 2 23 23 199 199 199 644 568 123 137 23 198 198 198 198 198 198
184 161 161 161 161 161 161 161 186 199 199 1 1 1 117 570 216 218 1 21 21 21 21 21 21 21 23 23 199 199 576 137 115 1 23 23 23 23 23 23
184 161 161 161 161 161 161 161 186 199 199 1 1 1 117 570 1 280 282 21 21 21 21 21 21 21 21 21 727 735 635 568 123 124 124 124 124 124 124 124
184 161 161 161 161 161 161 161 186 199 23 1 1 1 117 570 1 288 290 520 21 21 21 21 21 21 21 21 624 625 626 576 206 206 206 206 206 206 206 145
2 2 204 161 161 161 161 161 186 199 116 124 175 124 125 570 1 288 289 282 520 21 21 21 21 21 21 21 21 21 21 21 199 199 23 23 23 23 23 1
14 14 2 2 204 161 161 161 186 23 117 116 175 145 145 578 1 288 289 290 1 520 520 21 21 21 21 21 21 21 21 21 23 23 1 1 1 1 1 1
199 199 14 14 2 2 2 2 2 1 117 570 1 1 1 1 1 296 289 289 282 4 1 520 520 520 520 520 520 520 520 520 1 4 1 1 4 1 3 1
199 199 199 199 14 14 1 1 1 1 117 570 1 200 202 1 1 1 296 289 289 281 281 281 281 281 281 281 281 281 281 281 281 281 281 282 1 1 1 4
199 199 199 199 199 199 116 124 124 124 125 570 1 216 218 1 1 200 202 296 297 297 297 297 297 297 297 297 297 297 297 297 297 289 289 289 281 281 281 281
199 199 199 199 199 199 117 116 145 145 145 578 1 1 4 1 1 216 209 202 1 1 1 200 202 1 4 1 1 14 14 14 14 296 297 297 297 297 297 297
199 199 199 199 199 199 117 570 331 332 332 332 333 1 1 1 14 14 216 218 1 1 1 216 218 14 14 14 14 199 199 23 23 1 1 1 1 1 4 1
199 199 23 23 23 23 117 570 275 276 276 276 277 14 14 14 199 199 14 4 1 1 1 14 14 199 199 199 199 199 23 116 124 124 124 124 137 1 1 1
23 23 116 124 124 124 125 570 14 14 14 14 14 199 199 199 199 199 199 14 14 1 1 23 23 23 23 23 23 23 116 125 195 177 177 196 123 124 124 124
124 124 125 116 145 206 206 578 199 199 199 199 199 199 199 23 23 23 23 23 23 116 124 124 124 124 124 124 124 124 125 195 192 161 161 194 177 177 177 178
206 206 145 578 14 199 199 14 199 199 199 199 199 23 23 116 124 124 124 124 124 125 195 177 177 177 177 177 177 177 177 192 161 161 161 161 161 161 161 186
199 199 14 14 199 199 199 199 199 199 199 23 23 116 124 125 195 177 177 177 177 177 192 161 161 161 161 161 161 161 161 161 161 161 161 161 161 161 161 186
199 199 199 199 199 199 199 199 199 199 23 116 124 125 195 177 192 161 161 161 161 161 161 161 161 161 161 161 161 161 161 161 161 161 161 161 161 161 161 186
198 199 199 199 199 199 199 199 199 23 116 125 195 177 192 161 161 161 161 161 161 161 161 161 161 161 161 161 161 161 161 161 161 161 161 161 161 161 203 211