Route110_TrickHousePuzzle3_Layout (15x22)
513 513 517 518 513 513 517 518 513 513 517 518 514 623 516
521 521 525 526 521 521 525 526 521 521 525 526 522 631 524
550 528 528 550 528 528 550 534 528 550 600 534 550 528 528
557 600 520 557 520 520 557 587 588 557 520 520 557 587 588
565 520 520 570 520 520 565 595 596 570 520 520 589 595 596
625 520 520 578 520 520 625 520 520 578 536 537 597 520 520
542 587 588 542 568 569 542 520 520 542 558 559 542 520 520
565 595 596 565 576 577 589 520 520 570 566 567 565 600 520
638 536 537 600 520 520 597 520 520 578 625 625 625 520 520
542 558 559 550 587 588 542 587 588 550 520 520 542 587 588
565 566 567 546 595 596 570 595 596 546 520 600 589 595 596
625 625 625 546 520 520 578 520 520 546 520 520 597 520 520
542 520 520 557 600 520 542 568 569 557 568 569 542 520 520
565 520 520 589 520 520 570 576 577 565 576 577 570 520 520
625 520 520 597 536 537 578 520 520 625 520 520 578 520 520
542 568 569 542 558 559 542 520 520 542 520 520 542 587 588
565 576 577 565 566 567 570 520 520 589 520 520 570 595 596
625 520 520 625 625 625 578 520 520 597 520 520 578 536 537
542 520 520 542 587 588 542 587 588 542 568 569 542 558 559
565 520 520 565 595 596 565 595 596 565 576 577 565 566 567
625 520 520 625 520 600 625 520 520 625 520 520 625 625 625
529 530 520 520 520 520 520 520 520 520 520 520 520 520 520