Route102_Layout (50x20)
468 469 468 469 468 469 468 469 468 469 468 469 468 469 468 469 468 469 468 469 468 469 468 469 468 469 468 469 468 469 468 469 468 469 468 469 468 469 468 469 468 469 468 469 468 469 468 469 468 469
476 477 476 477 476 477 476 477 484 485 484 485 484 485 484 485 484 485 484 485 484 485 484 485 484 485 484 485 476 477 476 477 476 477 476 477 484 485 484 485 484 485 484 485 476 477 476 477 476 477
468 469 468 469 468 469 468 469 13 13 13 1 1 1 1 1 1 3 1 1 1 1 1 652 653 653 654 1 468 469 468 469 468 469 468 469 13 13 13 13 176 177 177 178 468 469 468 469 468 469
476 477 484 485 484 485 484 487 13 13 13 1 1 1 464 465 465 466 1 1 1 1 1 275 276 276 277 1 486 485 484 485 484 485 484 487 13 13 13 13 184 161 161 186 484 485 476 477 476 477
468 469 13 13 13 13 13 13 13 13 13 1 464 465 473 473 473 473 465 466 1 1 1 1 1 1 1 1 1 1 1 1 1 4 255 1 13 13 13 13 184 161 161 194 177 178 468 469 468 469
484 487 13 13 13 13 13 13 13 13 1 464 473 473 625 633 481 481 481 482 1 1 1 1 1 1 1 1 1 1 462 463 4 1 134 1 1 13 13 13 184 161 161 161 161 186 476 477 476 477
1 1 1 13 13 13 13 13 13 13 1 472 473 482 470 471 213 214 1 1 213 135 135 135 135 214 462 463 462 463 470 471 1 4 134 1 1 1 13 13 184 161 161 161 161 186 468 469 468 469
1 1 1 1 13 13 13 13 1 1 1 480 626 463 476 477 1 1 1 1 13 13 13 13 13 1 470 469 468 469 476 477 462 463 134 1 1 1 1 1 2 2 2 2 2 2 486 485 476 477
1 1 1 1 1 1 1 1 1 1 1 1 470 469 468 469 1 1 13 13 13 13 13 13 13 1 476 477 476 477 468 469 468 471 635 1 1 1 1 1 1 1 1 1 1 1 1 1 468 469
462 463 462 463 462 463 462 463 1 1 1 1 476 477 476 477 1 13 13 13 13 13 13 13 1 1 468 469 468 469 476 477 476 477 462 463 1 1 1 1 3 1 1 1 1 1 1 1 486 485
468 469 468 469 468 469 468 471 1 1 462 463 468 469 468 469 13 13 13 13 13 13 1 1 1 1 476 477 476 477 468 469 468 469 468 471 1 1 1 1 1 464 465 465 466 1 1 1 1 1
476 477 476 477 476 477 484 487 1 1 470 469 476 477 476 477 13 13 13 13 1 1 1 1 1 1 468 469 468 469 484 485 476 477 476 477 1 1 464 465 465 473 473 473 474 1 1 1 462 463
468 469 468 469 468 469 13 13 1 1 486 485 468 469 468 469 13 13 13 1 1 462 463 1 1 1 486 485 484 487 13 13 468 469 468 469 464 465 473 473 473 473 473 481 482 1 1 1 470 469
476 477 476 477 476 477 13 13 213 135 135 214 476 477 476 477 454 455 1 1 1 470 471 462 463 1 1 1 13 13 13 13 486 485 484 487 472 473 473 473 473 481 482 1 462 463 462 463 476 477
468 469 468 469 468 469 13 13 13 1 1 1 468 469 468 469 468 471 1 1 1 486 485 468 471 1 1 1 13 13 13 13 13 1 1 464 473 473 481 481 482 1 1 1 470 469 468 469 468 469
476 477 476 477 476 477 13 13 13 1 462 463 476 477 476 477 476 477 1 1 13 13 13 486 487 1 1 1 1 13 13 13 1 1 1 480 481 482 1 1 462 463 462 463 476 477 476 477 476 477
468 469 468 469 468 469 13 13 13 13 470 469 468 469 468 469 468 469 1 13 13 13 13 13 13 13 1 1 1 1 1 1 1 1 1 1 1 1 1 1 470 469 468 469 468 469 468 469 468 469
476 477 476 477 476 477 454 455 454 455 476 477 476 477 476 477 476 477 462 455 454 455 454 455 13 13 13 1 1 1 1 1 462 463 462 463 462 463 462 463 476 477 476 477 476 477 476 477 476 477
468 469 468 469 468 469 468 469 468 469 468 469 468 469 468 469 468 469 468 469 468 469 468 471 13 13 13 13 1 1 1 1 470 469 468 469 468 469 468 469 468 469 468 469 468 469 468 469 468 469
476 477 476 477 476 477 476 477 476 477 476 477 476 477 476 477 476 477 476 477 476 477 476 477 454 455 454 455 462 463 462 463 476 477 476 477 476 477 476 477 476 477 476 477 476 477 476 477 476 477