Route125_Layout (80x40)
368 368 368 368 368 368 368 368 368 368 368 368 368 368 368 368 368 368 336 337 368 429 514 371 371 371 371 371 371 371 371 371 371 371 371 515 431 368 368 368 368 368 368 368 368 368 368 368 368 368 368 368 368 368 368 368 368 368 368 368 368 368 368 368 368 368 368 368 368 368 368 368 368 368 368 368 368 368 368 368
368 368 368 368 368 368 368 368 368 368 368 368 368 368 368 368 368 368 344 345 368 437 358 113 107 108 108 108 108 108 108 108 108 109 113 380 439 368 368 368 368 336 337 368 368 368 368 368 368 368 336 337 368 368 827 828 829 368 368 336 337 368 368 368 368 368 368 368 368 368 368 368 368 368 368 368 368 368 368 368
368 368 368 368 368 368 368 368 368 368 368 368 368 368 368 368 368 368 368 368 368 437 358 113 115 113 113 147 148 113 113 113 113 191 109 380 439 368 368 368 368 344 345 368 368 368 368 368 827 829 344 345 368 368 378 113 380 368 368 344 345 827 829 368 368 368 368 368 368 368 368 368 368 368 368 368 368 368 368 368
368 368 368 368 368 368 368 368 368 368 368 368 368 368 368 368 368 368 429 514 371 190 190 113 115 147 148 155 156 113 113 113 147 148 117 191 190 371 515 431 368 368 368 368 368 368 368 368 381 382 368 368 336 337 386 121 388 336 337 368 368 381 382 368 368 368 368 368 368 368 368 368 368 368 368 368 368 368 368 368
368 368 368 368 368 368 368 368 368 368 368 368 368 368 368 368 368 368 437 358 107 108 108 108 190 155 156 113 113 113 113 113 155 156 191 109 113 113 380 439 368 368 827 828 828 829 336 337 368 368 368 368 344 345 368 368 368 344 345 368 368 368 368 827 829 368 368 368 368 368 368 368 368 368 368 368 368 368 368 368
368 368 368 368 368 368 368 368 368 368 368 368 368 368 368 368 368 429 411 358 115 107 108 108 108 108 108 108 108 108 108 108 108 108 109 191 108 109 380 439 368 368 378 113 113 380 344 345 368 368 368 368 368 368 368 368 368 368 368 368 368 368 368 381 382 368 368 368 368 368 368 368 368 368 368 368 368 368 368 368
368 368 368 368 368 368 368 368 368 368 368 368 368 368 368 368 368 437 350 190 115 115 113 107 108 108 108 108 108 109 113 113 113 113 117 113 113 117 380 439 368 368 386 121 121 388 368 368 368 368 368 368 368 368 368 368 368 368 368 368 368 368 368 368 368 827 829 368 368 368 368 368 368 368 368 368 368 368 368 368
368 368 368 368 368 368 368 368 368 368 368 368 368 368 368 368 368 437 358 107 190 115 113 115 113 113 113 113 113 191 108 108 109 113 191 109 113 117 359 439 368 827 829 368 368 368 368 368 368 368 429 430 430 430 430 430 430 431 368 368 368 368 368 368 368 381 382 368 368 368 368 368 368 368 368 368 368 368 368 368
368 368 368 368 368 368 368 368 368 368 368 368 368 368 827 829 368 437 358 115 113 115 113 115 147 148 113 113 113 113 113 113 117 113 113 117 113 117 359 354 337 381 382 368 368 368 368 368 368 368 437 405 406 406 406 406 407 412 431 368 827 828 828 828 829 368 368 368 368 368 368 368 368 368 368 368 368 368 368 368
368 368 368 368 368 368 368 368 368 368 368 368 368 368 381 382 429 411 358 115 113 115 113 115 155 156 113 113 113 113 113 113 117 147 148 117 116 125 359 362 345 368 368 368 368 368 368 368 368 368 437 413 163 129 129 130 390 407 412 431 378 107 108 109 380 368 368 368 368 368 368 368 368 368 368 368 368 368 368 368
368 368 368 368 368 368 368 368 368 368 368 368 368 368 368 368 437 350 190 115 107 190 113 115 113 113 113 113 113 113 113 113 117 155 156 117 117 116 367 439 368 368 368 368 368 368 368 368 368 368 437 413 171 416 137 191 130 415 414 439 378 123 137 117 380 368 368 336 337 368 368 368 368 368 368 368 368 368 368 368
368 368 368 368 368 368 368 368 368 368 368 827 828 829 368 429 411 358 107 190 115 107 108 190 113 113 113 113 113 113 113 113 117 113 113 117 117 138 414 439 368 368 368 368 368 368 368 368 368 368 437 421 397 292 171 416 172 415 414 439 381 137 123 125 380 368 368 344 345 368 368 368 368 368 368 368 368 368 368 368
368 368 368 368 368 368 368 336 337 368 368 378 113 380 368 437 350 190 115 113 115 115 113 147 148 113 113 113 113 113 113 116 125 116 124 125 117 138 420 447 368 368 368 429 430 430 430 430 430 431 445 419 421 422 422 422 422 423 420 447 368 381 121 121 388 368 368 368 368 368 368 368 368 368 368 368 368 368 368 368
829 368 368 368 368 368 368 344 345 336 337 386 121 388 336 355 358 107 190 113 115 115 113 155 156 113 113 113 113 147 148 117 113 117 116 124 125 138 439 368 368 368 368 437 405 406 406 406 407 439 368 445 446 419 414 414 414 420 447 368 368 368 368 827 829 368 368 368 368 368 368 368 368 368 368 368 368 368 368 368
382 827 829 368 827 828 828 829 368 344 345 368 368 368 344 363 358 115 113 107 190 115 113 113 113 113 113 113 113 155 156 117 113 117 117 147 148 138 439 368 368 368 368 437 413 163 129 130 415 439 368 368 368 445 446 446 446 447 368 368 368 368 368 381 382 368 368 368 368 368 368 368 368 368 368 368 368 368 368 368
368 381 382 368 378 113 113 380 368 368 368 368 827 829 368 437 358 115 113 115 113 123 124 124 137 113 113 113 113 113 113 117 113 117 117 155 156 138 439 368 368 368 368 437 413 171 121 172 415 439 368 368 368 368 368 368 368 368 368 368 368 827 829 368 368 368 368 368 368 368 368 368 368 368 368 368 368 368 368 368
368 546 827 829 386 121 121 388 368 368 368 368 381 382 429 411 358 123 137 123 124 124 137 113 123 124 124 137 147 148 113 117 116 125 117 113 116 367 439 368 368 368 368 437 421 422 422 422 423 439 368 368 368 368 368 368 368 368 368 368 368 381 382 368 368 368 368 368 368 368 368 368 368 368 368 368 368 368 368 368
829 368 381 382 368 368 368 368 368 368 368 368 368 368 437 414 358 113 123 169 137 113 123 124 169 169 137 115 155 156 113 117 117 113 117 113 138 414 439 368 368 368 368 445 446 446 446 446 446 447 368 368 368 368 368 368 368 827 828 828 829 368 368 368 368 368 368 368 368 368 368 368 368 368 368 368 368 368 368 368
382 368 368 368 368 368 368 368 368 368 368 368 368 429 411 414 366 121 145 137 123 124 159 169 169 137 115 123 137 113 116 125 117 113 117 116 367 420 447 368 368 368 368 368 368 368 368 368 368 368 368 368 368 368 368 368 368 378 113 113 380 368 368 368 368 368 368 368 368 368 368 368 368 368 368 368 368 368 368 368
827 828 829 368 368 368 368 368 368 368 368 429 430 411 414 414 414 414 414 366 145 145 167 145 137 115 123 137 123 124 125 116 125 116 125 138 414 439 368 368 368 368 368 368 368 368 368 368 368 368 368 368 368 368 368 368 368 378 113 113 830 829 368 368 368 368 368 368 368 368 368 368 368 368 368 368 368 368 368 368
830 113 380 368 368 368 368 429 430 430 430 411 414 414 414 414 414 414 414 414 414 414 414 414 358 115 113 123 169 169 169 125 116 125 113 138 414 439 368 368 368 368 368 368 368 368 368 368 368 368 368 368 545 368 368 368 368 378 107 108 109 380 368 827 829 368 368 368 368 368 368 368 368 368 368 368 368 368 368 368
113 113 380 368 429 430 430 411 414 405 406 407 414 414 414 414 414 414 414 414 414 414 414 414 358 123 124 169 169 169 169 169 125 113 113 138 414 439 368 368 368 368 368 368 368 368 368 368 368 368 368 368 546 545 368 368 368 378 115 113 117 380 368 381 382 368 368 368 368 368 368 368 368 368 368 368 368 368 368 368
121 121 388 368 437 405 406 406 406 389 292 415 420 446 446 419 414 414 414 414 414 414 414 414 366 145 145 145 145 145 145 145 145 121 121 367 414 439 368 368 368 429 430 430 430 430 431 368 368 368 368 368 546 336 337 368 368 378 115 113 117 830 829 368 368 368 368 368 368 368 368 368 368 368 368 368 368 368 368 368
827 829 546 546 437 413 163 129 164 292 398 423 439 368 368 445 446 419 414 414 414 414 414 414 414 420 446 446 360 361 446 446 446 446 446 446 446 447 368 368 368 437 405 406 406 407 439 368 368 368 368 368 546 344 345 368 368 378 123 137 117 113 380 368 368 368 368 368 368 368 368 368 368 368 368 368 368 368 368 368
381 382 368 368 437 413 136 113 191 164 415 414 439 368 368 368 368 445 419 414 414 414 420 446 446 447 368 368 344 345 336 337 368 368 368 368 336 337 368 368 368 437 413 163 130 415 439 368 368 368 368 368 546 546 545 368 368 386 137 115 117 113 380 368 368 368 368 368 368 368 368 368 368 368 368 368 368 368 368 368
828 829 368 368 437 413 171 416 121 172 415 420 447 368 368 368 368 368 445 446 446 446 447 368 368 368 368 368 368 368 344 345 336 337 368 368 344 345 368 368 368 437 413 171 172 415 439 368 368 368 368 368 368 368 545 827 829 368 378 123 125 116 388 368 336 337 368 368 368 368 368 368 368 368 368 368 368 368 368 368
113 380 368 368 437 421 422 422 422 422 423 439 368 368 368 368 368 368 368 368 368 368 368 368 368 368 368 368 368 368 368 368 344 345 368 368 368 368 368 368 368 437 421 422 422 423 439 368 368 368 368 368 368 368 546 381 382 368 386 121 121 388 368 368 344 345 368 368 368 368 368 368 368 368 368 368 368 368 368 368
113 380 368 368 445 419 414 414 414 414 420 447 368 368 368 368 368 368 368 368 429 430 430 430 430 430 430 431 368 368 368 368 368 368 368 368 368 368 368 368 368 445 446 446 446 446 447 368 368 368 368 368 368 368 546 545 368 368 368 827 829 368 368 368 368 368 368 368 368 368 368 368 368 368 368 368 368 368 368 368
113 380 368 368 368 445 446 446 446 446 447 368 368 368 368 368 368 368 368 368 437 405 406 406 406 406 407 412 431 368 368 368 368 368 368 368 368 368 368 368 368 368 368 368 368 368 368 368 368 368 368 368 368 368 546 545 368 368 368 381 382 368 368 368 368 368 368 368 368 368 368 368 368 368 368 368 368 368 368 368
113 380 368 368 368 368 368 368 368 368 368 368 368 368 368 368 368 368 368 368 437 413 163 129 129 130 415 414 439 368 368 368 368 368 368 368 368 368 368 368 368 368 368 368 368 368 368 368 368 368 368 368 368 368 368 368 368 368 368 368 368 827 829 368 368 368 368 368 368 368 368 368 368 368 368 368 368 368 368 368
113 380 368 368 368 368 368 368 368 368 368 368 368 368 368 368 368 368 368 368 437 413 136 113 113 138 415 414 439 368 368 368 368 368 368 368 368 368 368 368 368 368 368 368 368 368 368 368 368 368 368 368 368 336 337 368 368 368 368 368 368 381 382 368 368 336 337 368 368 368 368 368 368 368 368 368 368 368 368 368
113 380 827 829 368 368 368 368 368 368 368 368 368 368 368 368 368 368 368 368 437 413 171 137 113 138 415 414 439 368 368 368 368 368 368 368 368 368 368 368 368 368 368 368 368 368 368 368 368 368 368 368 368 344 345 368 368 368 368 368 368 368 827 828 829 344 345 368 368 368 368 368 368 368 368 368 368 368 368 368
113 380 381 382 368 368 368 368 368 368 368 368 368 368 368 368 368 368 368 368 437 421 397 171 416 172 415 414 439 368 368 368 368 368 368 368 368 368 368 368 336 337 368 368 368 368 368 368 368 368 368 368 368 368 368 368 368 368 368 368 827 829 378 113 380 368 368 368 368 368 368 368 368 368 368 368 368 368 368 368
113 380 368 368 827 829 368 368 368 368 368 368 368 368 368 368 368 368 368 368 445 419 421 422 422 422 423 420 447 368 546 546 546 546 546 368 368 368 368 368 344 345 368 368 368 368 368 368 368 368 368 368 368 368 336 337 368 368 336 337 381 382 386 121 388 368 368 368 368 368 368 368 368 368 368 368 368 368 368 368
113 380 368 368 381 382 368 368 368 368 368 368 368 368 368 368 368 368 368 368 368 445 446 419 414 414 420 447 546 546 546 546 546 546 546 546 546 546 368 368 368 336 337 368 368 368 368 368 368 368 368 368 336 337 344 345 336 337 344 345 368 368 368 368 368 368 368 368 368 368 368 368 368 368 368 368 368 368 368 368
113 380 368 368 368 827 828 828 828 828 828 829 368 368 368 368 368 368 368 368 368 368 368 445 446 446 447 368 546 546 545 545 546 546 546 546 546 546 368 368 368 344 345 368 368 368 368 368 368 368 368 368 344 345 368 368 344 345 368 368 368 368 368 368 368 368 368 368 368 368 368 368 368 368 368 368 368 368 368 368
116 388 368 368 827 830 113 107 108 113 109 830 828 828 829 368 368 368 368 368 827 829 368 368 368 368 368 368 368 368 368 368 546 546 546 546 546 546 368 368 368 368 368 368 368 368 368 368 368 368 368 336 337 368 368 368 368 368 368 368 368 368 368 368 368 368 368 368 368 368 368 368 368 368 368 368 368 368 368 368
388 368 368 368 378 113 113 115 113 113 117 113 113 113 380 368 368 368 368 368 381 382 368 368 368 368 368 368 368 368 368 368 368 368 368 546 546 546 368 368 368 368 368 368 368 368 368 368 368 368 368 344 345 368 368 368 336 337 368 368 368 368 368 368 368 368 368 368 368 368 368 368 368 368 368 368 368 368 368 368
368 368 368 368 378 113 113 115 113 113 117 113 113 113 380 368 368 827 828 829 368 827 829 368 368 368 368 368 368 368 368 368 368 368 368 546 546 546 368 368 368 368 368 368 368 368 368 368 368 368 368 368 827 829 368 368 344 345 368 368 368 368 368 368 368 368 368 368 368 368 368 368 368 368 368 368 368 368 368 368
368 368 368 368 378 113 113 115 113 113 117 113 113 113 380 336 337 378 113 380 368 381 382 368 368 368 368 368 368 368 368 368 368 368 368 546 546 546 368 368 368 368 368 368 368 368 368 368 368 368 368 368 381 382 368 368 368 368 368 368 368 368 368 368 368 368 368 368 368 368 368 368 368 368 368 368 368 368 368 368