Route130_Layout (80x40)
368 368 368 368 368 368 368 368 368 368 368 368 368 368 368 368 368 368 368 368 368 368 368 368 368 368 368 368 368 368 368 368 368 368 368 368 368 368 368 368 368 368 368 368 368 368 368 368 368 368 368 368 368 368 368 368 368 368 368 368 368 368 368 368 368 368 368 368 368 368 368 368 368 368 368 368 368 368 368 368
368 368 368 368 368 368 368 368 368 368 368 368 368 368 368 368 368 368 368 368 368 368 368 368 368 368 368 368 368 368 368 368 368 368 368 368 368 368 368 368 368 368 368 368 368 368 368 368 368 368 368 368 368 368 368 368 368 368 368 368 368 368 368 368 368 368 368 368 368 368 368 368 368 368 368 368 368 368 368 368
368 368 368 368 368 368 368 368 368 368 368 368 368 368 368 368 368 368 368 368 368 368 368 368 368 368 368 368 368 368 368 368 368 368 368 368 368 368 368 368 368 368 368 368 368 368 368 368 368 368 368 368 368 368 368 368 368 368 368 368 368 368 368 368 368 368 368 368 368 368 368 368 368 368 368 368 368 368 368 368
368 368 368 368 368 368 368 368 368 368 368 368 368 368 368 368 368 368 368 368 368 368 368 368 368 368 368 368 368 368 368 368 368 368 368 368 368 368 368 368 368 368 368 368 368 368 368 368 368 368 368 368 368 368 368 368 368 368 368 368 368 368 368 368 368 368 368 368 368 368 368 368 368 368 368 368 368 368 368 368
368 368 368 368 368 368 368 368 368 368 368 368 368 368 368 368 368 368 368 368 368 368 368 368 368 368 368 368 368 368 368 368 368 368 368 368 368 368 368 368 368 368 368 368 368 368 368 368 368 368 368 368 368 368 368 368 368 368 368 368 368 368 368 368 368 368 368 368 368 368 368 368 368 368 368 368 368 368 368 368
368 368 368 368 368 368 368 368 368 368 368 368 368 368 368 368 368 368 368 368 368 368 368 368 368 368 368 368 368 368 368 368 368 368 368 368 368 368 368 368 368 368 368 368 368 368 368 368 368 368 368 368 368 368 368 368 368 368 368 368 368 368 368 368 368 368 368 368 368 368 368 368 368 368 368 368 368 368 368 368
368 368 368 368 368 368 368 368 368 368 368 368 368 368 368 368 368 368 368 368 368 368 368 368 368 368 368 368 368 368 368 368 368 368 368 368 368 368 368 368 368 368 368 368 368 368 368 368 368 368 368 368 368 368 368 368 368 368 368 368 368 368 368 368 368 368 368 368 368 368 368 368 368 368 368 368 368 368 368 368
368 368 368 368 368 370 379 379 379 379 379 379 374 368 368 368 368 368 368 368 368 368 368 368 368 368 368 368 368 368 368 368 368 368 368 368 368 368 368 368 368 368 368 368 368 368 368 368 368 368 368 368 368 368 368 368 368 368 368 368 368 368 368 368 368 368 368 368 368 368 368 368 368 368 368 368 368 368 368 368
368 368 368 368 370 180 113 107 108 108 109 113 180 374 368 368 368 368 373 374 368 368 368 368 368 368 368 368 368 368 368 368 368 368 368 368 368 368 368 368 368 368 368 368 368 368 368 368 368 368 368 368 368 368 368 368 368 368 368 368 368 368 368 368 368 368 368 370 379 379 379 379 379 379 379 374 368 368 368 368
368 368 368 373 180 113 107 180 113 113 117 113 113 380 373 374 368 368 381 382 368 373 379 374 368 368 368 368 368 368 368 368 368 368 368 368 368 368 368 368 368 368 368 368 368 368 368 368 368 368 368 368 368 368 368 368 368 368 368 368 368 368 368 368 373 379 379 180 113 107 108 108 108 109 113 180 374 368 368 368
368 373 374 386 137 113 123 124 124 124 125 113 116 388 381 382 368 368 368 368 368 378 113 380 368 368 368 368 373 374 373 374 368 368 368 368 368 368 368 368 368 368 368 368 368 368 368 368 368 368 368 368 368 368 368 368 368 368 368 368 368 368 368 368 378 113 113 113 107 190 107 108 109 190 109 113 180 374 368 368
368 381 382 368 386 121 137 113 113 113 116 121 388 368 368 373 379 379 374 368 368 386 121 388 368 368 336 337 381 382 381 382 368 368 368 368 368 368 368 368 368 368 368 368 368 368 368 368 368 368 368 368 368 368 368 368 368 368 368 368 368 368 373 374 378 113 113 113 115 113 123 124 125 113 117 113 113 380 368 368
336 337 368 368 368 368 386 121 121 121 388 368 368 368 368 378 113 113 380 368 336 337 368 368 373 374 344 345 368 368 368 368 336 337 368 368 368 368 368 368 368 368 368 368 368 368 368 368 368 368 368 368 368 368 368 368 368 368 368 368 373 374 381 382 386 137 113 113 123 137 113 113 113 116 125 113 116 388 368 368
344 345 368 368 368 373 374 368 368 368 368 368 368 373 374 386 121 121 388 368 344 345 368 368 381 382 368 368 368 368 368 368 344 345 368 368 368 368 368 368 368 368 368 368 368 368 368 368 368 368 368 368 368 368 368 336 337 368 368 368 381 382 368 368 368 386 121 137 113 123 124 124 124 125 113 116 388 368 373 374
379 374 368 368 368 381 382 368 368 368 368 368 368 381 382 368 368 368 336 337 368 368 368 368 368 368 368 368 368 368 368 368 368 370 379 374 368 368 368 368 368 368 368 368 368 368 368 368 368 368 368 368 368 368 368 344 345 373 379 379 374 368 368 368 336 337 368 386 121 145 145 145 145 145 121 388 368 368 381 382
113 380 368 368 368 368 368 368 368 368 368 368 336 337 368 368 368 368 344 345 368 368 336 337 368 368 368 368 368 368 368 373 379 180 113 180 379 374 368 368 368 368 368 368 368 368 368 368 368 368 368 368 368 373 374 373 379 180 113 113 380 368 368 368 344 345 368 368 368 368 368 368 368 368 373 374 368 368 368 368
121 388 368 368 368 368 368 368 368 368 368 368 344 345 368 368 368 368 368 368 368 368 344 345 368 368 368 368 368 373 374 386 137 113 113 113 113 180 374 368 368 368 368 368 368 368 368 368 368 368 368 368 368 381 382 378 113 113 113 116 388 368 368 368 368 368 368 368 368 368 368 368 368 368 381 382 368 368 368 368
368 368 368 368 368 368 368 368 368 368 368 368 368 368 368 368 368 368 368 368 373 374 368 368 368 368 368 368 368 381 382 368 386 121 121 121 121 121 388 373 374 368 368 368 368 368 368 373 379 379 374 368 373 374 368 386 121 121 121 388 373 374 368 368 368 368 368 368 373 374 368 368 368 368 368 368 368 368 368 368
368 368 373 374 368 368 368 368 368 368 368 368 368 368 368 368 373 379 379 374 381 382 368 368 368 368 368 368 368 368 368 368 368 368 368 368 368 368 368 381 382 368 368 368 373 379 379 180 107 109 180 374 381 382 368 368 368 368 368 368 381 382 368 368 368 368 368 368 381 382 368 368 368 368 368 368 368 368 368 368
368 368 381 382 373 379 374 368 368 368 368 368 368 368 373 374 386 121 121 388 368 368 368 368 368 368 368 368 368 368 368 368 368 368 368 368 368 368 368 368 373 374 368 368 378 113 113 113 123 125 113 380 368 373 374 368 368 368 368 368 368 368 368 368 368 368 368 368 368 368 368 368 368 368 368 368 368 368 368 368
373 374 368 368 378 116 388 368 368 368 368 368 368 368 381 382 368 368 368 368 368 368 368 368 368 368 368 368 368 368 368 368 368 368 368 368 368 368 368 368 381 382 336 337 386 121 121 137 113 113 116 388 368 381 382 368 368 368 368 368 368 368 368 368 368 368 368 368 368 368 368 368 368 368 368 368 368 368 368 368
381 382 368 368 386 388 368 368 368 368 368 368 368 368 368 368 368 368 368 368 368 368 368 368 368 368 368 368 368 368 368 368 368 368 368 368 368 368 368 368 368 368 344 345 368 368 368 386 121 121 388 368 368 368 368 368 368 368 368 368 368 368 368 368 368 368 368 368 368 368 368 368 368 368 368 368 368 368 368 368
368 368 368 368 368 368 368 368 368 368 368 368 368 368 368 368 368 368 368 368 368 368 368 368 368 368 368 368 368 368 368 368 368 368 368 368 368 368 368 368 368 368 368 368 368 368 368 368 368 368 368 368 368 368 368 368 368 368 368 368 368 368 368 368 368 368 368 368 368 368 368 368 368 368 368 368 368 368 368 368
368 368 368 368 368 368 368 368 368 368 368 368 368 368 368 368 368 368 368 368 368 368 368 368 368 368 368 368 368 368 368 368 368 368 368 368 368 368 368 368 368 368 368 368 368 368 368 368 368 368 368 368 368 368 368 368 368 368 368 368 368 368 368 368 368 368 368 368 368 368 368 368 368 368 368 368 368 368 368 368
368 368 368 368 368 368 368 368 368 368 368 368 368 368 368 368 368 368 368 368 368 368 368 368 368 368 368 368 368 368 368 368 368 368 368 368 368 368 368 368 368 368 368 368 368 368 368 368 368 368 368 368 368 368 368 368 368 368 368 368 368 368 368 368 368 368 368 368 368 368 368 368 368 368 368 368 368 368 368 368
368 368 368 368 368 368 368 368 368 368 368 368 368 368 368 368 368 368 368 368 368 368 368 368 368 368 368 368 368 368 368 368 368 368 368 368 368 368 368 368 368 368 368 368 368 368 368 368 368 368 368 368 368 368 368 368 368 368 368 368 368 368 368 368 368 368 368 368 368 368 368 368 368 368 368 368 368 368 368 368
368 368 368 368 368 368 368 368 368 368 368 368 368 368 368 368 368 368 368 368 368 368 368 368 368 368 368 368 368 368 368 368 368 368 368 368 368 368 368 368 368 368 368 368 368 368 368 368 368 368 368 368 368 368 368 368 368 368 368 368 368 368 368 368 368 368 368 336 337 368 368 368 368 368 368 368 373 374 368 368
368 368 368 368 368 368 368 368 368 368 368 368 368 368 368 368 368 368 368 368 368 368 368 368 368 368 368 368 368 368 368 368 373 379 374 368 368 368 368 368 368 368 368 368 368 368 368 368 368 368 368 368 368 368 368 368 368 368 368 368 368 368 368 368 336 337 368 344 345 368 368 370 379 379 379 374 381 382 368 368
373 379 379 374 368 368 368 368 368 368 368 368 368 368 368 368 368 368 368 368 368 368 368 368 368 368 368 368 368 368 368 368 378 113 380 373 374 368 368 368 368 368 368 368 368 368 368 368 368 368 368 368 368 368 368 368 368 368 368 368 368 368 368 368 344 345 368 368 368 370 379 180 113 113 113 180 374 368 373 374
180 113 113 380 368 368 368 368 368 368 368 368 368 368 368 368 368 368 368 368 368 368 368 368 368 368 368 368 368 368 373 374 386 121 388 381 382 368 368 368 368 368 368 368 368 368 368 368 368 368 368 368 368 368 368 368 368 368 368 368 368 368 368 368 368 368 373 379 379 180 113 113 113 113 113 113 180 374 381 382
113 113 116 388 368 336 337 368 368 368 368 368 368 368 368 368 368 368 368 368 368 368 368 368 368 368 368 368 373 374 381 382 368 368 368 368 368 368 368 368 368 368 368 368 368 368 368 368 368 368 368 368 368 368 368 368 368 368 373 374 368 373 374 368 368 368 386 137 113 113 113 113 113 113 113 113 113 180 374 368
121 121 388 373 374 344 345 336 337 373 379 374 368 373 374 368 368 368 368 368 368 368 336 337 368 368 368 368 381 382 368 368 368 368 368 368 368 368 368 368 368 368 368 368 368 368 368 368 368 368 368 368 368 368 368 368 368 368 381 382 368 381 382 368 368 368 368 386 121 137 113 113 113 113 113 113 116 121 388 368
368 368 368 381 382 368 368 344 345 386 121 388 368 381 382 368 368 368 368 368 368 368 344 345 373 379 379 379 374 368 368 368 373 374 368 368 368 368 368 368 368 368 368 368 368 368 368 368 368 368 368 368 368 368 368 368 336 337 368 373 374 368 373 379 379 379 374 368 368 386 121 121 121 121 121 121 388 336 337 368
368 368 368 368 368 368 368 368 368 368 368 368 373 374 368 336 337 368 368 368 373 374 368 368 378 113 113 113 180 379 374 368 381 382 368 368 368 368 368 368 373 374 368 368 368 368 368 368 368 368 368 368 368 368 368 368 344 345 368 381 382 368 386 137 113 113 180 374 368 368 368 368 368 368 368 368 368 344 345 373
368 368 368 368 368 368 368 368 368 368 368 368 381 382 368 344 345 373 379 374 381 382 373 374 386 121 121 137 113 113 180 374 368 373 374 368 368 368 336 337 381 382 368 368 368 368 368 368 368 336 337 368 368 368 368 370 379 379 379 374 368 368 368 386 137 116 121 388 368 368 368 368 368 368 368 368 368 368 368 381
368 368 368 368 368 336 337 368 368 368 368 368 368 368 368 368 368 378 113 380 368 368 381 382 368 368 368 386 121 121 121 388 368 381 382 336 337 368 344 345 368 368 373 379 379 374 368 373 374 344 345 368 368 370 379 180 113 107 109 180 374 368 368 368 386 388 368 368 368 368 368 368 368 368 368 368 368 368 368 368
368 368 368 368 368 344 345 368 368 368 368 368 368 368 368 368 368 386 121 388 368 368 368 368 368 368 368 368 368 368 368 368 368 368 368 344 345 373 374 368 368 368 386 137 113 180 374 381 382 368 373 379 379 180 107 108 109 123 125 113 380 368 368 368 368 368 368 368 368 368 368 368 368 368 368 368 368 368 368 368
368 368 368 368 368 368 368 368 368 368 368 368 368 368 368 368 368 368 368 368 368 368 368 368 368 368 368 368 368 368 368 368 368 368 368 368 368 381 382 368 368 368 368 386 121 121 388 368 368 368 386 137 113 113 123 124 125 113 113 116 388 368 368 368 368 368 368 368 368 368 368 368 368 368 368 368 368 368 368 368
368 368 368 368 368 368 368 368 368 368 368 336 337 368 368 368 368 368 368 368 368 368 368 368 368 368 368 368 368 368 368 368 368 368 368 368 368 368 368 368 368 368 368 368 368 368 368 368 336 337 368 386 121 121 145 145 145 121 121 388 368 368 368 368 368 368 368 368 368 368 368 368 368 368 368 368 368 368 368 368
368 368 368 368 368 368 368 368 368 368 368 344 345 368 368 368 368 368 368 368 368 368 368 368 368 368 368 368 368 368 368 368 368 368 368 368 368 368 368 368 368 368 368 368 368 368 368 368 344 345 368 368 368 368 368 368 368 368 368 368 368 368 368 368 368 368 368 368 368 368 368 368 368 368 368 368 368 368 368 368