Route119_Layout (40x140)
199 199 199 199 199 199 199 199 199 199 199 199 23 23 23 380 518 518 378 199 199 199 199 199 199 199 199 199 199 199 199 199 199 199 199 199 198 199 198 199
199 199 199 199 727 735 735 743 199 199 199 199 116 121 121 388 518 518 378 199 199 199 199 199 199 199 199 199 199 199 199 199 199 199 199 199 199 199 199 199
199 199 199 199 624 625 625 626 23 23 23 23 380 518 518 518 518 518 378 199 199 199 199 199 199 199 199 199 198 198 198 198 198 198 198 199 199 199 199 199
199 199 199 199 14 14 14 1 116 121 121 121 388 518 518 518 518 518 378 198 199 199 199 199 199 199 199 199 199 198 198 198 198 198 198 198 198 199 199 199
199 199 199 199 199 199 23 1 380 518 518 518 518 518 518 518 518 518 378 22 199 199 199 22 22 22 22 22 198 198 198 198 198 198 198 22 22 199 199 199
199 199 199 199 199 23 1 1 240 241 241 518 518 518 518 518 518 518 378 1 199 199 199 331 332 332 332 333 198 22 198 22 198 22 22 1 1 23 22 23
199 199 199 199 23 1 1 1 248 245 237 518 518 518 518 518 518 518 378 1 199 199 199 742 276 276 276 277 23 1 22 1 22 1 1 1 1 1 1 1
199 199 199 199 116 236 121 121 388 368 251 241 241 241 241 241 241 241 242 1 199 199 199 199 15 15 1 1 1 1 1 280 281 281 281 281 281 282 1 1
199 199 199 23 380 244 518 518 518 518 245 245 245 245 245 245 245 245 250 1 199 199 199 199 199 199 15 1 1 1 280 289 289 289 297 297 297 298 1 1
199 23 23 116 388 244 518 518 518 518 518 518 518 518 518 518 518 518 378 1 22 199 199 199 199 199 199 15 27 1 288 289 289 290 1 1 1 1 1 1
199 116 121 388 518 244 243 243 243 247 518 241 241 241 241 241 241 241 242 1 1 199 198 199 199 199 199 199 1 1 288 289 289 298 1 14 14 15 15 15
199 380 518 518 518 252 252 252 252 244 518 245 245 245 245 245 245 245 250 1 1 199 199 199 199 199 199 199 1 1 288 289 290 1 1 199 199 199 199 199
199 380 518 518 518 518 518 518 518 244 518 518 518 518 518 518 518 518 378 1 1 199 198 198 199 198 199 199 15 1 288 289 290 1 15 199 199 199 199 199
199 29 29 29 29 29 29 372 518 244 518 518 518 518 518 518 518 518 378 1 1 199 199 199 199 199 198 199 198 1 288 289 290 15 198 198 198 199 199 199
199 199 199 727 735 735 743 380 518 244 518 518 518 518 518 518 518 518 386 137 1 199 199 199 199 198 199 199 198 280 289 289 298 199 198 198 198 199 199 199
199 199 199 624 625 625 626 380 518 244 518 519 519 519 519 518 518 518 518 378 1 199 199 199 199 199 199 199 23 288 289 290 15 199 198 198 199 199 199 199
199 199 199 15 15 15 1 2 2 2 2 199 199 199 199 372 518 253 241 242 1 199 199 199 199 198 199 199 1 288 289 290 199 199 198 198 199 199 199 199
199 199 199 199 199 199 15 1 1 1 1 199 199 23 23 380 518 237 245 250 1 199 199 199 199 199 198 198 1 288 289 290 23 199 199 198 199 199 199 198
199 199 199 199 199 199 199 1 1 1 1 199 23 1 1 240 241 251 368 386 137 199 199 199 199 199 198 23 1 288 289 298 1 198 199 199 199 199 199 199
199 199 199 199 199 199 199 135 135 135 214 23 1 1 1 248 245 245 368 368 378 199 199 199 199 198 199 3 1 288 290 1 1 199 199 199 199 199 199 198
199 199 199 199 199 199 199 1 1 1 1 1 1 1 1 380 368 368 368 368 378 199 199 199 199 199 198 1 280 289 290 1 1 23 23 199 199 199 198 199
199 199 199 199 199 199 199 1 1 1 1 1 1 1 1 380 212 377 368 368 378 199 199 198 198 199 22 1 288 289 290 1 21 21 21 23 199 198 199 198
199 199 199 199 199 199 199 259 260 260 261 1 116 175 207 122 1 400 368 368 378 199 199 199 199 198 1 1 288 289 298 1 21 21 21 21 23 198 198 199
23 23 23 23 23 23 23 667 659 660 668 1 380 1 1 1 1 400 368 368 378 22 22 22 22 22 1 280 289 290 1 21 21 641 642 643 21 198 198 198
124 124 124 124 124 124 124 124 124 124 124 124 122 1 1 1 1 400 368 368 123 124 124 124 124 137 1 288 289 290 1 21 21 624 625 626 21 198 198 198
169 169 169 169 169 169 169 169 169 169 137 113 116 124 124 124 124 187 179 179 124 169 169 169 137 115 1 288 289 298 1 520 520 21 21 21 520 198 198 198
206 145 729 730 672 673 674 672 673 676 677 124 125 116 169 169 169 185 185 185 169 169 169 137 115 123 124 175 207 124 124 124 137 520 520 520 14 198 198 198
199 736 737 738 739 680 680 680 683 684 685 686 145 122 116 169 169 185 185 185 169 169 137 115 120 145 145 175 207 145 145 137 115 14 14 14 198 198 198 198
199 744 745 746 747 680 680 680 691 692 693 694 1 1 117 116 432 185 185 185 145 137 115 115 1 1 280 289 290 1 1 112 115 22 198 198 198 198 198 198
199 752 753 754 688 689 690 688 689 700 701 702 1 1 117 114 1 44 52 60 1 112 115 115 1 280 289 289 298 1 1 112 123 137 198 198 198 198 198 198
199 760 761 762 696 697 698 696 697 708 709 710 1 1 117 114 1 400 368 402 1 112 115 115 1 288 289 298 1 1 1 112 113 115 22 198 198 198 198 198
199 768 769 770 704 705 706 704 705 716 717 718 1 1 117 117 392 408 368 410 394 115 115 120 121 175 207 121 121 121 137 123 137 123 137 198 198 198 198 198
199 199 777 778 712 713 714 712 713 724 725 726 1 1 117 117 400 368 368 368 402 115 115 1 280 281 282 1 1 1 112 113 123 137 115 22 22 22 22 22
199 199 199 1 720 721 722 720 721 3 1 1 1 1 766 529 534 528 528 528 535 533 766 1 288 289 289 282 1 1 120 121 137 115 123 124 124 124 124 124
23 23 23 1 1 280 281 282 1 1 1 1 1 1 774 537 542 536 536 536 543 541 774 1 296 289 289 290 1 1 1 1 112 123 124 169 169 169 169 169
104 105 105 105 106 288 289 289 282 1 1 1 1 1 117 117 614 369 369 369 615 115 115 1 1 296 297 298 1 1 1 1 120 206 206 206 206 206 206 206
112 113 113 113 114 296 289 289 298 1 1 21 21 21 117 117 614 369 369 369 615 115 123 124 175 207 121 121 121 137 1 1 14 198 198 198 198 198 198 199
112 113 113 113 191 106 296 298 1 1 1 21 21 21 117 117 400 368 368 368 402 123 169 137 1 1 1 1 1 112 1 14 198 198 198 198 198 198 198 198
732 733 137 113 113 191 106 1 1 1 1 21 21 21 117 117 400 368 368 368 410 393 385 115 1 1 1 1 1 112 1 198 198 198 198 198 198 198 198 199
199 199 112 113 113 113 114 1 1 1 1 21 21 21 117 117 400 368 368 368 368 368 402 115 1 1 1 1 1 120 137 22 22 22 22 22 22 22 22 22
199 199 732 137 113 113 114 1 1 1 1 520 21 21 117 117 400 368 368 368 368 368 402 115 1 1 1 1 1 1 120 124 124 124 124 124 124 124 124 124
199 199 199 732 733 733 734 21 21 1 1 1 520 520 117 117 400 368 368 368 368 368 402 123 121 175 733 733 733 733 206 206 206 206 206 206 206 206 206 206
199 199 199 199 198 199 199 21 21 21 1 1 1 1 117 117 400 368 368 368 368 368 410 394 1 1 22 22 22 22 22 198 198 198 198 198 198 198 198 199
23 23 23 198 198 199 199 21 21 21 21 21 1 1 117 117 400 368 368 368 368 368 368 410 393 393 393 393 393 393 394 22 22 198 198 198 198 198 198 198
124 124 137 198 198 199 199 21 21 21 21 21 21 1 620 620 620 620 620 372 368 368 368 368 368 368 368 368 368 368 410 393 394 198 198 198 198 198 198 198
206 137 115 198 199 198 199 21 21 21 21 21 21 21 1 1 1 1 1 620 372 368 368 368 368 368 368 368 368 368 368 368 402 22 22 198 198 198 198 198
198 112 115 198 198 198 199 21 21 21 21 21 21 21 21 21 1 1 1 1 620 620 620 372 368 368 368 368 368 368 368 368 410 393 394 22 198 198 198 198
198 112 115 198 198 198 198 21 21 21 21 21 21 21 21 21 1 1 1 1 1 1 1 621 401 401 401 372 403 403 368 368 368 368 402 1 198 198 198 199
198 112 115 198 198 198 198 21 21 21 21 21 21 520 520 520 1 1 116 124 124 175 207 125 113 113 113 114 198 198 403 368 368 368 402 1 198 198 198 198
198 112 115 23 23 198 198 21 21 21 520 520 520 1 1 1 1 1 621 113 113 113 113 113 113 113 113 114 198 198 198 377 368 368 410 394 22 198 198 198
198 112 123 124 137 23 23 520 520 520 1 1 1 1 1 116 124 124 125 113 113 113 113 113 113 116 121 122 198 198 198 400 368 368 336 357 1 198 198 198
198 120 206 137 115 1 1 1 1 1 1 1 1 1 1 621 113 113 113 113 113 113 113 113 116 122 21 21 23 198 198 400 368 368 344 365 1 198 198 198
198 15 198 112 115 1 1 1 1 1 116 124 124 124 124 125 113 113 113 113 113 113 116 121 122 21 21 21 21 23 198 400 368 368 368 402 1 198 198 198
198 198 198 112 115 1 1 1 1 116 125 113 113 116 145 145 121 121 175 207 121 121 122 1 1 21 21 21 21 1 198 400 368 368 368 402 14 198 198 198
198 198 198 112 123 740 232 741 124 125 113 116 121 122 21 21 21 1 1 1 15 15 15 15 15 520 21 21 21 15 198 356 337 368 368 402 198 198 198 198
198 198 198 120 145 748 232 749 145 145 121 122 21 21 21 21 21 21 1 15 198 198 198 198 198 15 520 520 520 198 198 364 345 368 368 402 198 198 198 198
198 198 198 1 1 1 1 1 15 15 15 21 21 21 21 21 21 21 1 198 198 198 198 198 198 198 15 15 15 198 198 400 368 368 368 402 198 198 198 198
198 198 198 15 1 200 202 1 198 198 198 520 21 21 21 21 21 21 15 198 198 198 198 198 198 198 198 198 198 198 23 400 368 368 368 402 198 198 198 198
198 198 198 198 200 209 218 1 198 198 198 15 21 21 21 21 21 21 198 198 198 198 198 198 198 198 198 23 23 23 392 408 368 368 368 402 22 198 198 198
198 198 198 198 216 218 1 1 198 198 198 198 21 21 21 21 21 21 198 198 198 198 198 198 198 198 23 392 393 393 408 368 368 368 376 2 1 22 22 198
198 198 198 198 15 1 1 1 23 198 198 198 21 21 21 21 21 520 198 198 198 198 198 198 198 198 392 408 368 368 368 368 368 376 2 14 21 21 21 22
198 198 198 198 198 1 200 202 1 198 198 198 520 21 21 21 21 15 198 198 198 198 198 198 198 198 400 368 368 368 368 368 336 357 14 198 21 21 21 21
198 198 198 198 198 15 216 218 1 23 198 198 15 21 21 21 21 198 198 198 198 198 198 198 198 198 400 368 368 368 368 368 344 365 198 198 21 21 520 21
198 198 198 198 198 198 15 1 1 1 198 198 198 21 21 21 520 198 198 198 198 198 198 198 23 23 400 368 368 368 368 368 376 2 198 198 520 21 21 21
198 198 198 198 198 198 198 1 1 1 198 198 23 21 21 21 15 198 198 198 198 198 198 198 392 393 408 368 368 376 2 2 2 21 22 198 14 520 520 520
198 198 198 198 198 198 198 1 1 1 23 23 1 21 21 21 198 198 198 198 198 198 23 23 400 368 368 368 376 2 1 21 21 21 21 199 198 14 14 14
198 198 198 198 198 198 198 1 1 1 1 1 1 21 21 520 198 198 198 198 198 198 392 393 408 368 368 368 402 1 14 21 21 21 520 199 198 198 198 198
198 198 198 198 198 198 198 1 1 1 1 200 202 520 520 15 198 198 198 198 198 198 400 368 368 368 368 368 402 14 199 21 21 21 14 199 198 198 198 198
23 23 23 198 198 198 198 15 1 1 1 216 218 1 1 198 198 198 198 198 23 23 400 368 368 368 376 2 2 199 199 21 21 520 199 199 198 198 198 198
124 124 137 198 198 198 198 198 21 21 21 1 1 1 15 198 198 198 198 198 392 393 408 368 368 368 402 1 14 199 22 21 21 14 198 199 198 198 198 198
169 137 115 23 198 198 198 198 21 21 21 21 21 21 198 198 198 198 198 198 400 368 368 368 368 376 2 14 199 22 21 21 21 199 199 199 198 198 198 198
137 115 123 137 198 198 198 198 21 21 21 21 21 21 198 198 198 198 198 198 400 368 368 368 368 402 1 199 199 21 21 21 21 198 199 199 199 198 198 198
112 115 113 115 198 198 198 23 21 21 21 21 21 520 198 198 198 198 198 198 400 368 368 368 368 402 14 198 198 21 641 642 643 199 199 199 199 199 199 199
112 115 113 115 198 198 198 1 520 21 21 21 21 15 198 198 198 198 198 198 400 368 368 376 2 2 199 199 199 520 624 625 626 199 199 199 199 199 199 199
112 115 113 115 198 198 198 1 1 520 21 21 520 198 198 198 198 198 23 23 212 400 336 357 1 1 198 198 198 14 14 14 14 199 199 199 199 22 22 22
112 123 137 115 198 198 23 1 1 1 520 520 15 198 198 198 198 198 30 31 1 400 344 365 14 1 198 199 199 199 198 199 198 199 199 198 199 116 124 124
112 113 115 115 198 23 1 200 202 1 1 1 198 198 198 198 198 198 38 39 1 356 337 652 198 1 199 199 199 199 199 198 198 198 198 199 199 117 116 124
112 113 115 115 23 1 1 216 218 1 1 1 198 198 198 198 198 198 14 14 14 364 345 652 198 14 199 198 198 198 199 199 199 199 199 199 199 117 117 116
112 113 115 115 1 1 1 1 1 1 1 1 23 23 23 23 23 23 23 23 23 651 518 652 22 22 22 22 22 22 22 22 22 22 199 199 199 117 117 114
112 113 115 115 1 1 1 1 1 116 124 124 124 124 124 124 124 124 124 124 124 187 179 188 124 124 124 124 124 124 124 124 124 137 22 199 199 117 117 114
112 113 115 123 124 175 207 124 124 125 116 169 169 169 169 169 169 169 169 169 169 185 185 185 169 169 169 169 169 169 137 113 113 123 137 199 199 117 117 114
112 113 115 113 113 113 113 116 124 124 125 113 116 145 145 145 432 145 206 206 169 185 185 185 169 145 432 145 206 137 123 124 124 137 115 22 22 117 117 114
112 113 115 113 113 113 113 117 113 116 145 121 122 1 1 1 1 4 199 199 116 185 185 185 137 1 1 1 199 546 206 206 137 115 123 121 121 125 117 114
112 113 115 113 113 113 113 117 113 114 14 14 14 1 14 14 14 14 199 199 380 52 52 52 699 14 1 1 199 199 199 199 112 115 113 113 113 113 117 114
112 113 115 113 113 113 113 529 529 529 532 532 532 531 532 532 532 532 532 532 529 528 528 528 533 532 531 531 532 532 532 532 533 533 113 113 113 113 117 114
120 137 115 113 113 113 113 537 537 537 540 539 539 539 540 540 540 540 540 540 537 536 536 536 541 540 539 539 540 540 540 540 541 541 113 113 113 113 117 114
15 112 123 124 124 124 124 125 113 114 580 580 580 1 580 580 580 580 580 580 380 527 527 527 707 580 1 1 22 580 580 580 112 115 113 113 113 116 125 114
199 120 206 206 206 206 145 145 124 122 23 23 23 1 23 199 199 199 199 199 380 527 527 527 707 199 14 1 1 22 22 22 112 115 113 113 113 117 113 114
199 15 199 727 735 743 21 21 1 1 1 200 202 1 1 23 199 199 199 199 380 518 518 518 378 199 199 1 1 1 1 1 112 123 137 113 113 117 113 114
199 199 199 624 625 626 21 21 1 1 1 216 209 202 1 1 23 23 23 23 380 518 518 518 378 199 199 1 259 260 260 261 112 113 123 175 207 125 116 122
199 199 199 15 21 21 21 21 15 15 1 1 216 218 1 1 1 1 116 121 388 518 518 518 378 199 22 1 667 659 660 668 112 113 113 113 113 113 114 1
199 199 199 199 520 520 520 520 199 199 15 1 1 1 1 1 1 1 240 241 241 241 518 518 378 22 1 1 1 104 105 105 190 113 113 113 113 113 114 14
199 199 199 199 15 15 15 15 199 199 199 15 15 1 1 15 15 15 248 245 249 237 518 518 378 1 1 1 1 112 113 113 113 113 113 113 113 113 114 199
199 199 199 199 199 199 199 199 199 199 199 199 199 15 15 199 23 23 380 518 518 237 518 518 378 1 1 1 1 112 113 113 113 113 113 113 113 113 114 199
199 199 199 199 199 199 199 199 199 199 199 199 199 199 199 199 116 121 388 518 518 251 241 241 242 1 1 1 1 112 113 113 113 113 113 113 113 113 114 199
198 199 199 199 23 22 23 23 23 23 23 199 199 199 199 199 380 518 518 518 518 245 249 245 250 1 1 21 21 112 113 113 113 116 733 733 733 733 547 199
199 199 23 22 1 1 21 21 21 21 21 23 199 23 23 23 380 518 518 518 518 518 518 518 378 1 21 21 21 112 113 113 113 114 199 199 199 199 199 199
198 198 21 21 21 21 21 21 21 21 21 21 23 116 121 121 388 518 518 518 518 518 518 518 386 137 21 21 21 120 175 207 121 547 199 199 199 199 199 199
199 198 520 520 21 21 21 21 21 21 21 21 1 380 368 336 337 518 518 336 337 518 518 336 337 378 21 21 21 21 280 282 14 199 199 199 199 199 199 199
198 198 15 15 520 21 21 21 21 21 21 520 1 380 368 344 345 336 337 344 345 336 337 344 345 378 21 21 21 21 288 290 199 199 199 199 199 199 199 199
199 198 199 199 15 520 641 642 643 520 520 1 1 380 368 368 368 344 345 368 368 344 345 368 368 378 21 21 21 520 288 290 22 199 199 199 199 199 199 199
198 199 198 198 199 15 624 625 626 1 1 1 1 380 368 368 368 368 368 368 368 368 368 368 368 378 21 21 520 1 288 290 1 199 199 199 199 199 199 199
198 198 198 198 198 198 15 1 1 1 1 1 1 138 285 368 368 368 368 368 368 368 368 368 368 378 520 520 1 1 288 290 1 22 22 22 22 22 22 22
198 199 199 199 198 198 198 15 15 1 116 175 207 146 293 368 368 368 368 368 368 368 368 368 368 386 733 733 121 121 175 207 121 733 733 733 733 733 733 733
199 199 198 198 198 198 198 198 23 1 380 292 292 292 293 368 368 368 368 368 368 368 368 368 368 376 199 199 1 1 288 290 14 199 199 199 199 199 199 199
198 198 198 23 23 23 23 23 116 121 146 292 292 292 293 368 368 368 368 368 368 368 368 368 368 402 199 23 1 1 288 290 199 199 199 199 199 199 199 199
199 199 23 116 121 121 121 121 388 300 300 300 300 300 301 368 368 368 368 368 368 336 337 368 368 402 23 1 1 1 288 290 8 9 9 10 199 199 199 199
198 198 116 388 518 336 337 368 368 368 368 368 368 368 368 368 368 368 368 368 368 344 345 368 368 402 1 1 1 280 289 290 16 17 17 18 199 199 199 199
199 199 380 518 518 344 345 336 337 368 368 368 368 368 368 368 368 368 368 368 368 368 368 368 368 402 1 1 280 289 289 290 24 25 11 26 199 199 199 199
198 198 380 518 518 518 518 344 345 368 368 368 368 368 368 368 368 368 368 368 368 368 368 376 2 2 1 280 289 289 289 298 32 33 19 34 199 199 199 199
23 23 380 518 518 518 336 337 368 368 368 368 368 403 403 403 403 368 368 376 2 2 2 2 1 1 280 289 289 289 298 1 1 1 1 1 22 199 199 199
121 121 388 518 518 518 344 345 368 403 403 403 403 199 199 199 199 2 2 2 1 1 1 1 280 281 289 289 289 290 1 1 1 1 1 1 1 22 199 199
518 518 518 518 518 336 337 403 403 199 199 199 199 199 199 199 23 1 1 1 280 281 281 281 289 289 289 289 297 298 1 1 1 21 21 21 21 21 199 199
518 518 518 518 518 344 345 199 199 199 199 199 199 199 199 23 1 1 280 281 289 289 289 297 297 297 297 298 1 1 21 21 21 21 21 21 21 21 199 199
519 519 519 519 519 519 519 199 199 199 199 199 199 199 23 1 1 1 296 297 297 297 298 1 21 21 21 21 21 21 21 21 21 21 21 21 21 21 199 199
199 199 198 199 199 199 199 199 199 199 199 23 23 23 1 1 1 1 1 21 21 21 21 21 21 21 21 21 21 21 21 21 21 21 21 21 21 21 198 198
199 199 199 198 199 198 198 198 198 198 23 1 1 1 1 1 21 21 21 21 21 21 21 21 21 21 21 21 21 21 21 21 21 520 21 21 21 21 22 199
199 199 199 198 199 198 198 198 198 23 21 21 21 21 21 21 21 21 21 21 21 21 21 21 21 21 21 21 21 21 21 21 21 1 21 21 21 21 21 198
199 199 199 198 199 198 198 198 198 21 21 21 21 21 21 21 21 21 21 520 520 520 520 21 21 21 21 21 21 21 21 21 21 21 21 21 21 21 21 198
199 199 199 198 198 198 198 23 23 21 21 21 21 21 21 21 21 21 21 21 21 21 21 21 21 21 21 21 21 21 21 21 21 21 21 21 21 21 21 198
199 199 198 198 198 198 23 21 21 21 21 21 520 520 21 21 21 520 520 520 520 520 21 21 21 21 520 21 21 21 21 21 21 21 21 21 21 21 21 22
199 199 198 198 198 23 21 21 21 21 21 21 1 1 21 21 520 14 14 14 14 1 520 21 21 21 21 21 21 21 21 21 21 21 21 21 21 21 21 21
199 199 199 198 23 21 21 21 21 21 21 21 21 21 21 21 1 199 199 199 199 14 1 21 21 21 21 21 21 21 21 21 21 21 21 21 21 21 21 21
199 199 198 198 21 21 21 21 21 21 21 21 21 21 21 21 1 199 198 198 199 199 1 21 21 21 21 21 21 21 21 21 21 21 21 21 21 21 21 21
199 199 198 198 21 21 21 21 520 520 520 21 21 21 21 21 21 22 22 198 199 198 1 21 21 21 21 21 21 520 520 21 21 21 21 21 21 21 21 21
199 199 198 23 21 21 21 21 21 21 21 21 21 21 21 21 21 21 21 22 22 22 21 21 21 21 21 21 520 14 14 520 21 21 21 21 21 21 21 21
199 199 198 21 21 21 21 21 21 21 21 21 21 21 21 21 21 21 21 21 21 21 21 21 21 21 21 21 1 199 199 14 520 21 21 21 21 21 21 520
199 199 198 21 21 21 21 21 21 21 21 21 21 21 21 21 21 21 21 21 21 21 21 21 21 21 21 21 1 198 198 199 1 21 21 21 21 21 21 14
199 199 23 21 21 21 21 21 21 21 21 21 21 21 21 21 21 21 21 21 21 21 21 21 21 21 21 21 21 22 22 22 1 21 21 21 21 21 520 198
199 199 21 21 21 21 520 520 21 21 21 21 21 21 21 21 21 21 21 21 520 520 520 21 21 21 21 21 21 21 21 21 21 21 21 21 21 520 14 198
199 199 520 520 520 21 21 21 21 21 21 21 21 21 21 21 21 21 21 21 21 21 21 21 21 21 21 21 21 21 21 21 21 21 520 520 520 14 198 198
199 199 14 14 14 520 520 520 520 520 520 520 520 520 21 21 21 21 21 21 21 21 21 21 21 21 520 520 520 520 520 520 520 520 1 14 14 198 198 198
199 199 199 199 199 14 14 14 14 14 1 1 1 1 520 520 520 520 520 520 520 520 520 520 520 520 1 1 14 14 14 14 14 14 14 198 198 198 198 198
199 199 199 199 199 199 199 199 199 199 14 14 14 14 14 1 1 1 1 1 1 1 14 14 14 14 14 14 198 198 198 198 198 198 198 198 198 198 198 198
199 199 199 199 199 199 199 199 199 199 199 199 199 199 199 14 1 1 1 1 1 14 198 198 198 198 198 198 198 198 198 198 198 198 198 198 198 198 198 198
199 199 22 22 199 199 199 199 199 199 22 22 199 199 198 198 1 280 281 282 1 22 22 199 199 199 199 199 199 199 199 199 22 22 22 22 198 198 198 198
199 22 104 105 191 191 191 191 191 191 105 106 22 199 22 198 1 288 289 290 1 104 105 191 191 191 191 191 191 191 191 191 105 105 105 106 22 22 22 22
199 104 115 113 107 108 108 108 108 108 109 191 105 191 106 22 1 288 289 290 1 112 107 108 108 108 108 108 108 108 108 108 108 108 109 191 105 105 105 106
199 112 115 113 115 113 113 113 113 113 191 109 113 113 117 106 1 288 289 290 1 112 115 107 108 108 108 108 108 108 108 108 108 109 191 108 108 108 109 114
199 112 115 113 115 113 113 113 113 113 113 117 113 113 117 114 14 288 289 290 15 112 115 115 113 113 113 113 113 113 113 113 113 191 108 108 108 109 117 114