Route132_Layout (80x40)
368 368 336 337 368 368 368 373 374 336 337 368 368 336 337 370 379 379 372 373 374 368 368 368 368 368 368 368 368 368 368 368 368 368 368 368 368 373 374 336 337 368 368 368 368 368 368 373 374 368 368 336 337 368 368 368 368 368 368 368 336 337 370 379 379 372 368 368 402 115 115 113 123 137 113 113 113 113 113 113
373 374 344 345 368 368 368 381 382 344 345 373 374 344 345 378 113 113 380 381 382 336 337 368 368 368 368 368 368 373 374 368 368 336 337 368 368 381 382 344 345 336 337 368 368 336 337 381 382 373 374 344 345 370 379 372 336 337 368 368 344 345 378 113 113 380 368 368 402 115 123 137 113 123 124 137 113 113 113 113
381 382 368 368 370 379 372 368 368 368 368 381 382 373 374 386 121 121 388 368 368 344 345 336 337 373 374 336 337 381 382 336 337 344 345 373 374 611 611 368 368 344 345 373 374 344 345 368 368 381 382 368 368 378 113 380 344 345 336 337 368 368 386 121 121 388 368 368 402 123 137 123 124 137 113 123 137 113 113 113
368 368 368 368 378 113 380 368 368 368 368 368 368 381 382 368 368 368 611 611 611 611 611 344 345 381 382 344 345 368 368 344 345 368 368 381 382 611 611 611 611 368 368 381 382 368 336 337 368 368 368 368 368 386 121 388 368 368 344 345 368 368 368 368 368 368 336 337 410 385 123 137 113 123 124 137 123 124 124 124
611 611 368 368 386 121 388 368 373 374 368 368 368 368 368 368 611 611 611 611 611 611 611 611 611 611 611 611 611 611 611 611 611 611 611 611 611 611 611 611 611 611 611 611 611 611 344 345 368 368 368 611 611 611 611 611 611 611 611 611 611 611 611 611 368 368 344 345 368 410 385 123 124 169 137 123 169 169 169 169
611 611 611 611 368 368 368 368 381 382 368 368 368 368 368 368 368 368 611 611 611 611 611 611 611 611 611 611 611 611 611 611 611 611 611 611 611 611 611 611 611 611 611 611 336 337 368 368 368 368 368 368 611 611 611 611 611 611 611 611 611 611 611 611 611 611 368 373 374 368 410 346 347 385 123 169 169 137 113 113
611 611 611 611 611 368 368 368 368 368 368 368 368 368 368 373 374 611 611 611 611 611 611 611 611 336 337 643 643 643 643 643 611 611 611 611 611 611 611 611 611 611 611 611 344 345 368 368 368 368 368 368 368 611 611 611 611 611 611 611 611 611 611 611 611 611 611 381 382 336 337 344 345 410 393 393 385 123 124 124
611 611 611 368 368 368 368 368 368 368 368 373 374 373 374 381 382 611 611 611 611 611 611 611 611 344 345 611 336 337 643 643 643 643 611 611 611 611 611 611 611 611 611 611 336 337 368 368 368 368 368 336 337 643 643 643 611 611 611 611 611 611 611 611 611 611 611 368 368 344 345 368 368 373 374 368 410 393 393 385
611 611 611 611 368 368 368 368 368 373 374 381 382 381 382 611 611 611 611 611 611 611 611 611 611 611 611 611 344 345 336 337 643 643 643 643 611 611 611 611 611 611 611 611 344 345 368 368 368 368 368 344 345 336 337 643 643 643 611 611 611 611 611 611 611 611 368 368 368 368 368 368 368 381 382 368 368 368 368 410
611 611 611 611 611 373 374 373 374 381 382 598 582 582 599 611 611 611 611 611 611 611 611 611 611 611 611 611 611 611 344 345 611 336 337 643 643 611 611 611 611 611 611 336 337 368 368 336 337 336 337 336 337 344 345 620 620 620 611 611 611 611 611 368 368 368 368 368 368 368 368 370 379 372 368 368 373 374 368 368
611 611 611 611 611 381 382 381 382 598 582 574 414 414 607 611 611 611 611 611 611 611 611 611 611 611 611 611 611 611 611 611 611 344 345 643 643 643 368 368 368 336 337 344 345 368 368 344 345 344 345 344 345 620 620 620 611 611 611 611 611 368 368 368 368 368 368 368 368 368 368 378 113 380 368 368 381 382 368 368
611 611 611 611 598 582 582 582 582 574 414 414 414 414 575 599 611 611 611 611 611 643 643 643 611 611 611 611 611 611 611 611 611 611 611 611 336 337 368 368 368 344 345 368 368 368 368 368 368 368 368 611 611 611 611 611 611 611 611 611 611 611 611 611 611 368 368 368 368 368 368 386 121 388 368 368 368 368 368 368
611 611 611 598 574 414 414 414 414 414 414 414 414 414 414 607 611 611 611 611 611 336 337 643 643 643 611 611 611 611 611 611 611 611 611 611 344 345 368 368 368 368 368 368 368 368 368 368 368 368 368 368 368 611 611 611 611 611 611 611 611 611 611 611 611 611 611 368 368 368 368 368 368 373 374 370 379 379 372 368
611 611 611 606 414 350 343 343 351 350 343 351 414 414 414 607 611 611 611 611 611 344 345 611 611 643 643 643 611 611 611 611 611 611 611 336 337 368 368 368 368 368 368 368 368 368 368 368 368 368 368 368 336 337 611 611 611 611 611 611 611 611 611 611 611 611 611 611 368 368 368 368 368 381 382 386 137 113 380 368
611 611 611 606 350 191 116 121 367 366 121 367 350 343 351 607 611 611 611 611 611 611 611 611 611 336 337 643 643 611 611 611 611 611 611 344 345 368 368 368 368 368 368 368 368 368 368 368 368 368 336 337 344 345 643 643 643 643 611 611 611 611 611 611 611 611 611 611 611 611 368 368 368 368 368 368 386 121 388 368
611 611 611 606 366 121 367 414 414 414 414 414 366 121 367 607 611 611 611 611 336 337 611 611 611 344 345 611 643 643 611 611 611 611 611 611 373 374 368 368 368 368 368 368 368 368 368 368 368 368 344 345 611 336 337 336 337 643 643 643 611 611 611 611 611 611 611 611 611 611 611 368 368 368 368 368 368 368 368 368
611 611 611 614 590 414 414 414 414 414 414 414 414 414 414 607 611 611 611 611 344 345 336 337 611 611 611 611 611 643 643 611 611 611 611 611 381 382 368 368 368 368 368 368 368 368 368 368 336 337 611 611 611 344 345 344 345 611 336 337 336 337 611 611 611 611 611 611 611 368 368 368 368 368 368 368 368 368 368 368
611 611 611 611 614 590 414 414 420 446 419 414 414 414 414 607 611 611 611 611 611 611 344 345 611 611 611 611 336 337 643 643 611 611 611 611 611 611 368 368 368 368 368 368 368 368 368 368 344 345 611 611 611 336 337 611 611 611 344 345 344 345 336 337 336 337 611 611 368 368 368 368 368 368 368 368 368 368 368 368
611 611 611 611 611 614 583 583 447 368 445 583 583 583 583 615 611 643 643 643 643 611 611 611 611 611 611 611 344 345 611 611 643 643 611 611 611 611 611 611 368 368 368 368 368 368 611 611 611 611 611 611 611 344 345 611 611 611 611 611 611 611 344 345 344 345 611 368 368 368 368 368 368 368 368 368 368 368 368 368
611 611 611 611 611 611 611 611 611 611 611 611 611 611 611 611 611 611 611 611 611 611 643 643 643 643 611 611 611 611 611 611 611 611 643 643 611 611 611 611 611 611 611 611 611 611 611 643 643 643 643 643 643 611 611 611 611 611 611 611 611 611 611 611 611 611 368 368 368 368 368 368 368 368 368 368 368 368 368 368
611 611 611 611 611 611 611 611 611 611 611 611 611 611 611 611 611 611 611 611 611 611 611 611 611 611 611 643 643 643 643 611 611 611 611 611 611 611 611 611 611 611 611 611 611 611 611 611 611 611 611 643 643 643 643 643 643 611 611 611 611 611 611 611 611 611 611 611 611 368 368 368 368 368 368 368 368 368 368 368
611 611 611 611 611 611 611 611 611 611 611 611 611 611 611 611 611 611 611 611 611 611 611 611 611 611 611 611 611 611 611 643 643 611 611 611 611 611 611 611 611 611 611 611 611 611 611 611 611 611 611 611 611 611 643 643 643 643 643 643 611 611 611 611 611 611 611 611 368 368 368 368 368 368 368 368 368 368 368 368
336 337 336 337 611 611 611 336 337 652 652 652 652 652 611 611 611 611 611 611 611 611 611 611 611 611 611 611 611 598 582 582 582 582 599 611 611 611 611 611 611 611 611 611 598 582 582 582 582 582 582 582 582 582 582 582 582 582 599 336 337 611 336 337 611 611 611 368 368 368 368 368 368 368 368 368 368 368 368 368
344 345 344 345 336 337 611 344 345 652 652 652 652 611 611 611 611 611 611 611 611 611 611 611 611 611 611 611 611 606 414 414 414 414 607 611 611 611 611 611 611 611 611 598 574 405 406 406 406 406 407 350 351 414 350 351 414 414 607 344 345 611 344 345 611 611 368 368 368 368 368 368 368 368 368 368 368 368 368 368
335 335 335 335 344 345 336 337 652 652 652 652 611 611 611 611 611 611 598 582 582 582 582 582 582 582 582 582 582 574 414 414 414 414 607 611 611 611 611 611 611 611 598 574 414 413 292 163 164 292 390 358 359 414 366 367 591 583 615 620 611 611 611 611 611 611 611 368 368 368 368 368 368 368 368 368 368 368 368 368
335 335 335 335 335 335 344 345 652 652 652 652 611 611 611 611 611 611 606 414 414 414 414 414 414 414 414 414 414 414 414 414 414 414 607 611 611 611 611 611 611 598 574 414 414 413 292 171 367 422 422 366 367 591 583 583 615 620 620 611 611 611 611 611 368 368 368 368 368 368 368 368 368 368 368 368 368 368 368 368
335 335 335 335 335 335 336 337 652 652 652 611 611 611 611 611 611 611 606 414 414 414 414 420 446 446 446 446 446 446 446 419 414 414 607 611 611 611 611 611 598 574 414 414 405 389 292 292 415 350 351 591 583 615 611 620 620 611 611 611 611 611 611 611 611 611 611 368 368 368 368 368 368 368 368 368 368 368 368 368
335 335 335 335 335 335 344 345 652 652 652 611 611 611 611 611 611 611 606 414 414 414 414 439 368 368 368 368 368 368 368 437 414 414 607 611 611 611 611 611 606 350 351 405 389 292 292 398 423 366 367 607 611 620 620 611 611 611 611 611 611 611 611 611 611 611 611 611 368 368 368 368 368 368 368 368 368 368 368 368
335 335 335 335 335 336 337 652 652 652 611 611 611 611 611 611 611 611 606 414 414 414 414 439 368 368 368 368 368 368 368 437 414 414 575 582 599 611 611 611 606 366 367 413 163 164 292 415 414 414 414 607 611 611 611 611 611 611 611 611 611 611 611 611 611 611 611 611 611 368 368 368 370 379 379 372 368 368 368 368
335 335 335 335 335 344 345 652 652 611 611 611 611 611 611 611 611 611 614 583 590 414 414 439 368 368 368 368 368 368 368 445 419 414 414 414 607 611 611 611 614 590 414 413 171 172 292 415 414 414 414 607 611 611 611 611 611 611 611 611 611 611 611 611 611 611 611 368 368 368 368 368 378 113 113 380 368 368 368 368
335 335 335 335 336 337 652 652 611 611 611 611 611 611 611 611 611 611 611 611 606 414 414 412 431 368 368 368 368 368 368 368 437 414 414 414 607 611 611 611 611 614 590 421 397 163 164 390 407 414 414 575 582 599 643 643 611 611 611 611 611 611 611 611 611 611 368 368 368 368 373 374 386 121 121 388 373 374 368 368
335 335 336 337 344 345 652 611 611 611 611 611 611 611 611 611 611 611 611 611 606 414 414 414 412 430 430 430 430 430 430 430 411 414 414 414 607 611 611 611 611 611 606 414 413 171 172 292 390 407 414 350 351 575 599 643 643 643 611 611 611 611 611 611 368 368 368 368 368 368 381 382 368 368 368 368 381 382 368 368
336 337 344 345 652 652 611 611 611 611 611 611 611 611 611 611 611 611 611 611 606 414 414 414 414 414 414 414 414 414 414 414 414 414 414 414 607 611 611 611 611 611 606 414 421 422 422 397 292 390 407 366 367 414 575 582 599 643 643 643 611 611 611 611 611 368 368 368 368 368 368 368 368 368 368 368 368 368 370 379
344 345 652 652 652 611 611 611 611 611 611 611 611 611 611 611 611 611 611 611 606 414 414 414 414 591 583 583 583 583 583 583 583 583 583 583 615 611 611 611 611 611 614 590 414 350 351 413 292 292 390 406 406 407 350 351 575 582 599 643 643 611 611 611 611 611 368 368 368 368 368 368 373 374 368 370 379 379 180 113
611 611 611 611 611 611 611 611 611 611 611 611 611 611 611 611 611 611 611 611 606 414 414 414 414 607 611 611 611 611 611 611 611 611 611 611 611 611 611 611 611 611 611 614 590 366 367 421 422 422 422 422 422 423 366 367 414 414 607 611 611 611 611 611 336 337 368 368 373 374 368 368 381 382 370 180 113 113 113 113
611 611 611 611 611 611 611 611 611 611 611 611 611 611 611 611 611 611 611 611 614 583 583 583 583 615 611 611 611 373 374 611 611 611 611 611 611 611 611 611 611 611 611 611 614 583 583 583 583 583 583 583 583 583 583 583 583 583 615 611 611 611 611 611 344 345 336 337 381 382 373 374 368 370 180 113 107 108 108 190
336 337 368 368 368 368 368 368 368 368 368 368 336 337 611 611 611 611 373 374 368 368 336 337 368 368 368 336 337 381 382 611 611 611 611 336 337 368 373 374 368 368 336 337 368 368 336 337 368 368 373 374 368 368 368 368 368 373 374 336 337 368 336 337 373 374 344 345 368 368 381 382 370 238 107 108 190 113 113 113
344 345 368 368 373 374 368 368 373 374 373 374 344 345 373 374 336 337 381 382 336 337 344 345 373 374 368 344 345 368 336 337 336 337 368 344 345 368 381 382 336 337 344 345 373 374 344 345 373 374 381 382 370 379 372 336 337 381 382 344 345 368 344 345 381 382 368 368 368 368 370 379 180 180 238 113 113 113 113 113
368 368 336 337 381 382 336 337 381 382 381 382 368 368 381 382 344 345 368 368 344 345 368 368 381 382 373 374 368 368 344 345 344 345 336 337 368 373 374 368 344 345 368 368 381 382 368 368 381 382 368 368 378 113 380 344 345 368 368 368 368 373 374 368 368 368 368 368 368 370 238 113 107 108 190 113 113 113 113 113
368 368 344 345 368 368 344 345 368 368 368 368 368 368 368 368 368 368 368 368 368 368 368 368 368 368 381 382 368 368 368 368 368 368 344 345 368 381 382 368 368 368 368 368 368 368 368 368 368 368 368 368 386 121 388 368 368 368 368 368 368 381 382 368 368 368 368 370 371 115 115 113 115 113 113 113 113 113 113 113