Route114_LanettesHouse_Layout (11x8)
528 529 528 529 521 520 521 530 531 528 529
536 537 536 537 522 588 524 538 539 536 537
544 545 544 545 517 546 547 546 547 544 545
552 562 552 514 560 514 592 593 514 552 570
593 566 549 514 568 514 600 601 514 562 578
601 556 557 514 576 514 562 586 514 566 549
592 564 565 514 514 514 514 514 553 556 557
600 586 562 514 514 518 519 562 561 564 565