Route110_Layout (40x100)
199 199 199 199 199 199 199 199 199 14 22 322 1 1 1 1 1 1 1 320 198 198 198 198 198 198 198 198 14 198 198 198 198 198 198 198 400 368 368 368
198 199 199 199 199 199 199 199 199 199 321 330 1 1 1 1 1 1 1 320 198 198 198 198 198 198 198 198 198 198 198 198 198 198 199 198 400 368 368 368
198 199 199 199 199 199 199 199 199 199 322 1 1 1 1 1 1 1 312 306 198 198 198 198 198 198 198 198 198 198 198 198 198 199 199 198 400 368 368 368
198 199 199 199 199 199 199 199 199 199 322 1 1 1 1 1 1 1 320 1 22 22 22 198 198 198 198 198 198 198 198 198 198 198 199 198 29 377 368 368
22 199 199 199 199 199 199 199 199 22 322 1 1 1 1 1 1 312 306 1 1 1 1 22 22 22 22 22 22 22 22 22 22 22 199 199 199 400 368 368
394 199 199 199 199 199 199 199 199 321 330 1 1 1 280 282 1 320 848 849 844 844 844 844 844 844 844 844 844 844 844 844 850 851 199 198 198 400 368 368
402 199 199 199 199 199 199 199 199 322 1 1 1 280 289 290 1 320 856 757 758 758 758 758 758 758 758 758 758 758 758 758 759 859 198 199 199 400 368 368
402 199 199 199 199 199 199 199 199 322 1 1 1 288 289 290 1 320 857 741 766 766 766 766 766 766 766 766 766 766 766 766 742 858 198 199 199 400 368 368
402 199 199 199 199 199 199 199 199 322 1 1 280 289 289 290 1 320 865 741 766 766 766 766 766 766 766 766 766 766 766 766 742 866 886 199 199 400 368 368
402 199 199 199 199 199 199 199 199 322 1 1 288 289 289 298 1 320 864 765 766 766 766 766 766 766 766 766 766 766 766 766 767 867 28 199 199 400 368 368
402 199 199 199 23 23 23 23 23 307 1 280 289 289 290 1 1 320 872 777 820 766 766 821 778 820 725 766 726 821 778 778 775 875 28 199 199 400 368 368
402 199 199 199 331 332 332 332 333 1 1 288 289 289 298 1 1 320 880 881 828 724 724 831 786 828 741 766 742 829 786 781 882 883 878 199 199 400 368 368
402 199 199 199 275 276 276 276 277 1 1 288 289 290 638 679 679 679 679 639 873 724 724 874 28 873 741 766 742 874 878 852 878 878 199 199 199 400 368 368
402 199 199 199 1 1 1 1 1 280 281 289 289 290 646 687 687 687 687 647 891 724 724 868 889 894 741 766 742 877 199 860 23 23 199 199 199 29 29 377
402 199 199 199 1 1 1 280 281 289 289 289 289 290 654 695 695 695 695 655 329 1 1 329 329 892 741 766 742 893 887 329 329 329 199 199 199 198 198 400
402 199 199 199 1 1 280 289 289 297 297 297 297 298 662 641 678 678 641 663 1 1 1 1 15 876 741 766 742 877 863 1 1 15 199 199 199 198 198 400
402 199 199 23 1 280 289 289 298 1 1 1 1 3 670 649 668 668 649 671 1 1 1 15 199 884 741 766 742 885 879 1 1 199 199 199 199 199 199 400
402 199 199 3 1 296 297 298 1 1 1 1 1 1 1 1 1 313 1 1 1 1 15 198 199 884 741 766 742 885 199 15 15 199 199 23 23 23 23 400
402 199 199 1 1 1 1 1 15 15 1 15 1 1 1 15 15 320 1 1 1 1 23 198 199 884 741 766 742 885 199 199 199 199 199 104 105 105 106 400
402 23 23 1 1 1 1 1 23 23 1 23 1 1 1 23 23 328 329 329 329 329 329 23 22 936 741 766 742 937 887 23 23 23 23 112 113 113 114 400
410 394 69 1 1 1 71 392 393 393 393 393 393 393 393 393 393 393 393 393 393 393 393 393 393 824 741 766 742 825 909 393 394 104 105 190 113 113 114 400
368 402 69 1 1 1 71 400 368 368 368 368 368 368 368 368 368 368 368 368 368 368 368 368 368 832 741 766 742 833 369 368 402 112 107 108 108 109 114 400
368 402 69 1 1 13 71 400 368 368 368 368 368 368 368 368 368 368 368 368 368 368 368 368 368 840 741 766 742 841 369 368 402 112 115 113 113 117 114 400
368 402 69 1 1 1 71 400 368 368 368 368 368 368 368 376 2 2 377 368 368 368 368 368 368 808 741 766 742 809 369 368 402 112 123 100 124 125 114 400
368 402 69 13 1 1 71 400 368 368 368 368 368 368 376 2 30 31 400 368 368 368 368 368 368 808 741 766 742 809 369 368 402 120 121 167 206 206 122 400
368 402 69 1 1 13 71 400 368 368 368 368 368 368 402 27 38 39 400 368 368 368 368 368 368 808 741 766 742 809 369 368 402 518 1 1 198 198 15 400
368 402 69 1 1 1 71 400 368 368 368 368 368 368 402 1 1 1 400 368 368 368 368 368 368 808 741 766 742 809 369 368 402 1 1 1 198 198 198 400
368 402 69 13 1 13 71 400 368 368 368 368 368 368 410 393 393 393 408 368 368 368 368 368 368 808 741 766 742 809 369 368 402 1 518 15 198 198 23 400
368 402 69 1 13 1 71 400 368 368 368 368 368 368 368 368 368 368 368 368 368 368 368 368 368 804 741 766 742 805 369 368 402 1 15 198 198 198 392 408
368 402 69 13 1 13 71 400 752 753 754 754 754 754 754 754 754 754 754 754 754 754 754 754 754 812 741 766 742 813 837 756 410 394 198 198 198 198 400 368
368 402 69 1 13 13 71 400 760 757 758 758 762 762 762 762 762 762 762 762 762 762 762 762 762 762 709 766 710 758 759 764 369 402 23 23 23 23 400 368
368 402 69 13 13 13 71 400 768 765 766 766 766 770 770 770 770 770 770 770 770 770 770 770 770 770 770 766 766 766 767 772 369 410 393 346 347 393 408 368
368 402 69 1 13 13 71 400 776 777 820 725 766 726 823 778 778 778 778 778 778 778 778 778 778 778 778 778 778 774 775 780 369 368 368 344 345 336 337 368
368 402 69 13 13 13 71 400 784 785 828 741 766 742 831 786 786 786 781 786 786 786 786 786 781 786 786 786 786 786 787 788 369 368 368 368 368 344 345 368
368 402 69 13 13 13 71 400 369 369 838 741 766 742 839 369 369 369 789 369 369 369 369 369 789 369 369 369 369 369 369 369 369 368 368 368 368 368 336 337
368 402 69 13 1 13 71 400 369 369 796 741 766 742 809 369 369 369 797 369 369 369 369 369 797 369 369 369 369 369 369 369 369 368 368 368 368 368 344 345
368 402 69 13 13 13 71 400 368 368 808 741 766 742 809 369 368 368 368 368 368 368 368 368 368 368 368 368 368 368 368 368 368 368 368 368 368 336 337 368
368 402 69 13 13 13 71 400 368 368 808 741 766 742 809 369 368 368 368 368 368 368 368 368 368 368 368 368 368 368 368 368 368 368 368 368 368 344 345 368
368 402 69 13 13 13 13 62 62 62 853 741 766 742 854 855 62 62 62 62 62 62 62 62 62 62 62 62 62 62 62 62 62 62 62 62 62 63 377 368
368 402 69 1 13 13 13 13 13 1 861 741 766 742 862 863 1 13 1 1 13 1 13 1 1 13 13 1 13 1 13 1 13 13 1 27 1 71 400 368
368 402 69 13 13 13 13 13 1 13 861 741 766 742 862 863 1 1 1 13 1 1 13 13 13 13 1 13 1 13 1 13 1 13 13 13 13 71 400 368
368 402 69 1 13 1 13 1 13 1 861 741 766 742 862 863 13 1 13 1 1 13 13 1 1 13 13 13 13 13 13 13 13 13 13 13 13 71 400 368
368 402 77 78 78 78 78 78 78 78 938 741 766 742 939 871 78 78 78 78 78 78 78 78 78 78 78 78 78 78 78 13 13 13 1 13 13 71 400 368
368 410 393 393 393 393 393 393 393 393 824 741 766 742 825 909 393 393 346 347 393 393 393 393 393 393 393 393 393 393 394 69 13 13 13 13 13 71 400 368
368 368 368 368 368 336 337 368 368 368 832 741 766 742 833 369 368 368 344 345 368 368 368 368 368 368 368 368 368 368 402 69 1 13 13 13 13 71 400 368
368 368 368 368 368 344 345 368 368 368 840 741 766 742 841 369 368 336 337 368 368 368 368 368 368 368 368 368 368 368 402 69 13 1 13 13 1 71 400 368
368 368 368 368 336 337 368 368 368 368 808 741 766 742 809 369 368 344 345 368 368 368 368 368 376 2 2 2 377 368 402 69 13 13 13 13 13 71 400 368
368 368 336 337 344 345 368 368 368 368 808 741 766 742 809 369 368 368 336 337 368 368 368 368 402 1 1 1 400 368 402 69 13 13 1 13 1 71 400 368
336 337 344 345 368 368 368 368 368 368 808 741 766 742 809 369 368 368 344 345 336 337 368 368 410 394 1 1 400 368 402 69 13 1 13 1 13 71 400 368
344 345 368 368 368 368 368 368 368 368 804 741 766 742 805 369 368 368 368 368 344 345 368 368 368 410 393 393 408 368 402 69 1 13 13 13 13 71 400 368
368 336 337 368 368 368 368 752 753 754 812 741 766 742 813 836 754 754 754 754 755 756 336 337 368 368 368 368 368 368 402 77 1 1 13 1 1 79 400 368
368 344 345 368 368 368 368 782 757 3 758 709 766 710 758 758 758 758 758 758 759 783 344 345 368 368 368 368 368 368 410 394 69 13 1 13 71 392 408 368
368 368 336 337 368 368 368 810 741 766 766 766 766 766 766 766 766 766 766 766 742 811 369 336 337 368 368 368 368 368 368 402 69 13 13 1 71 400 368 368
368 368 344 345 368 368 368 818 741 766 766 766 766 766 766 766 766 766 766 766 742 819 369 344 345 368 368 368 368 368 368 402 69 13 1 13 71 400 368 368
368 336 337 368 368 368 368 826 741 766 766 766 766 766 766 766 766 766 766 766 742 827 369 336 337 368 368 368 368 368 368 402 69 1 13 1 71 400 368 368
368 344 345 368 368 368 368 834 741 766 766 766 766 766 766 766 766 766 766 766 742 835 369 344 345 368 368 368 368 368 368 402 69 13 1 13 71 400 368 368
336 337 368 368 368 368 368 842 741 766 766 766 766 766 766 766 766 766 766 766 742 843 369 368 336 337 368 368 368 368 368 402 69 1 1 1 71 400 368 368
344 345 336 337 368 368 368 847 765 766 766 766 766 766 766 766 766 766 766 766 767 791 369 368 344 345 368 368 368 368 368 402 69 1 1 1 71 400 368 368
368 368 344 345 368 368 368 798 777 774 774 774 774 774 774 820 725 766 726 821 779 799 369 336 337 368 368 368 368 368 368 402 69 13 13 1 71 400 368 368
371 371 371 371 372 368 368 806 785 786 786 781 786 786 786 828 741 766 742 831 787 807 369 344 345 368 368 368 368 368 368 402 69 13 1 13 71 400 368 368
113 113 113 113 117 377 368 368 368 369 369 789 369 369 369 838 741 766 742 839 369 369 369 336 337 368 368 368 368 368 368 402 69 1 1 1 71 400 368 368
107 108 108 109 191 191 372 368 368 369 643 644 645 369 369 796 741 766 742 809 369 369 369 344 345 368 368 368 368 368 368 402 69 13 1 13 71 400 368 368
115 113 113 191 108 109 117 29 29 643 651 652 653 645 377 808 741 766 742 809 369 368 336 337 368 368 368 368 368 368 368 402 69 1 13 1 71 400 368 368
123 124 124 124 124 125 117 198 198 651 651 652 653 653 400 816 741 766 742 817 369 368 344 345 368 368 368 368 368 368 368 402 69 13 1 13 71 400 368 368
206 206 206 206 206 206 206 198 198 651 628 626 629 653 400 824 741 766 742 825 369 336 337 368 368 368 368 368 368 368 368 402 69 13 13 1 71 400 368 368
198 198 198 198 198 198 198 198 23 672 675 676 675 674 400 832 741 766 742 833 369 344 345 368 368 368 368 368 368 376 61 62 13 13 13 1 13 62 63 377
22 22 22 22 198 198 198 23 1 680 683 684 683 682 400 840 741 766 742 841 369 368 336 337 368 368 368 368 368 402 69 13 13 1 13 13 13 13 71 400
1 1 1 1 22 22 22 1 3 1 1 1 1 71 400 796 741 766 742 809 369 368 344 345 368 368 368 368 368 402 69 13 13 13 13 13 13 1 71 400
1 1 1 1 1 1 1 1 1 1 1 1 1 1 62 853 741 766 742 854 855 62 62 62 62 62 2 2 62 62 13 13 13 13 13 13 13 13 71 400
281 281 281 281 281 281 281 281 281 281 282 1 1 1 1 861 741 766 742 862 863 1 1 13 13 1 13 13 13 13 1 13 1 13 1 13 13 13 71 400
297 297 297 297 297 297 297 297 289 289 289 282 1 1 1 861 741 766 742 862 863 1 1 1 1 13 1 13 1 13 13 13 13 13 13 13 1 27 71 400
14 14 14 14 1 1 1 1 288 289 289 298 1 1 1 938 741 766 742 939 863 1 13 1 1 1 13 1 13 13 1 1 1 13 13 13 1 1 71 400
199 199 199 199 14 1 1 1 288 289 290 1 78 78 78 824 741 766 742 825 871 78 78 78 78 78 78 78 78 78 78 1 1 1 1 78 78 78 79 400
199 199 199 199 199 15 1 1 288 289 290 1 392 393 393 832 741 766 742 833 909 393 393 393 393 393 393 393 393 393 393 393 393 393 393 393 346 347 393 408
199 199 199 199 199 198 15 1 288 289 290 1 400 368 368 840 741 766 742 841 369 368 368 368 368 368 368 368 368 368 368 368 368 368 368 368 344 345 368 368
199 199 199 199 199 199 198 3 288 289 290 1 400 368 368 804 741 766 742 805 369 368 368 368 368 368 368 368 368 368 368 368 368 368 368 368 336 337 368 368
199 199 199 199 199 199 198 1 288 289 290 1 400 752 753 812 741 766 742 813 836 754 754 754 754 754 754 754 754 755 756 368 368 368 368 368 344 345 336 337
199 199 199 199 199 199 198 1 288 289 290 320 400 760 757 758 709 766 718 762 762 762 762 762 762 762 762 762 762 763 764 369 368 368 368 368 368 368 344 345
199 199 199 199 199 199 198 1 288 289 290 320 400 768 765 766 766 770 770 770 770 770 770 770 770 770 770 770 770 742 827 369 368 368 368 368 368 368 336 337
199 199 199 199 199 199 198 1 288 289 290 320 400 776 777 778 778 778 778 778 778 778 778 778 778 778 822 733 766 742 835 369 368 368 368 368 368 368 344 345
199 199 199 199 199 199 198 1 288 289 290 320 400 784 785 786 786 781 786 786 786 786 781 786 786 786 828 741 766 742 843 369 368 368 368 368 368 336 337 368
199 199 199 199 199 199 198 1 288 289 290 320 400 369 369 369 369 789 369 369 369 369 789 369 369 369 838 741 766 742 811 369 368 368 368 368 368 344 345 368
199 199 199 199 199 199 198 1 288 289 290 320 400 369 369 369 369 797 369 369 369 369 797 369 369 369 743 741 766 742 743 369 368 368 368 368 368 368 336 337
199 199 199 199 199 199 198 1 288 289 290 320 400 368 368 368 368 368 368 368 368 752 753 754 754 754 751 741 766 742 751 836 754 754 754 755 756 368 344 345
199 199 199 199 199 199 198 1 288 289 290 320 400 368 368 619 620 620 620 620 621 782 757 758 758 758 758 709 766 710 758 758 758 758 758 759 783 368 336 337
199 199 199 199 199 199 198 1 288 289 290 328 308 308 308 646 687 687 687 687 613 818 741 766 766 766 766 766 766 766 766 766 766 766 766 742 819 579 344 345
199 199 199 199 199 199 198 15 288 289 290 1 1 1 1 654 695 695 695 695 655 826 741 766 766 766 766 766 766 766 766 766 766 766 766 742 827 199 377 368
199 199 199 199 199 199 198 198 288 289 290 1 1 1 1 662 641 678 678 641 663 864 765 766 766 766 766 766 766 766 766 766 766 766 766 767 867 199 400 368
199 199 199 199 199 199 199 198 288 289 290 1 1 1 3 670 649 668 668 649 671 872 777 778 778 778 778 820 766 766 821 778 778 778 778 779 875 199 400 368
199 199 199 199 199 199 199 198 288 289 290 1 1 1 1 1 1 1 313 1 1 880 881 781 786 786 786 828 724 724 831 786 786 786 781 882 883 199 400 368
199 199 199 199 199 199 199 198 288 289 290 1 1 1 1 1 1 1 320 1 1 1 898 852 28 28 28 873 724 724 874 28 28 28 852 28 878 199 400 368
199 199 199 199 199 199 199 198 288 289 289 281 281 281 281 282 1 1 320 1 1 1 900 860 889 889 889 891 724 724 868 897 889 889 860 889 199 199 400 368
199 199 199 199 199 199 198 198 296 297 297 297 297 289 289 289 281 282 320 1 1 1 1 1 1 1 1 1 1 1 1 328 329 329 329 64 199 199 400 368
199 199 199 199 199 199 199 198 15 13 13 13 13 296 297 297 289 290 328 329 329 329 329 313 4 1 1 1 1 1 1 1 3 1 1 199 199 199 400 368
199 199 199 199 199 199 199 198 198 13 13 13 13 13 1 1 288 290 1 1 3 1 1 320 1 4 1 4 1 4 1 1 1 1 14 199 199 199 400 368
199 199 199 199 199 199 199 199 198 15 13 13 13 13 13 1 288 290 1 1 1 1 1 320 4 1 4 1 4 1 1 1 1 14 199 199 199 199 400 368
199 199 199 199 199 199 199 198 198 198 15 13 13 13 13 1 288 289 282 1 1 1 1 328 329 329 64 64 64 64 64 64 64 199 199 199 199 199 400 368
199 199 199 199 199 199 199 198 198 198 198 15 15 13 13 1 296 289 290 1 1 1 1 14 14 14 199 199 199 199 199 199 199 199 199 199 22 22 400 368
199 199 199 199 199 199 199 199 199 199 199 199 199 14 14 1 1 288 290 1 1 14 14 199 198 198 198 198 199 199 199 199 199 199 199 199 392 393 408 368
198 198 198 198 198 198 198 198 198 198 198 198 198 198 198 1 1 296 298 1 14 198 199 199 198 198 198 198 199 199 199 199 199 199 199 199 400 368 368 368