Route116_Layout (100x20)
468 469 468 469 468 469 468 469 468 469 468 469 468 469 468 469 468 469 468 469 468 469 468 469 468 469 468 469 468 469 468 469 468 469 468 469 468 469 468 469 1 112 115 113 115 113 113 115 113 113 113 113 113 113 113 113 113 113 113 113 113 113 113 113 113 113 113 113 113 113 113 113 113 113 113 113 113 113 113 113 113 113 113 115 113 113 113 113 113 113 113 113 113 117 113 117 117 113 113 117
476 477 476 477 476 477 476 477 476 477 476 477 476 477 484 485 484 485 484 485 484 485 484 498 499 498 499 498 499 498 499 498 499 498 499 498 499 498 499 498 463 112 115 113 123 137 113 123 137 113 113 113 113 113 113 113 113 113 113 113 113 113 113 113 113 113 113 113 113 113 113 113 113 113 113 113 113 113 113 113 113 113 113 115 113 113 113 113 113 113 113 113 113 117 113 117 117 113 113 117
468 469 468 469 468 469 468 469 468 469 468 469 468 469 1 1 254 331 332 332 332 332 333 468 469 468 469 468 469 468 469 468 469 468 469 468 469 468 469 468 471 112 123 137 113 115 113 113 115 113 113 113 113 113 113 113 113 113 113 113 113 113 113 113 113 113 113 113 113 113 116 124 124 124 124 137 113 113 113 113 113 113 113 123 137 113 113 113 113 113 113 113 113 117 116 125 117 113 113 117
476 477 476 477 476 477 484 485 484 485 484 485 484 487 1 1 133 275 276 276 276 276 277 492 493 484 493 484 493 484 493 476 477 476 477 476 477 476 477 476 477 112 113 115 113 115 113 113 123 124 124 124 137 113 113 113 113 113 113 113 113 113 113 113 113 113 113 113 113 116 125 113 113 113 113 123 124 124 137 113 113 113 113 113 123 137 113 113 113 113 113 113 116 125 117 116 125 113 116 125
468 469 468 469 468 469 1 1 1 1 1 1 1 1 1 1 133 14 1 1 1 1 14 198 23 1 23 14 23 1 23 468 469 468 469 468 469 468 469 468 469 112 225 115 113 123 137 113 113 113 113 113 123 124 137 113 113 113 113 113 113 113 113 113 113 113 113 113 116 125 116 432 124 124 137 113 113 113 123 124 124 137 113 113 113 115 113 113 113 113 113 113 117 113 117 117 113 113 117 113
476 477 484 485 484 487 1 1 1 1 1 1 13 1 1 1 133 23 14 1 14 1 23 23 1 1 1 23 1 1 1 492 493 484 498 499 8 9 9 9 10 120 137 123 124 137 115 113 113 113 113 113 113 113 123 124 124 124 137 113 113 113 113 113 113 113 116 124 125 113 117 113 113 113 123 124 124 124 137 113 113 123 124 137 113 115 113 113 113 113 113 113 117 113 117 117 113 113 117 113
468 469 1 1 1 1 1 1 1 13 1 13 1 13 1 1 133 1 23 1 23 1 1 1 1 14 1 1 1 14 1 23 23 1 468 469 16 17 17 17 18 1 112 225 113 115 123 124 124 124 124 124 124 124 169 169 432 137 123 124 137 113 113 113 116 124 125 113 116 124 125 113 113 113 113 113 113 113 123 124 124 124 137 115 113 123 137 113 113 113 113 113 117 113 117 117 113 113 117 113
484 487 1 1 1 1 1 1 454 463 13 13 13 13 13 13 141 135 135 135 135 111 14 1 1 198 14 1 14 23 1 1 1 1 486 493 24 11 25 11 26 1 120 137 113 123 124 159 169 169 169 137 225 113 113 113 113 115 113 113 123 124 124 124 125 113 113 113 117 113 113 113 113 113 113 113 113 113 113 113 113 225 115 123 137 113 123 137 113 113 113 113 117 116 125 117 113 116 125 113
1 1 1 1 1 1 462 463 470 471 13 13 13 13 13 13 13 13 1 1 1 133 23 14 1 23 23 1 23 1 1 1 14 1 14 23 32 19 33 19 34 1 1 120 121 145 145 167 145 145 137 123 124 175 124 124 137 123 137 113 113 116 169 169 169 124 124 124 125 116 124 124 175 124 124 137 225 113 113 113 113 113 115 113 115 113 113 115 113 113 113 116 125 117 116 125 113 117 113 113
1 1 1 1 1 1 470 469 476 477 454 455 13 13 13 13 13 1 13 1 1 133 1 198 1 14 1 1 14 1 1 1 198 1 23 1 1 518 518 518 3 1 1 1 1 1 1 1 3 1 112 113 113 113 113 113 123 137 115 113 113 117 116 169 169 159 169 169 169 125 113 113 113 147 148 123 124 124 137 113 113 113 115 113 115 113 113 115 113 113 113 117 116 125 117 113 113 117 113 113
1 1 1 1 1 3 476 477 468 469 468 469 13 13 13 13 1 13 1 1 1 133 1 23 1 23 14 1 23 27 1 14 23 1 14 1 1 518 518 518 1 1 1 1 1 1 1 1 1 1 120 137 113 113 113 113 113 115 123 137 113 117 117 116 169 167 169 169 137 113 113 113 113 155 156 113 113 113 123 124 124 137 115 113 123 137 113 123 137 113 116 125 117 113 117 113 113 117 113 116
1 1 1 1 1 1 468 469 476 477 476 477 454 455 454 463 13 1 1 1 1 133 1 1 1 1 23 1 1 1 1 23 1 1 23 1 1 1 1 1 1 1 1 1 1 1 1 1 1 1 1 120 175 121 137 113 113 115 113 115 113 117 117 114 1 1 1 1 120 121 121 121 175 121 121 121 121 121 121 432 137 115 115 113 113 123 137 113 123 124 125 113 117 113 117 113 113 117 113 162
1 1 1 1 1 13 486 485 468 469 468 469 468 469 468 471 27 1 1 1 1 141 135 135 135 135 135 135 135 135 135 135 135 135 135 214 1 1 1 1 1 1 1 1 1 1 1 1 1 1 1 1 1 1 112 113 113 115 113 123 124 125 117 114 1 1 1 1 1 1 1 1 1 1 1 1 1 1 1 1 112 115 115 113 113 113 115 113 113 113 113 113 117 113 117 113 113 117 113 162
462 463 1 1 13 1 13 13 486 485 484 485 484 485 476 477 1 1 1 1 1 1 1 1 13 13 13 13 13 13 13 13 13 1 1 13 1 1 1 1 1 1 462 463 462 463 462 463 462 463 1 1 1 1 112 113 113 115 113 113 113 116 125 114 462 463 462 463 462 463 462 463 1 1 1 1 1 1 1 1 112 115 115 113 113 113 115 113 113 113 116 124 125 113 117 113 113 117 113 162
470 471 1 1 1 13 13 13 13 13 13 13 13 13 468 469 1 1 1 1 1 1 1 13 1 13 13 13 1 1 13 13 13 13 13 1 13 1 1 1 1 1 470 469 468 469 468 469 468 471 1 1 1 1 112 113 113 115 113 113 116 125 113 114 470 469 468 469 468 469 468 471 1 1 1 1 1 104 105 105 190 115 115 113 113 113 123 137 113 116 125 113 113 113 117 113 113 117 113 162
476 477 462 463 13 1 13 13 13 13 13 13 13 13 486 487 1 1 1 1 1 1 1 1 13 13 13 13 1 13 13 13 13 13 13 13 1 1 1 1 462 463 476 477 476 477 476 477 476 477 462 463 1 1 120 432 137 123 124 124 125 116 496 828 476 477 476 477 476 477 476 477 104 105 105 105 105 190 107 182 182 190 115 113 113 113 113 123 124 125 113 116 124 124 125 113 113 117 113 162
468 469 468 471 1 13 13 13 13 13 13 13 13 1 1 1 1 1 1 1 1 1 1 13 13 13 13 13 13 13 13 13 1 1 13 1 13 1 1 1 470 469 468 469 468 469 468 469 468 469 468 471 1 1 1 1 112 113 113 113 113 114 468 469 468 469 468 469 468 469 468 469 112 113 113 107 182 182 190 113 107 182 190 113 113 113 113 113 113 113 113 117 113 113 113 113 113 191 109 162
476 477 476 477 454 455 454 455 454 455 462 455 1 13 1 1 1 1 1 1 1 1 13 1 13 1 1 13 454 455 454 463 462 455 454 455 462 463 462 463 476 477 476 477 476 477 476 477 476 477 476 477 462 463 462 463 827 497 496 497 496 828 476 477 476 477 476 477 476 477 476 477 112 113 107 182 113 107 182 182 190 113 113 113 113 113 113 113 113 116 124 125 113 113 113 113 113 113 117 162
468 469 468 469 468 469 468 469 468 469 468 471 13 1 13 1 1 1 1 1 1 1 1 13 13 13 1 13 470 469 468 469 468 469 468 469 468 469 468 469 468 469 468 469 468 469 468 469 468 469 468 469 468 469 468 469 468 469 468 469 468 469 468 469 468 469 468 469 468 469 468 469 112 113 115 107 182 190 113 113 113 113 113 113 113 113 113 113 113 117 113 113 113 113 113 113 113 113 117 162
476 477 476 477 476 477 476 477 476 477 476 477 462 463 462 463 462 463 462 463 462 455 13 455 454 455 454 455 476 477 476 477 476 477 476 477 476 477 476 477 476 477 476 477 476 477 476 477 476 477 476 477 476 477 476 477 476 477 476 477 476 477 476 477 476 477 476 477 476 477 476 477 120 137 115 115 113 113 113 113 113 113 116 124 124 124 124 124 124 125 113 113 113 113 113 113 113 113 117 162