Route107_Layout (60x20)
569 579 579 579 570 579 579 579 579 114 368 368 368 368 368 368 368 368 368 368 368 368 368 368 368 368 368 368 368 368 368 368 368 368 368 368 368 368 368 368 368 368 368 368 368 368 368 368 368 336 337 368 368 368 368 368 368 368 336 337
579 570 579 579 569 579 570 579 570 114 368 368 368 368 368 368 368 368 368 368 368 368 368 368 368 368 368 368 368 368 368 368 368 368 368 368 368 368 368 368 373 374 368 368 368 368 368 373 374 344 345 336 337 368 368 368 336 337 344 345
579 569 579 570 579 579 569 570 292 114 368 368 368 368 368 368 368 368 368 368 368 368 368 368 368 368 368 368 373 374 368 368 336 337 368 368 368 368 373 374 381 382 368 368 368 373 374 381 382 368 368 344 345 368 373 374 344 345 368 368
579 579 579 569 570 570 579 116 121 388 368 368 368 368 368 368 336 337 368 368 370 379 372 368 373 374 336 337 381 382 336 337 344 345 336 337 373 374 381 382 368 368 370 379 372 381 382 368 368 368 368 368 373 374 381 382 373 374 368 368
570 579 579 579 569 569 579 114 336 337 373 374 368 368 336 337 344 345 336 337 378 113 380 368 381 382 344 345 368 368 344 345 368 368 344 345 381 382 368 368 368 370 180 113 380 368 368 368 368 368 368 368 381 382 368 368 381 382 368 368
292 570 579 570 579 570 570 114 344 345 381 382 373 374 344 345 368 368 344 345 386 121 388 373 374 368 368 368 368 368 368 368 368 368 368 368 368 368 368 368 368 386 121 121 388 368 368 368 368 368 368 368 368 368 368 368 368 368 368 368
292 292 570 292 570 116 121 388 368 368 368 368 381 382 368 368 368 368 368 368 368 368 368 381 382 368 368 368 368 368 368 368 368 368 368 368 368 368 368 368 368 368 368 368 368 368 368 368 368 368 368 368 368 368 368 368 368 368 368 368
121 121 121 121 121 388 368 368 368 368 368 368 368 368 368 368 368 368 368 368 368 368 368 368 368 368 368 368 368 368 368 368 368 368 368 368 368 368 368 368 368 368 368 368 368 368 368 368 368 368 368 368 368 368 368 368 368 368 368 368
368 368 368 368 368 368 368 368 368 368 368 368 368 368 368 368 368 368 368 368 368 368 368 368 368 368 368 368 368 368 368 368 368 368 368 368 368 368 368 368 368 368 368 368 368 368 368 368 368 368 368 368 368 368 368 368 368 368 368 368
368 368 368 368 368 368 368 368 368 368 368 368 368 368 368 368 368 368 368 368 368 368 368 368 368 368 368 368 368 368 368 368 368 368 368 368 368 368 368 368 368 368 368 368 368 368 368 368 368 368 368 368 368 368 368 368 368 368 368 368
284 284 284 284 284 285 368 368 368 368 368 368 368 368 368 368 368 368 368 368 368 368 368 368 368 368 368 368 368 368 368 368 368 368 368 368 368 368 368 368 368 368 368 368 368 368 368 368 368 368 368 368 368 368 368 368 368 368 368 368
292 292 292 292 292 293 368 368 368 368 368 368 368 368 368 368 368 368 368 368 368 368 368 368 368 368 368 368 368 368 368 368 368 368 368 368 368 368 368 368 368 368 368 368 368 368 368 368 368 368 368 368 368 368 368 368 368 368 368 368
292 292 292 292 292 318 285 368 368 368 368 368 368 368 368 368 368 368 368 368 368 368 368 368 368 368 368 368 368 368 368 368 368 368 368 368 373 374 368 368 368 368 368 368 368 368 368 368 368 368 368 373 374 368 368 368 368 368 368 368
292 569 569 569 292 569 318 285 368 368 368 368 368 368 368 373 374 368 368 368 368 368 368 368 368 368 368 368 368 368 368 368 373 374 368 368 381 382 368 368 368 368 368 368 368 373 374 370 379 379 372 381 382 368 368 368 368 368 368 368
569 579 579 570 569 570 569 340 337 370 379 379 372 368 368 381 382 336 337 368 368 368 368 368 368 368 368 373 374 370 379 372 381 382 373 374 368 336 337 368 368 368 368 373 374 381 382 378 113 113 380 368 336 337 373 374 368 368 368 368
579 579 570 569 579 569 579 348 345 386 121 137 380 336 337 368 368 344 345 373 374 336 337 368 368 368 368 381 382 378 113 180 372 368 381 382 368 344 345 368 368 368 368 381 382 368 368 386 121 121 388 368 344 345 381 382 336 337 368 368
570 579 569 579 579 579 570 293 368 368 368 381 388 344 345 368 368 368 368 381 382 344 345 373 374 368 368 368 368 386 137 113 380 368 368 368 368 368 373 374 368 368 373 374 368 368 368 368 368 368 368 336 337 368 368 368 344 345 336 337
569 579 570 579 579 570 569 293 368 368 368 368 368 368 368 368 368 368 368 368 368 368 368 381 382 336 337 373 374 368 386 137 380 368 368 368 368 368 381 382 336 337 381 382 368 368 368 368 368 368 368 344 345 368 368 368 368 368 344 345
579 579 569 579 579 569 579 318 285 368 368 368 368 368 368 368 368 368 368 368 368 368 368 368 368 344 345 381 382 368 368 381 388 368 368 368 368 368 368 368 344 345 368 368 368 368 368 368 368 368 368 368 368 368 368 368 368 368 368 368
579 579 579 579 579 579 579 569 293 368 368 368 368 368 368 368 368 368 368 368 368 368 368 368 368 368 368 368 368 368 368 368 368 368 368 368 368 368 368 368 368 368 368 368 368 368 368 368 368 368 368 368 368 368 368 368 368 368 368 368