Route129_Layout (80x40)
368 368 368 368 368 368 368 368 368 368 368 368 368 368 368 368 368 368 368 368 368 368 368 368 368 368 368 368 368 336 337 368 368 368 368 368 368 368 368 368 368 368 368 368 336 337 368 368 368 368 368 368 368 368 368 827 829 368 368 373 374 368 368 368 368 368 368 368 368 368 368 368 368 368 368 368 368 368 368 368
368 368 368 368 368 368 368 368 368 368 368 368 368 368 368 368 368 368 368 368 368 368 368 368 368 368 368 368 368 344 345 368 368 368 368 368 368 368 368 368 368 368 368 368 344 345 827 828 828 828 828 828 828 828 829 381 382 368 368 381 382 368 368 368 368 368 368 368 368 368 368 368 368 368 368 368 368 368 368 368
368 368 368 368 368 368 368 368 368 368 368 368 368 368 368 368 368 368 368 368 368 368 368 368 368 368 368 368 368 368 373 374 368 368 368 368 368 336 337 368 368 368 368 368 368 368 386 137 107 108 108 108 109 113 180 828 828 828 828 828 828 829 368 368 368 368 368 368 368 368 368 368 368 368 368 368 368 368 368 368
368 368 368 368 368 368 368 368 368 368 368 368 368 368 368 368 368 368 368 368 368 368 368 368 368 368 368 368 368 368 381 382 368 368 368 368 368 344 345 368 368 368 368 368 368 368 368 378 123 137 113 113 190 108 108 108 108 108 109 113 113 830 829 368 368 368 368 368 368 368 368 368 368 368 368 368 368 368 368 368
368 368 368 368 368 368 368 368 368 368 368 368 368 368 368 368 368 368 368 368 368 368 368 368 368 368 368 368 368 368 368 336 337 368 368 368 368 368 368 368 368 368 368 368 368 368 368 386 137 123 124 137 113 113 113 113 113 113 190 108 109 113 830 828 374 368 368 368 368 368 368 368 368 368 368 368 368 368 368 368
368 368 368 368 368 368 368 368 368 368 368 368 368 368 368 368 368 368 368 368 368 368 368 368 368 368 368 368 368 368 368 344 345 373 374 368 368 368 368 368 368 368 368 368 368 368 368 368 386 145 137 123 137 113 113 113 113 113 113 116 125 113 116 121 388 368 368 368 368 368 368 368 368 368 368 368 368 368 368 368
368 368 368 368 368 368 368 368 368 368 368 368 368 368 368 827 829 368 368 368 368 368 368 368 368 368 368 368 368 368 827 829 368 381 382 368 368 368 368 368 368 368 368 368 368 368 368 368 368 368 378 113 123 124 124 124 137 113 116 125 113 116 388 368 368 368 368 368 368 368 368 368 368 368 368 368 368 368 368 368
368 368 368 368 368 368 368 368 368 368 368 368 368 368 368 381 382 368 368 368 368 368 368 373 374 368 368 368 368 368 378 380 535 368 368 368 368 368 368 368 368 368 368 368 368 368 368 368 368 368 386 121 145 145 145 137 115 116 125 116 121 388 368 368 368 368 368 368 368 368 368 368 368 368 368 368 368 368 368 368
368 368 368 368 368 368 368 368 368 368 368 368 827 828 828 828 828 828 828 828 828 829 368 381 382 373 374 368 368 531 378 830 829 368 368 368 368 368 368 368 368 368 368 368 368 368 368 368 368 827 829 368 368 368 368 378 115 117 116 388 368 368 368 368 368 368 368 368 368 368 368 368 368 368 368 368 368 368 368 368
368 368 368 368 368 368 368 368 368 373 828 828 190 113 107 108 108 108 109 113 113 180 829 368 368 381 382 368 368 535 386 137 380 368 368 368 368 368 368 368 368 368 368 368 368 368 368 368 368 381 382 368 368 368 368 378 123 125 380 368 368 368 368 368 368 368 368 368 368 368 368 368 368 368 368 368 368 368 368 368
368 368 368 368 368 368 368 373 374 378 113 113 113 107 190 113 113 113 190 108 109 113 180 828 374 368 368 368 368 373 374 386 382 368 368 368 368 368 368 368 368 368 368 368 368 368 368 368 368 368 368 368 368 827 829 386 137 113 380 368 368 368 368 368 368 368 368 368 368 368 368 368 368 368 368 368 368 368 368 368
373 374 336 337 368 368 368 381 382 386 137 113 113 123 137 113 113 113 113 116 125 113 116 121 388 368 368 336 337 381 382 368 368 368 368 368 368 368 368 368 368 368 368 368 368 368 368 368 368 368 368 827 829 381 382 545 378 113 380 368 368 368 368 368 368 368 368 368 368 368 368 368 368 368 368 368 368 368 368 368
381 382 344 345 368 336 337 368 368 368 386 121 137 113 123 124 124 124 124 125 113 116 388 368 368 336 337 344 345 368 368 368 368 368 368 368 368 368 368 368 368 368 368 368 368 368 368 368 368 368 368 378 180 829 368 368 378 116 388 368 368 368 368 368 368 368 368 368 368 368 368 368 368 368 368 368 368 368 368 368
368 368 368 373 374 344 345 368 368 368 368 368 386 121 145 145 145 145 145 145 121 388 368 368 368 344 345 368 368 368 368 368 368 368 368 368 368 368 368 368 368 368 368 368 368 368 368 368 368 368 368 378 113 380 368 368 386 388 368 368 368 368 368 368 368 368 368 368 368 368 368 368 368 368 368 368 368 368 368 368
368 368 368 381 382 368 368 368 368 368 368 368 368 368 368 368 368 368 368 368 368 368 368 368 368 368 368 368 368 368 368 368 368 368 368 368 368 368 368 368 368 368 368 368 368 368 368 368 368 827 828 180 113 380 368 368 368 368 368 368 368 368 368 368 368 368 368 368 368 368 368 368 368 368 368 368 368 368 368 368
368 373 374 368 368 368 336 337 368 368 368 368 368 368 368 368 368 368 368 368 368 368 368 368 368 368 368 368 368 368 368 368 368 368 368 368 368 368 368 368 368 368 368 368 368 368 368 368 368 378 113 113 116 388 368 368 368 368 368 368 368 368 368 368 368 368 368 368 368 368 368 368 368 368 368 368 368 368 368 368
368 381 382 368 368 368 344 345 368 368 368 368 368 368 368 368 368 368 368 368 368 368 368 368 368 368 368 368 368 368 368 368 368 368 368 368 373 374 368 368 368 368 368 368 368 368 368 368 368 378 113 113 380 368 368 368 368 368 368 368 368 368 368 368 368 368 368 368 368 368 368 368 368 368 368 368 368 368 368 368
368 368 368 368 368 368 368 368 373 828 828 828 372 368 368 368 368 368 368 368 368 368 368 368 368 368 368 368 368 368 368 368 368 368 336 337 381 382 368 368 368 368 368 368 368 368 368 368 368 378 113 116 388 368 368 368 368 368 368 368 368 368 368 368 368 368 368 368 368 368 368 368 368 368 368 368 368 368 368 368
368 368 368 368 368 368 368 368 386 137 113 113 180 372 368 368 373 374 368 368 368 368 368 368 368 368 368 368 368 368 368 336 337 368 344 345 368 368 368 368 368 368 368 368 368 368 368 368 368 378 113 380 368 368 368 368 368 368 368 368 368 368 368 368 368 368 368 368 368 368 368 368 368 368 368 368 368 368 368 368
368 368 368 368 368 368 368 368 368 386 137 113 113 380 368 368 381 382 368 368 368 368 368 368 368 368 368 368 368 368 368 344 345 373 374 368 368 368 368 368 368 368 368 368 368 368 368 827 829 386 137 380 531 368 368 368 368 368 368 368 368 368 368 368 368 368 368 368 368 368 368 368 368 368 368 368 368 368 368 368
368 368 368 368 368 368 368 368 368 368 386 121 121 388 827 828 372 368 373 374 368 368 368 368 368 368 368 368 368 336 337 368 368 381 382 368 368 368 368 368 368 368 368 368 368 368 368 381 382 531 378 830 829 368 368 368 368 368 368 368 368 368 368 368 368 368 368 368 368 368 368 368 368 368 368 368 368 368 368 368
368 368 368 368 368 368 368 368 368 368 368 368 368 368 378 113 380 368 381 382 368 368 368 368 368 368 368 368 368 344 345 368 368 368 368 368 368 368 368 368 368 368 368 368 368 368 368 368 368 535 386 137 380 368 368 368 368 368 368 368 368 368 368 368 368 368 368 368 368 368 368 368 368 368 368 368 368 368 368 368
368 368 368 368 368 368 368 368 368 368 368 368 368 368 386 121 388 368 368 368 368 368 368 368 368 368 368 368 368 368 827 829 368 368 368 368 368 368 368 368 368 368 368 368 368 368 368 368 827 829 535 386 382 368 368 368 368 368 368 368 368 368 368 368 368 368 368 368 368 368 368 368 368 368 368 368 368 368 368 368
368 368 368 368 368 368 368 368 368 368 368 368 368 368 368 368 368 368 368 368 368 368 368 368 368 368 368 368 368 368 381 382 368 368 368 368 368 368 368 368 368 368 368 368 368 368 368 368 381 382 368 368 368 368 368 368 368 368 368 368 368 368 368 368 368 368 368 368 368 368 368 368 368 368 368 368 368 368 368 368
368 368 368 368 368 368 368 368 368 368 368 368 368 368 368 368 368 368 368 368 368 368 368 368 368 368 827 828 828 372 368 368 368 368 368 368 368 368 827 829 368 368 368 368 368 368 827 829 368 368 368 368 368 368 368 368 368 368 368 368 368 368 368 368 368 368 368 368 368 368 368 368 368 368 368 368 368 368 368 368
368 368 368 368 368 368 368 368 368 368 368 368 368 368 368 368 368 368 368 368 368 368 368 368 827 828 180 113 113 180 372 368 368 368 368 368 827 829 381 382 336 337 368 368 336 337 381 382 368 368 368 368 368 368 368 368 368 368 368 368 368 368 368 368 368 368 368 368 368 368 368 368 368 368 368 368 368 368 368 368
368 368 368 368 368 368 368 368 368 368 368 368 368 368 368 368 368 368 368 368 368 368 827 828 180 107 108 108 109 113 180 828 828 828 829 368 381 382 368 368 344 345 336 337 344 345 368 368 368 368 368 368 368 368 368 368 368 368 368 368 368 368 368 368 368 368 368 368 368 368 368 368 368 368 368 368 368 368 368 368
368 368 368 368 368 368 368 368 368 368 368 368 368 368 368 368 368 368 368 827 828 829 386 137 107 190 113 113 190 108 108 108 108 109 180 828 372 368 368 368 368 368 344 345 368 368 368 368 368 368 368 368 368 368 368 368 368 368 368 368 368 368 368 368 368 368 368 368 368 368 368 368 368 368 368 368 368 368 368 368
368 368 368 368 373 374 368 368 368 827 828 828 828 828 828 828 829 368 368 386 137 190 829 378 123 124 137 113 113 113 113 113 113 190 108 109 180 372 368 368 368 368 368 368 368 368 368 368 368 368 368 368 368 368 368 368 368 368 368 368 368 368 368 368 368 368 368 368 368 368 368 368 368 368 368 368 368 368 368 368
368 368 368 368 381 382 368 368 373 180 107 108 108 108 108 109 180 828 828 372 386 124 382 386 145 137 123 124 124 124 124 124 137 113 113 117 113 180 828 372 368 368 368 368 368 368 368 368 368 368 368 368 368 368 368 368 368 368 368 368 368 368 368 368 368 368 368 368 368 368 368 368 368 368 368 368 368 368 368 368
368 368 373 374 368 368 373 374 378 113 123 137 113 113 113 190 108 108 109 180 372 368 368 368 368 386 145 145 145 145 145 137 123 124 124 125 113 116 121 388 368 368 368 368 368 368 368 368 368 368 368 368 368 368 368 368 368 368 368 368 368 368 368 368 368 368 368 368 368 368 368 368 368 368 368 368 368 368 368 368
373 374 381 382 368 368 381 382 386 121 137 123 124 124 137 113 113 113 117 113 380 368 368 368 368 368 368 827 829 368 368 386 145 137 113 113 116 388 368 368 368 368 368 368 368 368 368 368 368 368 368 368 368 368 368 368 368 368 368 368 368 368 368 368 368 368 368 368 368 368 368 368 368 368 368 368 368 368 368 368
381 382 368 368 368 368 368 368 368 368 386 145 145 137 123 124 124 124 125 113 380 368 368 368 368 368 368 381 382 368 368 368 368 386 124 124 388 368 368 368 368 368 368 368 368 368 368 368 368 368 368 368 368 368 368 368 368 368 368 368 368 368 368 368 368 368 368 368 368 368 368 368 368 368 368 368 368 368 368 368
374 368 368 368 368 368 368 368 368 368 368 368 368 386 145 137 113 113 113 116 388 368 368 368 368 368 368 368 368 368 368 368 368 368 368 368 368 368 368 368 368 368 368 368 368 368 368 368 368 368 368 368 368 368 368 368 368 368 368 368 368 368 368 368 368 368 368 368 368 368 368 368 368 368 368 368 368 368 368 368
382 368 368 368 368 368 368 368 368 368 368 368 368 368 368 386 121 121 121 388 368 368 368 368 368 368 368 368 368 368 368 368 368 368 368 368 368 368 368 368 368 368 368 368 368 368 368 368 368 368 368 368 368 368 368 368 368 368 368 368 368 368 368 368 368 368 368 368 368 368 368 368 368 368 368 368 368 368 368 368
368 368 368 368 368 368 368 368 368 368 368 368 368 368 368 368 368 368 368 368 368 368 368 368 368 368 368 368 368 368 368 368 368 368 368 368 368 368 368 368 368 368 368 368 368 368 368 368 368 368 368 368 368 368 368 368 368 368 368 368 368 368 368 368 368 368 368 368 368 368 368 368 368 368 368 368 368 368 368 368
368 368 368 368 368 368 368 368 368 368 368 368 368 368 368 368 368 368 368 368 368 368 368 368 368 368 368 368 368 368 368 368 368 368 368 368 368 368 368 368 368 368 368 368 368 368 368 368 368 368 368 368 368 368 368 368 368 368 368 368 368 368 368 368 368 368 368 368 368 368 368 368 368 368 368 368 368 368 368 368
368 368 368 368 368 368 368 368 368 368 368 368 368 368 368 368 368 368 368 368 368 368 368 368 368 368 368 368 368 368 368 368 368 368 368 368 368 368 368 368 368 368 368 368 368 368 368 368 368 368 368 368 368 368 368 368 368 368 368 368 368 368 368 368 368 368 368 368 368 368 368 368 368 368 368 368 368 368 368 368
368 368 368 368 368 368 368 368 368 368 368 368 368 368 368 368 368 368 368 368 368 368 368 368 368 368 368 368 368 368 368 368 368 368 368 368 368 368 368 368 368 368 368 368 368 368 368 368 368 368 368 368 368 368 368 368 368 368 368 368 368 368 368 368 368 368 368 368 368 368 368 368 368 368 368 368 368 368 368 368
368 368 368 368 368 368 368 368 368 368 368 368 368 368 368 368 368 368 368 368 368 368 368 368 368 368 368 368 368 368 368 368 368 368 368 368 368 368 368 368 368 368 368 368 368 368 368 368 368 368 368 368 368 368 368 368 368 368 368 368 368 368 368 368 368 368 368 368 368 368 368 368 368 368 368 368 368 368 368 368