Route134_Layout (80x40)
368 368 368 368 368 368 368 368 368 368 368 368 368 368 368 368 368 368 368 368 368 368 368 336 337 368 368 368 368 336 337 368 368 368 368 368 368 336 337 373 374 368 368 368 368 368 368 368 373 374 373 374 368 368 336 337 368 368 368 336 337 336 337 373 374 336 337 368 368 336 337 368 368 368 368 368 368 368 336 337
368 368 368 368 368 368 368 368 368 368 373 374 368 368 373 374 336 337 368 370 379 372 368 344 345 368 368 373 374 344 345 373 374 368 368 336 337 344 345 381 382 336 337 368 368 336 337 368 381 382 381 382 373 374 344 345 368 373 374 344 345 344 345 381 382 344 345 336 337 344 345 373 374 368 368 373 374 368 344 345
368 368 368 368 368 368 336 337 368 368 381 382 373 374 381 382 344 345 368 378 113 380 373 374 368 336 337 381 382 368 368 381 382 373 374 344 345 368 368 368 368 344 345 373 374 344 345 336 337 368 368 368 381 382 368 373 374 381 382 598 582 582 582 582 582 582 599 344 345 611 611 381 382 336 337 381 382 336 337 368
368 336 337 368 368 368 344 345 370 379 372 368 381 382 368 368 368 373 374 386 121 388 381 382 368 344 345 368 368 368 611 611 611 381 382 611 611 611 611 368 368 368 368 381 382 368 368 344 345 368 368 368 368 368 368 381 382 368 368 437 414 350 343 343 351 414 575 582 582 582 582 582 599 344 345 368 368 344 345 368
368 344 345 368 370 379 372 368 378 113 380 368 368 368 368 368 368 381 382 368 368 368 368 368 368 611 611 598 582 582 599 611 611 611 611 611 611 611 611 611 611 368 368 368 368 368 368 368 368 368 368 368 368 368 368 368 368 368 611 614 590 366 121 121 367 350 343 343 343 343 351 414 607 611 620 620 620 620 620 611
336 337 368 370 180 113 380 368 386 121 388 368 368 368 368 368 368 368 368 368 611 611 611 611 611 611 611 606 414 414 575 599 611 611 611 611 611 611 611 611 611 611 368 368 368 368 368 368 368 368 368 368 368 368 368 368 368 611 611 611 614 583 583 590 414 366 121 121 121 121 367 591 615 620 620 620 620 611 611 611
344 345 368 378 113 116 388 368 368 368 368 368 368 368 368 368 368 368 611 611 611 611 611 611 611 611 611 606 414 414 414 575 599 611 611 611 611 611 611 611 611 611 611 368 368 368 368 368 368 368 368 368 368 368 368 368 368 368 368 611 611 611 611 614 583 583 583 583 583 583 583 615 620 620 620 611 611 611 611 611
368 368 368 386 121 388 368 368 368 368 368 368 368 368 368 368 368 368 368 368 368 611 598 582 582 599 611 606 414 414 414 414 575 599 643 643 611 611 611 611 611 611 611 611 368 368 368 368 368 368 368 368 368 368 368 368 368 368 368 368 368 611 611 611 611 611 611 611 611 611 611 611 611 611 611 611 611 611 611 611
368 368 368 368 368 368 368 368 368 368 368 368 368 368 368 368 368 368 368 368 611 611 606 414 414 607 611 606 414 414 414 414 414 607 611 643 643 643 611 611 611 611 611 611 611 611 368 368 368 368 368 368 368 368 368 368 368 368 368 368 611 611 611 611 611 611 598 582 582 582 582 599 611 611 611 611 611 611 611 611
368 368 368 368 368 368 368 368 368 368 368 368 368 368 368 368 368 368 611 611 611 611 606 414 414 575 599 606 350 343 351 414 414 607 611 336 337 643 643 643 611 611 611 611 611 611 611 611 611 368 368 368 368 368 368 368 368 611 611 611 611 611 611 598 582 582 574 350 343 343 351 607 611 611 611 611 611 611 611 611
368 368 368 368 368 368 368 368 368 368 368 368 368 368 368 368 611 611 611 611 611 611 606 414 414 414 607 606 358 223 191 351 591 615 611 344 345 611 336 337 643 611 611 611 611 611 611 611 611 611 611 368 368 368 611 611 611 611 611 611 611 611 598 574 350 343 343 190 116 121 367 607 611 611 611 611 611 611 611 611
368 368 368 368 368 368 368 368 368 368 368 368 368 368 611 611 611 611 611 611 611 598 574 414 414 414 607 606 366 121 121 367 607 611 611 611 611 611 344 345 643 643 611 611 611 611 611 611 611 611 611 611 611 611 611 611 611 611 611 611 598 582 574 350 190 116 121 121 367 591 583 615 611 611 611 611 611 611 611 611
368 368 368 368 368 368 368 368 368 368 368 368 368 368 368 368 368 611 611 611 598 574 414 414 414 414 607 614 590 350 351 414 575 582 582 582 582 582 582 582 599 611 611 611 611 611 611 611 611 611 611 611 611 611 611 611 611 611 611 598 574 350 343 190 116 367 414 414 414 607 611 611 611 611 611 611 611 611 611 611
368 368 368 368 368 368 368 368 368 368 368 368 368 368 368 368 368 368 611 611 606 414 414 350 351 414 607 611 606 366 367 414 414 414 414 414 414 414 414 414 575 582 582 599 611 611 611 611 611 611 611 611 611 611 611 611 611 611 611 606 350 190 116 121 367 414 414 414 591 615 611 611 611 611 611 611 611 611 611 611
368 368 368 368 368 368 368 368 368 368 368 368 368 368 368 368 611 611 611 598 574 414 414 366 367 414 607 611 614 590 414 414 350 343 343 343 343 351 414 414 414 414 414 575 582 582 582 582 582 582 582 582 582 582 582 582 582 582 582 574 358 116 367 414 414 414 414 414 607 611 611 611 611 611 611 611 611 611 611 611
336 337 368 368 368 368 368 368 368 368 368 368 368 368 368 611 611 611 611 606 414 414 414 414 414 414 607 611 611 614 590 414 366 121 121 121 121 367 414 350 351 414 414 405 406 406 406 406 406 406 406 406 406 406 406 406 406 406 406 407 358 359 414 414 414 414 414 591 615 611 611 611 611 611 611 611 611 611 611 611
344 345 336 337 368 368 368 368 368 368 368 368 368 368 611 611 611 611 611 606 414 414 350 351 414 414 607 611 611 611 614 583 583 583 583 583 583 583 590 366 367 350 351 413 292 292 292 292 292 292 292 292 292 292 292 292 292 292 292 415 358 359 414 414 414 414 591 615 611 611 611 611 611 611 611 611 611 611 611 611
368 368 344 345 370 379 379 372 368 368 368 368 368 368 368 368 611 611 611 614 583 590 366 367 414 414 607 611 611 611 611 611 611 611 611 611 611 611 614 583 590 366 367 421 422 422 422 422 422 422 422 422 422 422 422 422 422 422 422 423 366 367 414 414 591 583 615 651 611 611 611 611 611 611 611 611 611 611 611 611
368 368 368 368 378 113 113 180 379 372 611 611 611 611 611 611 611 611 611 611 611 614 583 583 583 583 615 643 643 643 643 611 611 611 611 611 611 611 611 611 614 583 583 583 583 583 583 583 583 583 583 583 583 583 583 583 583 583 583 583 583 583 583 583 615 611 611 611 611 620 620 620 620 611 611 611 611 611 611 611
368 368 368 368 386 137 113 113 113 380 368 368 611 611 611 611 611 611 611 611 611 611 611 611 611 611 611 611 611 643 643 643 643 611 611 611 611 611 611 611 611 611 611 611 611 611 611 611 611 611 611 611 611 611 611 611 611 611 611 611 611 611 611 611 611 611 611 620 620 620 620 611 611 611 611 611 611 611 611 611
368 368 368 368 368 386 121 121 121 388 368 368 368 368 611 611 611 611 611 611 611 611 611 611 611 611 611 611 611 611 611 611 643 643 643 611 611 611 611 611 611 611 611 611 611 611 611 611 611 611 611 611 611 611 611 611 611 611 611 611 611 611 611 611 611 620 620 620 620 611 611 611 611 611 611 611 611 611 611 611
368 368 368 368 368 368 368 368 368 336 337 368 368 368 368 611 611 611 611 611 611 611 611 611 611 611 611 611 611 611 611 611 611 611 643 643 643 611 611 611 611 611 611 611 611 611 611 611 611 611 611 611 611 611 611 611 611 611 611 611 611 611 611 620 620 620 620 611 611 611 611 611 611 611 611 611 611 611 611 611
368 368 368 368 368 368 368 368 368 344 345 368 611 611 611 611 611 611 611 611 611 611 611 598 582 582 582 582 582 599 611 611 611 611 336 337 643 643 643 611 598 582 582 599 611 611 336 337 336 337 336 337 611 611 611 611 611 611 336 337 336 337 611 611 611 611 611 611 611 611 611 611 611 611 611 611 611 611 611 611
368 368 368 368 368 368 368 368 368 370 379 372 368 368 611 611 611 611 611 611 611 611 598 574 414 414 414 414 414 575 599 611 611 611 344 345 336 337 643 643 606 414 414 607 336 337 344 345 344 345 344 345 368 368 368 336 337 611 344 345 344 345 611 611 611 611 611 611 611 611 611 611 611 611 611 611 611 611 611 611
368 368 368 368 368 368 368 368 368 378 113 380 368 368 368 611 611 611 611 611 611 611 606 414 414 414 414 414 414 414 575 599 611 611 611 611 344 345 336 337 445 446 446 447 344 345 368 368 368 368 368 368 368 336 337 344 345 611 611 611 611 611 611 611 611 611 611 611 611 611 611 611 611 611 611 611 611 611 611 611
368 368 368 368 368 368 368 368 368 386 121 388 368 368 368 368 611 611 611 611 611 598 574 414 414 414 414 414 414 414 414 607 611 611 611 336 337 368 344 345 336 337 368 368 368 336 337 368 368 368 368 368 368 344 345 611 336 337 611 611 373 374 611 611 611 611 611 611 611 611 611 611 611 611 611 611 611 611 611 611
368 368 368 368 368 368 368 368 368 368 373 374 370 379 372 368 368 368 611 611 611 606 414 414 414 350 351 414 414 414 414 607 611 611 611 344 345 368 368 368 344 345 368 368 368 344 345 368 336 337 368 368 368 368 611 611 344 345 611 611 381 382 611 611 611 611 611 611 611 611 611 611 611 611 611 611 598 582 582 582
368 368 368 368 368 368 368 368 368 368 381 382 378 113 180 372 611 611 611 611 611 606 414 414 414 366 367 414 414 414 591 615 611 611 611 611 368 368 368 368 368 336 337 368 336 337 368 368 344 345 368 368 368 368 611 611 611 611 611 611 611 611 611 611 611 611 611 611 611 611 611 611 611 611 611 598 574 414 414 414
368 368 368 368 368 368 368 368 368 368 368 368 386 137 113 380 368 368 368 611 611 606 414 414 414 414 414 414 414 591 615 611 611 611 611 336 337 368 368 368 368 344 345 368 344 345 368 368 368 336 337 368 368 336 337 373 374 620 620 611 611 611 611 611 611 373 374 611 611 611 611 611 611 611 598 574 414 414 414 414
368 368 368 368 368 368 368 368 368 368 368 368 368 386 121 388 368 368 611 611 611 606 414 414 414 414 414 414 414 607 611 611 611 611 611 344 345 336 337 368 368 336 337 368 368 368 368 336 337 344 345 368 368 344 345 381 382 620 611 368 368 368 368 604 611 381 382 611 611 611 611 611 611 611 606 414 414 414 414 414
368 368 368 368 368 368 368 368 368 368 368 368 368 373 374 368 368 611 611 611 611 614 590 414 414 414 414 414 591 615 611 611 611 611 611 611 611 344 345 368 368 344 345 336 337 336 337 344 345 368 368 368 336 337 611 611 611 611 368 368 342 342 368 368 604 611 611 611 611 611 611 611 611 611 606 414 414 414 414 414
368 368 368 368 368 368 368 368 368 368 368 368 368 381 382 368 368 368 368 611 611 611 614 590 414 414 414 591 615 611 611 611 611 611 611 611 611 611 336 337 368 368 368 344 345 344 345 368 368 368 336 337 344 345 611 611 611 611 368 342 327 327 342 368 611 611 611 611 611 611 611 611 611 611 606 414 414 414 414 414
368 368 368 368 368 368 368 368 368 368 368 368 368 368 373 374 368 368 368 368 368 611 611 614 583 583 583 615 611 611 336 337 611 611 611 611 611 611 344 345 611 611 368 368 368 368 368 368 336 337 344 345 611 611 611 611 611 611 368 342 327 327 342 368 611 611 611 611 611 611 611 611 611 611 606 414 414 414 414 414
368 368 368 368 368 368 368 368 368 368 368 368 368 368 381 382 336 337 373 374 368 368 368 611 611 611 611 611 336 337 344 345 611 611 611 611 611 611 611 611 611 611 611 611 336 337 368 368 344 345 611 611 611 611 611 611 611 611 368 368 342 342 368 368 620 611 611 611 611 611 611 611 611 611 606 414 414 414 414 414
368 368 368 368 368 368 368 368 368 368 368 368 368 368 368 368 344 345 381 382 373 374 336 337 373 374 368 368 344 345 368 611 611 611 611 611 611 611 611 611 611 611 611 611 344 345 611 611 611 611 611 611 611 611 611 373 374 604 611 368 368 368 368 620 611 373 374 611 611 611 611 611 611 611 606 414 414 414 414 591
368 368 368 368 368 368 368 368 368 368 368 368 368 368 368 368 368 368 368 368 381 382 344 345 381 382 368 368 368 368 368 368 336 337 611 611 611 611 611 611 611 373 374 611 611 611 611 611 611 611 611 611 611 611 611 381 382 604 604 611 611 611 611 611 611 381 382 611 611 611 611 611 611 611 614 583 583 583 583 615
368 368 368 368 368 368 368 368 368 368 368 368 368 368 368 368 368 368 368 368 368 368 368 368 368 373 374 370 379 372 373 374 344 345 368 368 611 611 611 336 337 381 382 336 337 368 368 373 374 368 368 368 373 374 611 611 611 611 611 611 611 611 611 611 611 611 611 611 611 336 337 368 368 336 337 368 368 368 336 337
368 368 368 368 368 368 368 368 368 368 368 368 368 368 368 368 368 368 368 368 368 368 368 368 368 381 382 378 113 380 381 382 368 336 337 368 368 373 374 344 345 368 368 344 345 336 337 381 382 368 336 337 381 382 373 374 611 611 611 611 373 374 611 611 611 611 611 611 611 344 345 373 374 344 345 368 373 374 344 345
368 368 368 368 368 368 368 368 368 368 368 368 368 368 368 368 368 368 368 368 368 368 368 368 368 368 368 386 121 388 368 368 368 344 345 336 337 381 382 368 368 368 368 368 368 344 345 368 373 374 344 345 368 368 381 382 336 337 336 337 381 382 336 337 373 374 336 337 373 374 368 381 382 368 336 337 381 382 368 368
368 368 368 368 368 368 368 368 368 368 368 368 368 368 368 368 368 368 368 368 368 368 368 368 368 368 368 368 368 368 368 368 368 368 368 344 345 368 368 368 368 368 368 368 368 368 368 368 381 382 368 368 368 368 368 368 344 345 344 345 368 368 344 345 381 382 344 345 381 382 368 368 368 368 344 345 368 368 368 368