Route117_PokemonDayCare_Layout (12x9)
520 565 566 567 521 521 524 525 521 521 522 527
528 573 574 575 531 540 548 533 529 529 4 535
536 550 537 550 539 564 564 519 518 518 523 543
544 558 545 558 547 519 518 542 513 513 513 513
519 518 552 518 518 563 513 516 516 516 557 560
541 513 513 513 513 513 513 516 516 516 553 554
549 513 513 513 513 513 513 516 568 560 561 562
541 513 513 513 513 513 579 516 516 516 569 538
549 513 571 572 513 513 576 577 577 577 577 577