Route117_Layout (60x20)
198 199 198 198 198 198 198 198 23 23 23 23 198 198 198 198 198 198 23 23 23 23 23 23 23 23 23 23 23 198 198 23 23 565 566 567 23 23 1 525 13 1 1 208 209 209 210 14 1 13 13 522 1 1 1 1 1 1 1 1
199 199 199 199 198 198 198 199 1 1 13 13 23 23 23 23 23 23 1 1 1 1 176 177 177 177 177 177 178 23 198 698 104 115 113 117 105 106 14 1 1 525 13 208 209 209 210 22 1 13 13 13 13 1 1 1 1 1 1 1
198 199 199 199 198 198 198 22 13 13 13 13 13 13 13 1 1 1 1 1 1 1 184 161 161 161 161 161 194 178 23 648 112 123 124 125 113 114 22 1 13 13 1 208 209 217 218 13 1 1 8 9 9 10 1 1 14 1 1 1
199 199 199 199 199 199 199 312 329 329 329 329 329 329 314 1 1 1 1 1 1 1 184 161 161 161 161 161 161 194 178 648 112 113 113 116 121 122 1 13 13 14 200 209 210 13 524 1 1 523 16 17 17 18 1 1 22 1 1 1
198 199 199 199 199 199 199 320 533 524 531 522 529 520 322 1 1 1 1 1 1 522 184 161 161 161 161 161 161 161 186 648 120 121 121 122 1 1 13 1 13 22 216 217 218 1 1 1 524 1 24 25 11 26 1 1 1 1 1 1
198 199 199 199 199 199 198 320 526 533 524 531 522 529 322 1 1 1 1 1 1 1 2 2 2 2 204 161 161 161 186 656 657 657 657 657 657 657 657 657 657 657 657 657 657 657 657 1 657 3 32 33 19 34 657 657 657 657 657 657
22 199 199 199 199 199 22 320 535 526 533 524 531 522 322 1 3 1 1 1 1 1 1 1 1 522 184 161 161 161 186 1 520 1 1 1 1 1 1 1 1 1 1 1 1 1 1 1 1 1 1 1 1 1 1 1 1 1 1 1
516 22 22 22 22 22 1 320 527 535 526 533 524 531 322 1 280 281 281 281 281 281 282 1 1 1 2 2 204 161 186 529 1 1 1 280 281 281 281 281 281 281 281 281 281 281 281 281 281 282 1 1 1 1 1 1 1 1 1 1
329 329 329 329 329 329 329 328 329 1 1 1 1 329 330 1 288 289 297 297 297 297 298 1 1 1 1 1 2 2 2 1 1 280 281 289 289 289 297 632 633 632 633 632 633 632 633 289 289 289 281 282 1 1 1 1 1 1 1 1
516 517 1 1 517 1 517 1 1 1 1 1 1 1 1 1 288 290 1 1 1 1 1 1 1 1 1 1 280 281 281 281 281 289 289 289 289 298 1 470 469 468 469 468 469 468 471 296 297 289 289 289 281 281 282 1 1 1 1 1
517 516 1 516 1 516 1 1 280 281 281 281 281 281 281 281 289 290 1 1 176 177 178 524 1 1 1 1 296 297 289 289 289 289 289 289 298 1 462 499 498 499 498 499 498 499 498 463 1 296 289 289 289 297 298 1 1 1 1 1
516 516 516 1 1 1 1 1 296 297 297 297 297 297 297 297 297 298 1 1 184 161 194 178 531 1 1 1 1 1 296 297 289 289 289 290 1 1 470 469 468 469 468 469 468 469 468 471 1 1 288 289 298 1 1 1 1 1 1 1
516 1 517 1 516 1 1 1 1 1 1 1 1 1 1 1 1 1 1 1 184 161 161 194 177 178 1 1 1 1 1 1 296 289 289 290 1 1 476 477 484 485 484 485 484 498 499 487 1 3 288 290 1 1 1 1 1 1 15 15
329 329 64 64 64 64 329 329 312 329 329 1 1 1 329 329 314 1 13 13 184 161 161 161 161 186 1 531 1 1 1 1 1 288 289 289 282 1 468 469 331 332 332 332 333 468 469 1 1 280 289 290 1 1 1 15 15 15 198 198
1 15 198 199 198 198 15 15 320 526 533 524 531 522 529 520 322 13 13 13 184 161 161 161 161 194 177 178 1 13 13 13 1 296 289 289 290 1 486 487 275 276 276 276 277 484 487 1 1 288 289 298 1 15 15 198 198 198 198 198
15 199 198 198 198 198 198 198 320 535 526 533 524 531 522 529 322 13 13 13 184 161 161 161 161 161 161 186 13 13 13 13 13 1 288 289 289 282 1 1 1 1 1 1 1 1 1 1 280 289 290 1 1 198 198 198 198 198 198 198
198 198 198 198 198 198 198 198 320 527 535 526 533 524 531 522 322 13 13 13 184 161 161 161 161 161 161 186 13 13 13 13 13 13 296 289 289 289 281 281 281 281 281 281 281 281 281 281 289 289 298 1 15 198 198 198 198 198 198 198
198 198 198 22 22 22 22 22 328 1 329 329 329 329 329 329 330 64 64 64 184 45 45 45 45 45 45 186 37 37 13 13 13 13 13 296 297 297 297 297 297 297 297 297 297 297 297 297 297 298 1 15 198 198 198 198 198 198 198 198
199 199 199 15 1 15 15 15 15 15 1 15 15 15 15 15 1 198 198 198 29 198 198 198 198 198 198 29 198 198 37 37 13 13 13 1 1 15 15 15 15 15 15 15 15 15 15 15 1 1 15 198 198 198 198 198 198 198 198 198
198 198 198 198 15 198 198 198 198 198 15 198 198 198 198 198 15 198 198 198 198 198 198 198 198 198 198 198 198 198 198 198 37 37 37 15 15 198 198 198 198 198 198 198 198 198 198 198 15 15 198 198 198 198 198 199 199 199 199 199