Route104_PrettyPetalFlowerShop_Layout (15x9)
528 532 531 531 533 529 531 534 534 531 531 534 534 531 530
536 540 542 539 541 537 535 547 548 551 563 564 563 564 538
544 559 550 514 514 545 543 555 556 543 571 572 571 572 546
581 567 524 513 513 513 573 554 515 520 573 566 566 523 520
574 575 524 513 513 513 513 513 513 513 513 554 515 520 513
582 583 524 513 513 513 549 549 513 513 513 513 558 558 549
523 515 521 513 513 558 557 557 558 522 513 513 558 558 557
558 522 513 513 513 566 565 565 566 524 513 513 566 566 565
566 524 6 7 513 554 515 515 515 520 513 513 554 515 515