Route119_WeatherInstitute_2F_Layout (20x11)
607 648 649 607 619 607 607 607 607 607 607 607 607 607 607 607 636 637 638 607
615 656 657 615 619 556 557 556 557 556 557 556 557 556 557 615 644 643 646 615
618 664 665 634 619 564 565 564 565 564 565 564 565 564 565 618 652 634 654 634
626 608 617 617 627 618 634 634 612 613 634 634 634 612 613 631 617 617 617 617
599 596 617 617 624 626 617 606 595 596 598 617 606 595 596 598 617 617 617 617
626 604 617 617 632 626 617 617 650 651 617 617 617 650 651 617 617 617 617 617
626 617 617 617 640 631 617 617 617 617 617 617 617 617 617 617 617 617 617 617
626 617 617 617 641 626 617 617 608 609 617 617 617 608 609 617 617 617 617 617
626 608 617 617 619 626 617 606 595 596 617 617 606 595 596 598 617 617 617 617
599 596 617 617 619 626 617 617 650 651 617 617 617 650 651 617 617 617 617 617
626 604 617 617 619 626 617 617 617 617 617 617 617 617 617 617 617 617 617 617