Route118_Layout (80x20)
199 199 199 199 199 134 199 199 199 199 134 199 199 198 198 198 198 198 198 198 134 292 293 368 368 368 291 292 292 133 199 199 199 199 199 199 199 199 198 198 199 112 115 113 123 137 113 113 116 124 124 125 113 113 117 114 198 288 289 290 198 112 115 123 137 113 113 113 113 113 113 113 113 113 113 113 113 117 117 114
199 199 199 199 199 134 199 199 199 199 134 199 199 198 198 198 198 198 198 23 134 292 293 368 368 368 291 292 292 133 23 23 199 199 199 199 199 199 199 199 199 112 115 113 113 123 124 124 125 113 113 113 113 113 117 114 198 288 289 290 198 112 123 137 123 137 113 113 113 113 113 113 113 113 113 113 113 117 117 114
199 199 199 199 199 134 199 199 199 23 134 199 199 198 198 198 198 198 198 110 513 292 293 368 368 368 291 292 292 699 135 111 199 199 199 198 199 199 198 198 199 112 123 124 124 169 169 169 124 124 124 124 124 124 125 114 198 288 289 290 198 112 113 115 113 123 124 124 137 113 113 113 113 113 113 116 124 125 117 114
199 199 199 199 199 134 199 199 199 110 513 199 199 198 198 198 23 23 23 134 326 300 301 368 336 337 299 325 128 129 130 133 198 198 199 199 199 199 199 199 199 559 206 206 206 206 145 145 206 206 206 206 206 206 206 122 22 288 289 290 198 112 113 123 124 169 169 137 115 113 113 113 113 116 124 125 116 169 125 114
198 198 198 23 23 134 23 198 198 134 14 199 199 198 198 23 110 135 135 513 293 368 336 337 344 345 336 341 136 113 138 133 23 198 23 23 23 23 23 199 199 199 199 199 199 199 30 31 199 199 199 22 22 22 22 13 1 288 289 290 22 120 121 145 145 145 137 115 123 124 124 124 124 125 113 113 117 116 145 122
198 23 23 1 1 263 1 23 23 134 22 23 23 23 23 110 513 128 129 130 340 337 344 345 368 368 344 349 144 416 146 699 111 198 582 332 332 332 583 23 199 199 199 199 199 23 38 39 23 23 23 13 13 13 13 13 1 296 297 298 1 13 13 13 13 13 112 123 169 169 169 137 113 113 116 124 125 114 15 15
23 1 1 1 1 1 1 1 1 134 1 1 1 3 213 513 226 136 113 138 348 345 368 368 368 368 368 291 292 292 292 226 133 23 945 276 276 276 277 1 23 23 23 23 23 1 1 1 1 1 1 13 13 13 13 13 1 1 1 1 13 13 13 13 13 13 120 416 169 169 137 123 169 169 125 116 145 122 199 199
1 1 1 1 1 1 1 1 1 263 1 1 1 1 280 618 292 144 121 146 293 368 368 368 368 368 368 291 226 292 292 292 699 135 135 111 14 1 1 1 1 1 1 1 1 1 1 1 1 1 1 1 13 13 13 13 1 1 1 1 13 13 13 13 13 1 1 1 1 1 120 145 145 145 145 122 1 14 199 199
1 1 1 1 1 1 1 1 1 1 1 1 1 280 292 292 292 226 326 300 301 368 368 368 368 368 368 291 292 292 292 292 292 292 292 133 198 14 1 213 135 135 135 135 135 135 135 135 135 135 135 135 135 135 135 214 3 1 1 1 213 135 135 135 135 135 135 135 135 135 135 135 135 135 135 135 214 23 199 199
1 1 1 1 518 255 1 518 1 1 1 1 280 292 292 292 292 292 293 368 368 368 368 368 368 368 368 291 292 292 292 292 292 292 292 133 23 198 1 1 1 1 1 1 1 1 1 1 13 13 13 13 13 13 1 1 1 1 1 1 1 1 1 13 13 13 13 13 13 13 13 13 13 13 1 1 1 1 23 23
1 1 1 518 1 134 518 1 518 1 1 1 288 292 292 292 292 292 293 368 368 368 368 368 368 368 368 299 300 300 325 292 292 292 292 699 111 23 1 1 1 1 1 1 1 1 1 1 13 13 13 13 13 13 13 13 1 1 1 1 1 1 1 1 1 13 13 13 13 13 13 13 13 1 1 1 1 1 1 1
1 14 14 14 14 134 1 518 1 255 1 280 292 292 292 292 292 292 293 368 368 368 368 368 368 368 368 368 368 368 291 292 292 292 292 292 699 111 224 1 1 1 1 1 1 1 1 1 1 13 13 13 13 13 13 13 13 1 1 1 1 1 1 1 1 13 13 13 13 13 13 13 13 1 1 1 1 1 1 1
14 199 199 199 199 134 14 1 518 134 1 288 292 292 292 292 326 300 301 368 368 368 368 368 368 368 368 368 368 368 291 292 292 292 292 292 292 699 135 135 135 135 214 1 1 1 104 105 106 1 37 37 13 13 13 13 13 1 1 1 14 14 14 14 1 1 13 13 13 13 13 13 1 1 1 1 14 15 14 15
199 199 199 199 22 134 199 14 1 134 280 292 292 292 292 292 293 368 368 368 368 368 368 368 368 368 368 368 368 368 291 226 292 292 292 292 292 292 292 292 292 618 618 618 618 618 136 113 114 254 199 199 37 37 13 13 13 14 14 14 199 199 199 199 14 1 1 13 13 13 13 13 14 14 14 14 199 199 199 199
643 644 644 645 135 142 22 22 110 513 292 292 226 292 292 292 293 368 368 368 368 368 368 368 368 368 368 368 368 368 299 300 300 325 292 292 292 292 292 292 292 292 292 292 292 226 144 416 146 133 199 198 198 198 37 37 37 199 199 199 199 199 199 199 199 14 14 14 37 37 37 37 199 199 199 199 199 199 199 199
651 652 652 653 135 135 135 135 513 292 226 292 292 326 300 300 301 368 368 368 368 368 368 368 368 368 368 368 368 368 368 368 368 299 300 300 300 300 325 292 292 292 292 292 292 292 292 292 226 133 199 199 199 199 199 199 199 199 199 199 199 199 199 199 199 199 199 199 199 199 199 199 199 199 199 199 199 199 199 199
659 660 623 661 400 299 300 300 300 338 339 300 300 301 368 368 368 368 368 368 368 336 337 368 368 368 336 337 368 368 368 368 368 368 368 368 368 368 299 300 300 300 300 300 300 300 338 339 325 133 22 22 22 22 22 22 22 199 199 199 199 199 199 199 199 199 199 199 199 199 199 199 199 199 199 199 199 199 199 199
667 668 631 669 400 368 368 368 368 344 345 336 337 368 368 368 368 368 368 336 337 344 345 368 336 337 344 345 336 337 368 368 336 337 368 368 336 337 368 368 368 368 336 337 336 337 344 345 291 699 135 135 135 135 135 135 111 22 199 199 199 199 199 199 199 199 199 199 199 199 199 199 199 199 199 199 199 199 199 199
393 393 393 393 408 368 368 368 368 368 368 344 345 336 337 336 337 336 337 344 345 368 336 337 344 345 368 368 344 345 336 337 344 345 336 337 344 345 336 337 336 337 344 345 344 345 368 368 299 300 300 300 300 300 300 325 699 111 199 199 199 199 199 199 199 199 199 199 199 199 199 199 199 199 199 199 199 199 199 199
368 368 368 368 368 368 368 368 368 368 368 368 368 344 345 344 345 344 345 368 368 368 344 345 368 368 368 368 368 368 344 345 368 368 344 345 368 368 344 345 344 345 368 368 368 368 368 368 368 368 368 368 368 368 368 299 325 133 199 199 199 199 199 199 199 199 199 199 199 199 199 199 199 199 199 199 199 199 199 199