Route126_Layout (80x80)
378 115 115 190 190 190 829 368 827 829 368 368 437 414 414 358 115 113 117 113 113 380 368 368 368 368 368 368 368 531 531 531 531 827 829 344 345 378 113 380 827 829 344 345 378 113 380 827 828 828 828 829 827 828 829 368 368 368 368 368 368 368 368 368 368 336 337 531 378 113 107 190 113 113 113 107 108 108 108 109
378 115 123 124 124 137 837 829 381 382 368 368 437 414 414 358 115 113 117 113 113 380 368 368 368 368 334 334 368 368 368 827 829 381 382 368 368 378 113 380 381 382 368 368 386 121 388 378 113 113 113 380 386 121 382 368 368 368 368 368 368 368 368 368 368 344 345 531 378 113 115 147 148 113 107 190 113 113 113 190
378 123 137 113 113 115 117 837 829 368 368 368 445 419 414 358 115 113 117 113 116 388 368 368 368 334 335 335 334 368 368 381 382 368 368 368 368 386 121 388 368 368 368 368 368 368 368 386 137 113 113 830 829 368 368 368 368 368 368 368 368 368 368 368 368 368 368 531 378 113 115 155 156 113 115 113 113 113 113 113
386 137 123 124 137 115 117 117 380 368 334 334 368 445 446 765 115 113 117 113 380 827 829 368 368 334 335 335 334 368 368 336 337 368 368 368 368 545 368 368 368 368 368 368 368 368 368 368 386 137 113 113 380 368 368 368 368 368 368 368 368 368 368 368 368 827 829 531 378 113 115 113 113 107 190 113 113 113 113 113
531 378 113 113 115 115 117 117 380 368 334 334 368 368 368 378 115 113 117 113 380 381 382 368 368 368 334 334 368 368 368 344 345 368 368 368 368 545 545 545 368 368 368 368 368 368 368 368 368 386 121 121 388 368 368 368 368 368 368 368 368 368 368 368 368 381 382 531 378 113 115 113 113 115 113 113 113 113 113 113
531 378 113 113 115 115 117 117 380 368 368 368 368 368 368 378 115 113 117 116 388 368 827 829 368 368 368 368 368 368 336 337 368 368 368 368 368 545 545 545 368 368 368 368 368 368 368 368 368 368 368 368 368 368 368 368 368 368 368 368 368 368 368 368 368 368 336 337 378 113 115 113 113 115 113 113 113 113 113 113
531 386 121 137 115 115 190 830 830 828 828 828 829 368 368 378 115 113 117 380 368 368 381 382 368 827 828 828 828 829 344 345 368 368 336 337 545 545 368 368 368 368 368 368 368 368 336 337 368 368 368 368 368 368 368 368 368 368 368 368 368 368 368 368 368 368 344 345 378 113 123 137 113 115 113 113 113 113 113 113
531 531 531 378 115 123 124 124 137 113 113 113 837 828 828 830 830 116 125 380 368 368 368 827 829 378 113 113 113 380 546 545 368 368 344 345 545 546 546 546 368 368 368 368 368 368 344 345 368 368 368 368 368 368 368 368 368 368 368 368 368 368 368 368 368 336 337 531 378 113 113 115 113 115 113 113 113 113 113 113
531 531 531 378 123 169 169 137 115 113 113 116 125 113 113 116 124 125 113 380 827 828 829 381 382 386 137 113 113 380 543 518 539 539 539 539 539 539 539 539 539 539 519 368 368 368 638 638 368 368 368 368 368 368 368 368 368 368 368 368 368 368 368 368 368 344 345 531 386 137 113 115 113 115 113 113 113 113 113 113
531 531 531 386 121 137 113 115 123 124 124 125 113 113 116 125 113 116 121 388 378 113 380 368 368 368 386 121 121 388 539 540 334 334 334 334 334 334 334 334 334 334 538 539 539 519 531 368 368 368 368 368 368 368 368 368 368 368 368 368 368 368 368 368 368 368 368 531 531 378 113 115 113 115 113 113 113 113 113 116
638 638 531 368 368 386 137 123 169 169 169 169 124 124 125 113 113 380 531 518 386 121 388 368 368 368 827 829 546 540 334 334 334 334 334 334 534 534 534 534 534 534 334 334 334 538 539 519 531 531 541 542 542 542 368 368 368 368 368 368 368 368 368 368 368 368 368 531 531 378 113 123 137 115 113 113 113 113 113 117
638 638 638 368 368 638 386 121 137 113 113 113 113 113 113 113 116 388 531 336 337 368 368 368 368 368 381 382 336 337 523 523 523 523 523 524 334 534 534 534 534 534 534 534 334 334 334 538 539 539 539 539 519 531 368 368 368 368 368 368 368 368 368 368 368 368 827 829 531 378 147 148 115 123 124 137 113 113 113 117
638 638 638 638 638 368 368 368 386 121 121 121 121 121 121 121 388 368 531 344 345 542 542 543 368 368 531 531 344 345 827 829 531 531 531 547 524 334 534 534 334 334 334 334 334 534 534 334 334 334 334 334 538 539 368 368 368 368 368 368 368 368 368 368 368 368 381 382 368 378 155 156 115 113 113 115 113 113 116 125
638 638 638 638 638 638 638 638 638 638 827 828 828 829 638 638 827 829 638 638 368 539 539 539 539 539 539 539 539 519 381 382 336 337 531 531 532 334 513 334 522 523 523 523 524 334 334 534 534 534 534 534 334 334 538 519 531 531 531 541 542 542 519 531 531 531 531 368 368 378 113 113 115 113 113 123 124 124 125 113
638 638 638 638 638 638 638 631 631 628 378 113 113 830 829 531 381 382 518 540 334 334 334 334 334 334 334 334 334 538 539 519 344 345 336 337 532 334 513 334 530 531 531 531 547 523 524 334 534 534 534 534 534 534 334 538 539 519 531 531 531 531 541 542 519 531 531 368 368 386 121 137 115 113 113 113 113 113 113 113
638 638 638 638 638 638 638 827 828 829 386 121 121 121 388 531 535 518 540 334 534 534 534 534 534 534 534 534 534 334 334 538 519 531 344 345 532 334 513 334 530 531 531 531 531 531 547 524 334 534 534 534 534 534 534 334 334 538 539 539 539 519 531 531 541 519 531 368 368 368 368 378 123 124 137 113 113 113 113 113
638 638 638 638 638 638 638 378 113 380 638 636 531 531 531 531 531 535 334 534 534 534 534 534 534 534 534 534 534 534 534 334 530 531 531 336 337 334 513 334 538 539 539 519 531 531 531 547 524 334 534 534 534 534 534 534 534 334 334 334 334 538 519 531 531 541 542 368 368 336 337 386 121 137 115 113 113 113 113 113
638 638 638 638 638 638 638 386 121 388 638 336 337 531 638 638 531 535 334 534 534 534 334 334 334 334 334 534 534 534 534 334 530 336 337 344 345 334 513 334 334 334 334 538 519 531 531 531 532 334 534 534 534 534 534 534 534 534 534 534 534 334 538 539 539 539 519 368 368 344 345 368 368 378 123 124 137 113 113 113
638 638 638 638 638 638 638 827 829 531 638 344 345 631 638 638 629 535 334 534 534 334 522 523 523 523 524 334 334 534 534 334 530 344 345 531 532 334 513 513 513 534 534 334 530 531 531 531 532 334 534 534 534 534 534 534 534 534 534 534 534 534 334 334 334 334 538 531 531 368 368 368 368 386 121 137 115 113 113 113
638 638 638 638 638 827 829 381 382 638 638 638 638 638 638 638 629 535 334 334 334 522 546 526 526 527 547 523 524 334 334 334 530 531 824 826 532 334 534 534 534 534 534 334 530 525 526 527 532 334 534 534 534 534 534 534 534 534 534 534 534 534 534 534 534 534 334 530 531 368 368 368 368 827 829 378 123 124 137 113
638 638 638 638 638 381 382 638 524 524 638 638 638 638 655 629 824 825 826 824 826 627 824 825 825 825 825 826 547 523 523 523 546 531 840 842 547 524 334 334 334 334 334 522 546 533 336 337 532 334 534 534 534 513 513 513 513 513 513 534 534 534 534 534 534 534 334 538 519 368 368 368 368 381 382 386 121 137 123 124
638 638 638 336 337 638 524 524 524 524 638 638 638 638 638 824 692 833 834 840 842 824 692 833 680 681 682 692 826 531 523 523 336 337 559 539 531 547 523 523 523 523 523 546 525 546 344 345 532 334 534 534 513 513 513 334 334 334 513 513 513 534 534 534 534 534 534 334 530 368 368 368 368 368 368 368 368 386 121 137
638 638 638 344 345 638 638 638 638 638 638 638 638 638 638 832 833 677 842 634 634 832 833 833 688 689 690 833 834 531 824 826 344 345 531 531 559 525 526 526 526 526 526 526 546 531 518 543 532 334 534 534 513 513 334 522 523 524 334 334 513 513 513 534 534 534 534 334 530 368 368 368 368 368 827 828 829 368 368 378
638 638 638 638 827 829 638 638 638 638 638 638 638 824 826 840 841 842 642 642 642 840 676 833 696 697 698 833 834 531 840 842 531 531 531 531 531 541 519 336 337 531 531 531 518 542 543 518 540 334 534 513 513 334 824 826 824 825 826 547 334 513 513 513 534 534 513 334 530 368 368 368 368 368 378 113 380 368 368 378
638 638 638 638 381 382 638 638 638 638 638 542 542 840 842 645 649 649 650 650 650 541 840 841 676 833 833 833 834 824 826 539 539 539 539 539 519 531 541 344 345 531 518 542 543 518 539 540 334 534 534 513 513 334 840 842 832 833 693 826 524 334 334 513 513 513 513 334 530 368 368 368 368 368 386 121 388 827 829 378
638 638 638 638 638 336 337 638 638 638 645 542 542 639 336 337 535 653 334 334 334 530 531 654 840 841 841 841 842 840 842 334 334 334 334 334 538 539 519 531 541 542 543 518 539 540 334 334 534 534 534 513 513 334 538 519 840 676 833 834 547 523 524 334 513 513 513 334 530 368 368 368 368 368 827 829 368 381 382 378
638 638 638 638 638 344 345 639 639 639 652 531 531 531 344 345 535 547 524 334 334 541 654 542 542 519 824 826 531 518 540 334 534 534 534 534 334 334 538 539 539 539 539 540 334 334 534 534 534 534 534 513 513 513 334 538 547 840 841 842 824 826 540 334 513 513 334 522 546 368 368 368 368 368 381 382 368 368 531 378
638 638 638 638 645 652 827 829 518 542 542 542 519 336 337 531 547 527 535 334 334 530 531 336 337 542 840 842 518 540 334 534 534 534 534 534 534 534 334 334 334 334 334 334 534 534 534 534 534 534 534 534 534 513 513 334 334 334 538 539 840 842 334 513 513 513 334 530 531 368 368 368 368 368 368 368 368 368 531 378
638 638 638 638 636 531 381 382 543 531 531 531 533 344 345 531 824 826 535 334 334 538 539 344 345 531 531 518 540 334 534 534 534 534 534 534 534 534 534 534 534 534 534 534 534 534 534 534 534 534 534 534 534 513 513 513 513 513 334 334 334 334 513 513 513 513 334 530 368 368 368 368 368 368 368 368 368 368 368 386
638 638 645 639 652 336 337 535 531 518 539 519 541 519 336 337 840 842 535 334 334 334 334 538 539 539 539 540 334 534 534 534 534 534 534 534 534 534 534 534 534 534 534 534 534 534 534 534 534 534 534 534 534 534 534 513 513 513 513 513 513 513 513 513 513 334 522 546 368 368 368 368 368 368 368 368 368 368 368 531
638 638 645 336 337 344 345 535 531 532 334 530 531 541 344 345 518 543 535 334 334 534 534 334 334 334 334 334 534 534 534 534 534 534 534 534 534 334 334 334 334 534 534 534 534 534 534 534 534 534 534 534 534 534 534 534 534 534 513 513 513 513 513 513 513 334 530 531 368 368 368 368 368 368 368 368 368 368 368 368
638 638 531 344 345 531 531 535 531 532 334 538 519 531 533 336 337 531 547 524 334 534 534 534 534 534 534 534 534 534 534 534 534 334 334 334 334 522 523 523 524 334 334 334 334 334 534 534 534 534 534 534 534 534 534 534 534 534 534 534 534 534 513 513 513 334 530 531 368 368 368 368 368 368 368 368 368 368 368 368
638 638 336 337 368 531 518 543 518 540 334 334 538 519 541 344 345 531 531 535 334 534 534 534 534 534 534 534 534 534 534 334 334 522 523 523 523 546 336 337 547 523 523 523 523 524 334 334 334 334 334 334 334 334 334 334 334 534 534 534 534 534 534 534 513 334 538 519 368 368 368 368 531 368 368 827 829 368 368 368
638 645 344 345 368 531 535 531 532 334 534 534 334 530 531 531 531 824 826 524 334 534 534 534 534 534 534 534 534 534 334 522 523 546 531 531 531 525 344 345 526 526 526 527 559 547 523 523 523 523 523 523 523 523 523 523 524 334 334 534 534 534 534 534 534 534 334 530 368 368 368 368 531 368 368 381 382 368 368 368
638 636 368 824 826 531 535 531 532 334 534 534 334 538 519 531 531 840 842 524 334 513 534 534 534 534 534 534 334 334 522 546 531 546 546 546 683 684 684 684 684 684 684 684 684 684 684 684 685 546 546 527 559 824 826 531 547 523 524 334 534 534 534 534 534 534 334 530 531 368 368 368 531 368 368 368 368 368 368 368
638 636 368 840 842 531 535 559 532 334 534 534 534 334 531 824 826 531 518 540 334 513 513 534 534 534 334 334 522 523 546 525 525 683 684 684 692 689 689 689 689 689 689 689 689 689 689 689 693 684 684 685 527 840 842 559 531 531 547 524 334 534 534 534 534 534 334 538 519 368 368 368 531 368 368 368 368 368 368 368
368 368 336 337 368 368 535 531 532 334 534 534 534 334 531 840 842 518 540 334 513 513 513 513 534 334 546 546 336 337 546 546 683 692 689 689 680 681 681 681 681 681 681 681 681 681 681 681 681 682 689 693 685 546 546 547 547 547 546 546 546 334 534 534 534 534 534 334 530 368 368 368 531 368 368 368 368 368 368 368
368 368 344 345 368 368 535 531 532 334 534 534 534 334 530 336 337 532 334 513 513 513 513 513 334 546 546 546 344 345 546 683 838 689 680 681 692 689 689 689 689 689 689 689 689 689 689 689 681 839 689 689 693 685 546 546 546 546 547 546 546 524 334 534 534 534 534 334 530 368 368 368 531 368 368 368 368 368 368 368
368 629 824 825 826 518 535 531 532 334 534 534 334 522 546 344 345 540 334 513 513 513 513 334 522 336 337 546 546 546 683 692 688 689 688 689 689 680 681 681 681 681 681 681 681 681 681 682 681 693 681 682 689 839 684 685 546 546 546 547 546 547 524 334 534 534 534 334 538 368 368 368 531 368 368 368 368 368 368 368
368 824 692 833 834 532 535 531 547 524 334 534 334 530 336 337 532 334 513 513 513 513 513 334 530 344 345 546 546 683 838 680 692 680 692 680 681 692 689 689 689 689 689 689 689 689 689 693 681 681 682 690 689 690 689 839 685 546 546 546 824 826 547 524 334 534 534 534 334 368 368 368 368 368 368 368 368 368 368 368
368 832 833 677 842 532 824 826 559 532 334 534 334 530 344 345 532 334 513 513 513 513 334 522 544 546 546 683 684 692 692 688 680 692 689 688 689 689 677 697 697 697 697 697 697 697 697 676 689 689 690 690 689 693 682 693 693 685 546 546 840 842 531 532 334 534 534 534 334 530 531 531 533 368 368 368 368 368 368 368
368 840 841 842 642 532 840 842 531 532 334 534 334 530 336 337 532 334 534 513 513 513 334 530 544 546 683 838 689 689 680 692 688 689 680 692 689 689 690 847 836 836 836 836 836 836 846 688 689 689 690 693 681 682 693 682 689 693 685 546 546 544 559 547 524 334 534 534 334 538 519 531 533 368 368 368 368 368 368 368
368 645 649 824 826 532 531 535 531 532 334 534 334 530 344 345 532 334 534 513 513 513 334 530 546 721 688 688 689 689 688 680 692 689 688 689 689 689 690 849 847 836 836 836 836 846 848 688 689 689 693 681 682 690 689 693 682 689 839 685 546 546 527 531 547 524 334 534 534 334 530 531 541 368 368 368 368 368 368 368
368 368 368 840 842 532 531 547 527 547 524 334 522 824 826 518 540 334 534 534 534 334 522 523 546 721 688 688 689 689 688 688 689 680 692 689 689 689 690 849 845 831 831 831 831 843 848 688 689 689 689 689 690 693 681 682 690 689 690 690 720 546 546 559 531 532 334 534 534 334 530 531 559 368 368 368 368 368 368 368
368 368 368 368 824 825 826 531 535 531 547 523 546 840 842 532 334 534 534 534 534 334 530 525 546 721 688 688 689 689 688 688 689 688 689 689 689 689 690 849 845 831 831 831 831 843 848 688 689 689 689 689 690 689 689 690 690 689 690 690 720 546 547 527 531 532 334 534 534 334 538 519 531 368 368 368 368 368 531 531
368 368 368 368 832 833 834 531 547 527 629 824 825 826 518 540 334 534 534 534 534 334 530 533 546 721 688 688 689 689 688 688 689 688 689 689 689 689 690 849 845 831 831 831 831 843 848 688 689 689 689 689 693 682 689 690 690 689 690 690 720 546 531 535 531 532 334 534 534 534 334 530 531 541 531 531 531 531 531 531
531 531 368 368 840 841 842 531 531 547 824 692 833 834 532 334 534 534 534 534 534 334 530 533 546 721 688 688 689 689 688 688 689 688 689 689 689 689 690 849 845 831 831 831 831 843 848 688 689 689 689 689 689 690 689 690 690 689 690 690 720 546 527 547 527 547 524 334 534 534 334 538 519 531 533 531 531 531 531 531
531 531 531 531 531 824 826 531 531 531 832 833 833 834 532 334 534 534 534 534 534 334 530 824 826 721 688 688 689 689 688 688 689 688 689 689 689 689 690 849 845 831 831 831 831 843 848 688 689 689 689 689 689 690 689 690 690 689 690 690 720 546 824 826 535 559 532 334 534 534 534 334 530 559 533 531 531 531 531 531
531 531 531 531 531 840 842 531 531 531 832 833 677 842 532 334 534 534 534 534 334 522 523 840 842 721 688 696 676 689 688 688 689 696 676 689 689 689 690 849 845 831 831 831 831 843 848 688 689 689 689 689 677 698 689 690 690 689 690 690 720 547 832 693 826 531 532 334 534 534 534 334 530 531 533 531 531 531 531 531
531 627 824 825 825 825 825 826 645 649 840 841 842 642 532 334 534 534 534 534 334 530 559 533 546 721 696 676 688 689 688 696 676 689 696 676 689 689 693 693 693 850 850 850 850 693 692 692 689 689 689 689 690 689 677 698 690 677 698 690 720 547 832 833 834 518 540 334 534 534 534 334 530 531 533 531 531 531 531 531
531 824 692 833 833 833 833 692 826 824 826 531 531 531 532 334 534 534 534 534 334 530 531 533 546 729 713 688 688 689 696 676 696 676 689 696 676 689 689 689 689 689 689 689 689 689 689 689 689 689 677 697 698 689 690 689 690 690 677 698 720 547 840 841 842 532 334 534 534 534 534 334 530 531 533 533 533 533 533 533
531 832 833 680 681 681 682 833 834 840 842 531 545 531 532 334 534 534 534 534 334 530 559 533 546 546 721 688 696 676 689 688 689 696 676 689 696 697 676 689 689 689 689 689 689 689 689 689 677 697 698 689 689 689 690 677 698 690 690 712 728 824 826 543 518 540 334 534 534 534 534 334 530 531 533 533 533 533 533 533
531 832 833 688 689 689 692 682 834 368 368 531 368 531 532 334 534 534 534 534 334 538 519 519 824 826 721 696 676 688 689 688 689 689 688 689 689 689 696 697 697 676 689 689 689 677 697 697 698 689 689 689 677 697 698 690 677 698 690 720 546 840 842 531 532 334 534 534 534 534 534 334 530 531 533 533 368 368 533 533
531 840 676 688 689 689 689 690 692 826 368 559 368 559 532 334 534 534 534 534 534 334 530 530 840 842 729 713 688 688 689 696 676 689 696 697 697 676 689 689 689 696 697 697 697 698 689 689 689 689 677 697 698 689 677 698 690 677 698 720 546 546 543 531 532 334 534 534 534 534 334 522 546 531 533 533 373 374 533 533
531 541 832 696 697 676 689 690 833 834 368 531 368 531 532 334 534 534 534 534 534 334 530 531 546 546 546 721 688 696 676 689 696 676 689 689 689 696 697 697 676 689 689 689 689 689 677 697 697 697 698 689 689 677 698 689 690 690 712 728 546 546 531 518 540 334 534 534 534 534 334 530 531 531 533 533 381 382 533 533
531 530 840 676 833 696 697 698 833 834 368 531 368 531 532 334 534 534 534 534 534 334 538 519 546 546 546 721 696 676 688 689 689 696 697 676 689 689 689 689 696 697 697 697 697 697 698 689 689 677 697 697 697 698 677 697 698 690 720 546 546 336 337 532 334 534 534 534 534 534 334 530 531 531 533 533 546 544 533 533
531 541 541 840 841 676 833 833 833 834 368 559 368 559 547 524 334 534 534 534 534 534 334 530 546 547 546 729 713 688 696 697 676 689 689 696 697 697 676 689 689 689 677 697 697 697 697 697 697 698 689 689 689 689 690 677 697 698 720 546 546 344 345 540 334 534 534 534 534 534 334 530 531 559 533 533 533 533 533 533
531 531 530 531 654 840 841 841 841 842 368 531 368 531 531 532 334 534 534 534 534 534 334 538 519 546 547 546 721 696 697 676 696 676 689 689 689 689 696 697 697 697 698 689 689 689 689 689 689 677 697 697 697 697 698 690 712 705 728 546 547 531 532 334 513 534 534 534 534 334 522 546 531 531 533 533 533 533 533 533
531 531 541 824 826 542 519 519 519 531 368 527 368 527 531 547 524 334 534 534 534 534 534 334 538 546 546 546 729 705 713 696 676 696 697 697 697 676 689 689 689 689 689 677 697 697 697 697 697 698 677 697 697 697 697 698 720 546 546 547 547 559 532 334 513 534 534 534 334 522 546 531 531 525 533 533 533 533 533 533
531 531 531 840 842 824 825 826 519 368 368 535 368 535 531 531 532 334 534 534 534 534 534 534 334 546 546 546 546 546 729 713 696 697 697 697 676 696 697 697 697 697 697 698 677 697 697 697 697 697 698 712 705 705 705 705 728 546 546 535 531 518 540 334 513 513 534 534 334 530 531 368 368 368 533 533 533 533 533 336
531 531 531 368 368 832 833 834 535 368 368 535 368 535 559 531 532 334 534 534 534 534 534 534 534 334 538 547 336 337 546 729 705 705 705 713 696 697 697 697 697 697 697 697 698 712 705 705 705 705 705 728 546 546 546 546 546 546 546 543 531 532 334 513 513 513 513 334 522 546 531 546 531 531 533 533 533 533 533 344
531 531 531 368 368 840 841 842 368 368 368 535 368 535 531 531 547 524 334 534 534 534 534 534 534 534 334 546 344 345 546 546 546 546 546 729 705 705 705 705 705 705 705 705 705 728 531 531 531 531 531 531 531 531 531 531 531 336 337 531 518 540 334 513 513 513 513 334 530 531 531 531 368 368 533 533 533 533 373 374
531 531 531 368 336 337 368 368 368 368 368 535 368 535 531 531 531 532 334 534 534 534 534 534 534 534 534 334 334 538 519 531 531 531 559 541 542 519 559 541 542 542 519 531 531 531 531 531 518 542 542 542 542 543 518 542 542 344 345 518 543 334 513 513 513 513 513 334 530 531 525 531 368 368 533 533 533 533 381 382
531 531 531 368 344 345 368 533 546 368 368 535 368 535 531 531 531 532 334 534 534 534 534 534 534 534 534 534 534 334 538 539 539 519 531 559 531 541 542 542 542 519 541 542 542 542 336 337 543 559 518 542 542 542 543 531 518 539 539 540 334 513 513 513 513 513 334 522 546 531 533 531 368 368 533 533 533 336 337 533
531 531 531 629 824 825 826 368 368 368 368 547 824 826 527 559 531 547 524 334 334 334 534 534 534 534 534 534 534 534 334 334 334 538 539 539 539 539 539 539 519 541 542 542 613 614 344 345 531 531 543 518 539 539 539 539 540 334 334 334 513 513 513 513 513 513 334 530 368 368 368 525 368 368 368 336 337 344 345 533
531 531 531 824 692 833 834 532 368 368 368 368 840 842 368 368 368 368 547 523 523 524 334 334 534 534 534 534 534 534 534 534 534 334 334 334 334 334 334 334 538 539 539 539 621 622 623 539 531 531 539 540 334 334 334 334 334 534 534 534 534 534 513 513 513 513 334 530 368 368 368 533 368 336 337 344 345 533 533 535
531 531 531 832 833 677 842 532 368 368 368 368 368 368 368 368 368 368 531 531 531 547 523 524 334 334 534 534 534 534 534 534 513 513 513 513 513 513 513 513 334 334 334 334 334 334 334 334 334 334 334 334 534 534 534 534 534 534 534 534 534 534 534 534 513 334 522 546 368 368 368 368 368 344 345 533 533 533 533 533
531 531 531 840 841 842 642 532 368 334 334 368 368 824 826 368 368 368 526 526 527 559 531 547 523 524 334 334 334 334 534 534 513 513 513 513 513 513 513 534 534 534 534 534 534 534 534 534 534 534 534 534 534 534 534 534 534 534 534 534 534 534 334 334 334 522 546 531 531 531 531 368 336 337 533 531 533 533 533 533
531 531 824 826 650 649 650 532 334 335 335 334 368 840 842 627 824 825 825 825 825 826 645 527 531 547 523 523 523 524 334 513 513 513 513 513 513 513 534 534 534 534 534 534 534 534 534 534 534 534 534 534 534 534 534 534 534 534 534 534 534 334 522 523 523 546 531 531 629 824 825 826 344 345 531 531 533 533 533 531
531 531 840 842 531 368 368 368 334 335 335 334 368 368 368 824 833 680 681 682 833 692 826 535 531 559 368 368 531 547 524 334 334 513 513 513 513 513 534 534 534 534 534 534 534 534 534 534 534 534 534 534 534 534 534 534 534 534 334 334 334 522 546 531 531 559 531 531 824 692 833 834 531 531 336 337 533 533 533 531
531 531 531 531 336 337 368 368 368 334 334 368 368 368 368 832 833 688 689 690 833 833 692 826 645 526 368 368 526 527 547 523 524 334 334 334 513 534 534 534 534 534 534 534 534 534 534 534 534 534 534 534 534 534 534 534 334 334 522 523 523 546 531 368 368 368 368 368 832 833 677 842 531 531 344 345 531 533 533 531
531 531 531 531 344 345 368 368 368 368 368 531 531 368 368 832 833 696 697 698 680 681 682 692 826 368 368 368 368 368 531 531 547 523 523 524 334 334 334 534 534 534 534 534 534 534 534 534 534 534 534 534 534 534 334 334 522 523 546 531 531 533 531 533 368 368 368 368 840 841 842 642 531 531 531 531 531 533 533 535
531 531 531 531 531 531 336 337 531 531 531 336 337 824 826 840 841 676 833 833 688 689 690 833 834 824 826 526 526 368 526 526 526 336 337 547 523 523 524 334 334 534 534 534 534 534 534 534 334 334 334 334 334 334 522 523 546 531 531 559 531 531 336 337 368 368 824 826 650 649 650 532 531 531 531 531 531 533 533 535
531 531 531 531 531 531 344 345 531 368 368 344 345 840 842 368 368 832 833 833 696 697 698 833 834 840 842 526 526 531 531 531 531 344 345 547 547 531 531 531 524 334 334 334 334 334 334 334 522 523 523 523 531 531 531 531 531 531 531 531 336 337 344 345 368 368 840 842 531 531 368 368 368 368 531 531 531 531 531 535
368 368 368 368 368 368 368 336 337 824 826 368 368 368 368 368 368 840 841 841 841 841 841 841 842 368 368 336 337 629 824 825 826 518 531 547 368 368 531 531 531 368 368 368 368 368 368 368 368 368 336 337 629 531 531 824 825 826 531 531 344 345 368 368 336 337 649 649 368 368 368 368 368 368 368 368 368 368 368 531
368 368 368 368 368 368 368 344 345 840 842 368 368 368 824 825 826 368 368 368 368 368 368 368 368 368 368 344 345 824 692 833 834 532 531 368 336 337 531 531 531 368 531 368 368 368 368 368 336 337 344 345 824 825 825 692 833 834 824 826 368 368 368 368 344 345 368 531 531 531 531 368 368 368 368 368 368 368 368 368
368 368 368 368 368 368 368 368 368 368 368 368 368 368 832 833 834 368 368 368 368 368 368 368 368 368 368 368 526 832 833 677 842 824 825 826 344 345 824 825 825 826 531 368 336 337 368 368 344 345 368 368 832 833 833 833 677 842 840 842 368 368 368 368 368 368 368 368 368 368 368 368 368 368 368 368 368 368 368 368
368 368 368 368 368 368 368 368 368 368 368 368 368 368 840 841 842 368 368 368 368 368 368 368 368 368 368 368 368 840 841 842 642 832 833 834 368 368 832 833 833 834 368 368 344 345 336 337 368 368 368 368 840 676 833 677 842 642 368 368 368 368 368 368 368 368 368 368 368 368 368 368 368 368 368 368 368 368 368 368
368 368 368 368 368 368 368 368 368 368 368 368 368 368 368 368 368 368 368 531 368 368 368 368 368 368 368 368 368 649 650 649 650 840 841 842 368 368 840 841 841 842 824 826 368 368 344 345 368 368 824 826 649 840 841 842 532 368 368 368 368 368 368 368 368 368 368 368 368 368 368 368 368 368 368 368 368 368 368 368
368 368 368 368 368 368 368 368 368 368 368 368 368 368 368 368 368 368 368 368 368 368 368 368 368 368 368 368 368 368 368 368 368 368 368 368 368 368 368 368 368 368 840 842 368 368 368 368 368 368 840 842 368 368 368 368 368 368 368 368 368 368 368 368 368 368 368 368 368 368 368 368 368 368 368 368 368 368 368 368