Route110_TrickHousePuzzle6_Layout (15x22)
513 513 513 513 513 513 513 513 513 513 513 513 514 623 516
521 521 521 521 521 521 521 521 521 521 521 521 522 631 524
528 528 528 528 528 644 528 640 528 640 528 528 528 528 640
520 520 520 520 520 520 520 648 520 648 520 640 520 640 648
520 520 520 520 520 640 520 648 520 648 520 656 520 648 648
520 520 520 520 520 648 520 648 520 648 520 520 520 648 648
649 643 520 644 520 648 520 648 520 648 520 520 640 648 648
648 520 520 520 520 648 520 656 520 656 520 520 656 656 656
648 520 520 520 640 648 520 520 520 520 520 640 520 520 520
648 520 640 520 656 656 640 520 520 520 520 648 520 531 520
656 520 648 520 520 520 657 642 642 642 642 658 520 520 520
520 520 657 642 650 520 520 520 520 520 520 520 520 520 520
520 520 520 520 648 520 520 520 520 520 520 520 520 520 520
520 520 640 520 656 640 640 520 520 640 520 641 642 642 650
640 520 656 520 520 648 648 520 520 656 520 641 642 650 648
648 520 520 520 520 648 648 520 520 520 520 520 520 648 648
648 520 520 520 520 648 648 520 520 520 520 520 520 648 648
657 650 520 641 642 651 648 520 520 641 642 643 520 656 648
520 656 520 520 520 648 648 520 520 641 642 643 520 520 648
520 520 520 520 520 656 656 520 520 641 642 643 520 520 648
520 520 520 520 520 520 520 520 520 520 520 520 520 520 648
529 530 520 520 520 641 643 520 520 520 520 641 642 642 658