Route110_TrickHouseCorridor_Layout (15x24)
513 513 513 739 533 533 533 533 533 533 533 533 533 533 740
513 513 513 747 541 541 541 541 541 541 541 541 541 541 748
513 513 513 755 545 545 545 545 545 545 545 545 545 545 756
513 513 513 545 553 553 553 553 553 553 553 553 553 553 553
513 513 513 545 553 553 513 513 513 513 513 513 513 513 513
513 513 513 545 553 553 513 513 513 513 513 513 513 513 513
739 533 740 545 553 553 513 513 513 513 513 513 513 513 513
747 541 748 545 553 553 513 513 513 513 513 513 513 513 513
755 545 756 545 553 553 513 513 513 513 513 513 513 513 513
545 553 553 553 553 553 513 513 513 513 513 513 513 513 513
545 553 553 553 553 553 513 513 513 513 513 513 513 513 513
545 553 553 513 513 513 513 513 513 513 513 513 513 513 513
545 553 553 513 513 513 513 513 513 513 513 513 513 513 513
545 553 553 513 513 513 513 513 513 513 513 513 513 513 513
545 553 553 513 513 513 513 513 513 513 513 513 513 513 513
545 553 553 513 513 513 513 513 513 513 513 513 513 513 513
545 553 553 513 513 513 513 513 513 513 513 513 513 513 513
545 553 553 513 513 513 513 513 513 513 513 513 513 513 513
545 553 553 513 513 513 513 513 513 513 513 513 513 513 513
545 553 553 513 513 513 513 513 513 513 513 513 513 513 513
545 553 553 739 533 740 513 513 513 513 513 513 513 513 513
545 553 553 747 541 748 513 513 513 513 513 513 513 513 513
545 553 553 755 545 756 513 513 513 513 513 513 513 513 513
545 553 553 553 528 529 513 513 513 513 513 513 513 513 513