Route128_Layout (120x40)
368 368 368 368 368 368 368 368 368 368 378 123 124 137 113 117 113 830 829 368 532 532 381 382 532 531 535 532 529 334 575 599 596 598 594 597 334 528 533 368 368 368 368 368 378 123 137 191 108 108 108 108 109 113 830 828 828 828 828 828 828 828 830 113 113 113 107 190 113 113 117 116 388 368 368 368 368 368 368 368 368 368 368 368 368 368 368 368 368 368 368 368 368 368 368 368 368 368 368 368 368 368 368 368 368 368 368 368 368 368 368 368 368 368 368 368 368 368 368 368
368 368 368 368 368 368 368 368 368 368 386 137 113 115 113 117 113 113 380 368 532 532 532 532 532 542 543 532 529 334 575 599 596 598 594 597 334 528 533 368 368 368 368 545 378 113 123 124 124 137 113 113 191 108 109 113 113 113 113 113 113 113 113 113 113 107 190 113 113 116 125 380 368 368 368 531 531 368 368 368 368 368 368 368 368 368 368 368 368 368 368 368 368 368 368 368 368 368 368 368 368 368 368 368 368 368 368 368 368 368 368 368 368 368 368 368 368 368 368 368
368 368 368 368 368 368 368 368 368 368 368 378 113 115 113 190 109 113 380 368 368 368 368 368 368 368 368 368 368 334 575 599 587 588 594 597 334 368 368 368 368 368 368 368 386 137 113 113 113 123 124 137 113 113 191 108 108 108 108 108 108 108 108 108 108 190 116 124 124 125 116 388 368 368 368 368 368 368 368 368 368 368 368 368 368 368 368 368 368 368 368 368 368 368 368 368 368 368 368 368 368 368 368 368 368 368 368 368 368 368 368 368 368 368 368 368 368 368 368 368
368 368 368 368 368 368 368 368 368 368 368 378 113 123 137 113 117 113 380 368 368 368 368 368 368 368 368 368 368 368 334 587 591 596 594 597 334 368 368 368 368 368 368 368 368 386 121 121 137 113 113 123 124 124 137 113 113 113 113 113 113 113 113 113 113 116 125 116 145 145 388 368 368 368 368 368 368 368 368 368 368 368 368 368 368 368 368 368 368 368 368 368 368 368 368 368 368 368 368 368 368 368 368 368 368 368 368 368 368 368 368 368 368 368 368 368 368 368 368 368
368 368 368 368 368 368 368 368 368 368 368 386 137 113 115 113 117 113 380 368 368 368 429 430 430 430 430 430 431 368 334 564 599 596 594 597 334 368 368 368 368 368 368 368 368 336 337 368 386 121 137 113 113 113 123 124 124 124 124 124 124 124 124 124 124 125 116 388 368 368 373 374 368 368 368 368 368 368 368 368 368 368 368 368 368 368 368 368 368 368 368 368 368 368 368 368 368 368 368 368 368 368 368 368 368 368 368 368 368 368 368 368 368 368 368 368 368 368 368 368
368 368 368 368 368 368 368 368 368 368 368 368 378 113 123 137 117 113 380 368 368 429 411 414 350 343 343 351 412 431 368 334 599 596 594 597 334 368 368 368 368 368 368 368 368 344 345 368 368 368 386 121 121 121 145 145 145 145 145 145 145 145 145 145 145 145 388 827 829 368 381 382 368 368 368 368 368 368 368 368 368 368 368 368 368 368 368 368 368 368 368 368 368 368 368 368 368 368 368 368 368 368 368 368 368 368 368 368 368 368 368 368 368 368 368 368 368 368 368 368
368 368 368 368 368 368 368 368 368 368 368 368 386 137 113 115 117 116 388 368 368 437 414 414 358 113 113 359 414 439 368 334 599 596 594 597 334 368 368 368 368 368 368 368 368 368 368 368 368 368 368 368 368 368 336 337 368 368 368 368 368 368 368 368 368 368 368 381 382 368 368 368 368 368 368 368 368 368 368 368 368 368 368 368 368 368 368 368 368 368 368 368 368 368 368 368 368 368 368 368 368 368 368 368 368 368 368 368 368 368 368 368 368 368 368 368 368 368 368 368
368 368 368 368 368 368 368 368 368 368 368 368 368 386 137 123 125 380 368 368 368 437 414 414 366 137 113 359 414 439 368 334 599 596 594 597 578 334 368 368 368 368 368 368 368 368 429 430 430 430 431 368 368 368 344 345 368 368 368 368 368 368 368 368 336 337 368 368 827 829 368 368 368 368 368 368 368 368 368 368 368 368 368 368 368 368 368 368 368 368 368 368 368 368 368 368 368 368 368 368 368 368 368 368 368 368 368 368 368 368 368 368 368 368 368 368 368 368 368 368
368 368 368 368 368 368 368 368 368 368 368 368 368 368 386 137 113 380 368 827 829 437 414 414 414 366 121 367 414 439 368 334 599 596 594 605 593 578 334 334 334 334 368 368 368 368 437 414 414 414 412 431 368 368 368 368 368 368 368 368 368 368 368 368 344 345 368 368 381 382 368 368 368 368 429 430 430 430 430 430 431 368 368 368 368 368 368 368 368 368 368 368 368 368 368 368 368 368 368 368 368 368 368 368 368 368 368 368 368 368 368 368 368 368 368 368 368 368 368 368
368 368 368 368 368 368 368 368 368 368 368 368 368 368 545 378 113 380 368 381 382 445 419 414 414 414 414 414 414 439 368 334 334 596 602 593 605 603 603 603 593 578 334 334 334 334 437 414 414 414 414 439 368 368 368 368 368 368 368 368 368 368 368 368 368 368 368 368 368 336 337 827 829 429 411 414 350 343 343 351 412 431 368 368 368 368 368 368 368 368 368 368 368 368 368 368 368 368 368 368 368 368 368 368 368 368 368 368 368 368 368 368 368 368 368 368 368 368 368 368
368 368 368 368 368 368 368 368 368 368 368 368 368 368 368 378 113 380 368 368 368 368 445 419 414 414 414 414 420 447 368 368 368 334 598 602 603 603 603 593 605 603 603 603 593 334 445 419 414 414 414 439 368 368 368 368 334 334 334 368 368 368 368 368 368 368 368 368 368 344 345 381 382 437 350 343 190 113 113 191 351 412 430 430 431 373 374 368 368 368 368 368 368 368 368 368 368 368 368 368 368 368 368 368 368 368 368 368 368 368 368 368 368 368 368 368 368 368 368 368
368 368 368 368 368 368 368 368 368 368 368 368 368 368 368 378 116 388 368 368 368 368 368 445 446 446 446 446 447 368 368 368 368 368 334 334 334 334 334 334 334 603 603 593 597 578 334 445 446 446 446 447 368 368 368 368 334 579 579 334 334 334 334 334 334 334 368 368 368 368 368 368 336 355 366 121 137 113 113 113 191 343 343 351 439 381 382 368 368 368 368 368 368 368 368 368 368 368 368 368 368 368 368 368 368 368 368 368 368 368 368 368 368 368 368 368 368 368 368 368
368 368 368 368 368 368 368 368 368 368 368 368 368 368 368 386 388 368 336 337 368 368 368 368 368 368 368 368 368 368 368 368 368 368 368 368 368 368 368 368 368 334 334 334 334 593 578 334 334 368 368 368 368 334 334 334 580 592 603 603 603 603 603 603 603 334 368 368 368 368 368 368 344 363 414 414 366 121 137 113 113 113 113 359 439 368 368 368 368 368 368 368 368 368 368 368 368 368 368 368 368 368 368 368 368 368 368 368 368 368 368 368 368 368 368 368 368 368 368 368
368 368 368 368 368 368 368 368 368 368 368 368 368 368 368 368 827 829 344 345 827 829 368 368 368 368 368 368 368 368 368 368 368 429 430 430 430 430 430 431 368 368 368 368 368 334 603 593 578 334 334 334 334 580 592 603 603 607 592 603 603 603 603 334 334 368 368 368 336 337 368 368 368 437 414 414 414 414 366 121 121 137 113 359 354 337 368 368 368 368 368 368 368 368 368 368 368 368 368 368 368 368 368 368 368 368 368 368 368 368 368 368 368 368 368 368 368 368 368 368
368 368 368 368 368 368 368 368 368 368 368 368 368 368 368 368 381 382 368 368 381 382 368 368 368 368 368 368 368 368 368 429 430 411 414 414 414 414 414 412 430 430 430 431 368 368 334 605 603 603 603 603 603 603 607 592 603 603 334 334 334 334 334 368 368 368 368 368 344 345 368 368 368 445 419 414 414 414 414 350 351 366 121 367 362 345 368 368 368 368 368 368 368 368 368 368 368 368 368 368 368 368 368 368 368 368 368 368 368 368 368 368 368 368 368 368 368 368 368 368
368 368 368 368 368 368 368 368 368 368 368 368 368 368 368 368 368 368 827 829 368 368 368 368 368 368 368 368 368 368 368 437 414 414 414 420 446 446 419 414 414 414 414 439 368 368 368 334 603 603 603 603 603 603 603 604 334 334 368 368 368 368 368 368 368 368 368 368 368 368 368 368 368 368 445 419 414 414 414 366 367 414 414 420 447 827 829 368 368 368 368 368 368 368 368 368 368 368 368 368 368 368 368 368 368 368 368 368 368 368 368 368 368 368 368 368 368 368 368 368
368 368 368 368 368 368 368 368 368 368 368 368 368 368 368 368 368 368 381 382 368 368 368 368 368 368 368 368 368 368 368 437 414 414 420 447 368 368 445 446 446 419 414 412 431 368 368 368 334 598 598 598 598 598 334 334 368 368 368 368 368 368 368 368 368 368 368 368 368 368 368 368 368 368 368 445 446 419 414 414 414 414 420 447 368 381 382 368 368 368 368 368 368 368 368 368 368 368 368 827 829 368 368 368 368 368 368 368 368 368 368 368 368 368 368 368 368 368 368 368
368 368 368 368 368 368 368 368 368 368 368 368 368 368 368 368 368 368 368 368 827 829 368 368 368 368 368 368 368 336 337 437 414 414 439 368 368 368 368 368 368 437 414 414 439 336 337 368 334 598 598 598 598 334 368 368 368 368 368 368 368 368 368 368 368 368 368 368 334 334 334 368 368 368 368 368 368 445 446 446 446 446 447 368 368 368 336 337 827 829 368 368 368 368 368 368 827 828 829 381 382 368 368 368 368 368 368 368 368 368 368 368 368 368 368 368 368 368 368 368
368 368 368 368 368 368 368 368 368 368 368 368 368 368 368 368 368 368 368 368 381 382 368 368 368 368 368 368 368 344 345 437 414 414 439 368 334 334 334 334 368 437 414 414 439 344 345 368 334 588 598 598 334 368 368 429 430 430 430 430 430 430 431 368 368 368 368 334 580 595 578 334 334 368 368 368 368 368 368 368 368 368 368 368 368 368 344 345 381 382 336 337 368 368 827 829 378 113 380 368 827 828 828 828 828 828 828 828 828 828 828 829 368 368 368 368 368 368 368 368
368 368 368 368 368 368 368 368 368 368 368 368 368 368 368 368 368 368 533 368 827 828 829 368 368 368 368 368 368 368 368 437 414 414 439 368 334 334 571 334 368 437 414 414 439 368 368 368 334 596 588 598 334 368 429 411 414 350 343 343 351 414 412 431 368 368 368 334 592 603 603 593 578 334 334 334 334 334 334 368 368 368 368 368 368 368 368 368 368 368 344 345 336 337 381 382 386 121 388 368 386 137 107 108 108 108 108 108 108 108 109 190 371 371 372 368 368 368 368 368
368 368 368 368 368 368 368 368 368 368 368 368 368 368 368 368 368 368 368 368 378 113 380 368 535 368 334 334 368 368 368 437 414 414 412 430 431 368 334 334 429 411 414 414 439 368 368 334 580 596 596 334 368 368 437 414 414 366 137 113 359 414 414 439 368 368 368 368 334 592 593 605 603 603 603 603 603 593 578 334 334 368 368 368 368 368 368 368 368 368 368 368 344 345 368 368 368 368 368 827 829 378 123 124 137 113 113 113 113 113 190 108 108 109 190 372 368 368 368 368
368 368 368 368 368 368 368 368 368 368 368 368 368 368 368 368 368 368 368 827 830 113 380 368 368 334 580 578 334 368 368 445 419 414 414 414 412 430 430 430 411 414 414 420 447 368 368 334 592 607 596 334 368 368 445 419 414 414 366 121 367 414 420 447 368 368 368 368 368 334 602 603 603 603 603 603 593 605 603 593 578 334 368 368 368 368 368 368 368 368 368 368 368 368 368 368 368 368 368 381 382 386 121 137 123 124 124 124 124 124 137 113 113 117 113 190 371 372 368 368
368 368 368 368 368 368 368 368 368 368 368 368 368 368 368 368 368 368 368 378 113 113 380 368 368 334 592 593 334 368 336 337 445 419 414 414 414 414 414 414 414 414 414 439 336 337 368 334 596 592 598 334 368 368 368 445 419 414 414 414 420 446 447 368 368 368 368 368 368 368 334 334 598 598 598 598 334 334 334 334 334 368 368 368 368 368 368 368 368 368 368 368 368 368 368 368 368 368 368 368 368 368 368 386 121 121 121 121 121 137 123 124 124 125 113 116 121 388 368 368
368 368 368 368 368 368 368 368 368 368 368 368 368 368 368 368 368 368 533 378 107 109 380 368 368 334 596 594 334 368 344 345 368 445 446 419 414 414 414 414 414 414 420 447 344 345 368 334 596 596 598 334 368 368 368 368 445 446 446 446 447 368 368 368 368 368 368 368 368 368 368 368 334 334 334 334 368 368 368 368 368 368 368 368 368 368 368 368 368 368 368 368 368 368 368 368 368 368 368 368 368 368 368 368 368 827 829 368 368 386 121 137 113 113 116 388 368 368 368 368
368 368 368 368 368 368 368 368 368 368 368 368 368 368 368 368 368 368 533 378 115 117 380 531 368 368 334 594 578 334 368 368 368 368 368 445 446 446 446 446 446 446 447 368 368 368 334 580 596 596 598 334 368 368 368 368 368 368 368 368 368 368 336 337 368 368 368 368 368 368 368 368 368 368 368 368 368 368 368 368 368 368 368 368 368 368 368 368 368 368 368 368 368 368 368 368 368 368 368 368 368 368 368 368 368 381 382 368 368 368 368 386 124 124 388 368 373 374 373 374
368 368 368 368 368 368 368 368 368 368 368 368 368 368 368 368 368 368 533 378 155 156 380 827 829 368 368 334 593 578 334 334 368 368 368 368 368 336 337 368 368 368 368 368 334 334 580 592 607 596 334 334 368 368 368 368 368 368 368 368 368 368 344 345 368 368 368 368 368 368 368 368 368 368 368 368 368 368 368 368 368 368 368 368 368 368 368 368 368 368 368 368 368 368 368 368 368 368 368 368 368 368 368 368 368 368 368 368 368 368 368 368 368 368 373 374 381 382 381 382
368 368 368 368 368 368 368 368 368 368 368 368 368 368 368 368 368 368 533 386 137 113 380 381 382 368 368 368 334 603 593 578 334 334 368 368 368 344 345 368 368 368 368 334 580 592 603 607 334 334 429 430 430 430 430 431 368 368 368 368 368 368 368 368 368 368 429 430 430 430 430 430 430 430 430 431 368 368 368 368 368 368 368 368 368 368 368 368 368 368 368 368 368 368 368 368 368 368 368 368 368 368 368 368 368 368 368 368 368 368 368 368 368 368 381 382 368 368 368 368
368 368 368 368 368 368 368 368 368 368 368 368 368 368 368 368 368 368 368 545 378 113 380 368 368 368 368 368 368 334 334 603 593 578 334 334 334 334 334 334 334 334 334 572 592 607 592 334 368 429 411 350 343 351 414 412 431 368 368 368 368 368 368 368 429 430 411 414 414 414 414 414 414 414 414 412 431 368 827 829 368 368 368 368 368 336 337 368 368 368 368 368 368 827 829 368 368 368 368 368 368 368 368 368 368 368 368 368 368 368 368 368 368 368 368 368 368 368 368 368
368 368 368 368 368 368 368 368 368 368 368 368 368 368 368 368 368 368 368 368 378 116 388 827 829 368 368 368 368 368 368 334 334 334 603 603 593 578 579 579 579 579 579 580 596 592 334 368 429 411 414 366 121 367 414 414 439 368 368 336 337 368 429 430 411 414 414 414 350 351 414 414 414 350 351 414 354 337 381 382 827 829 336 337 368 344 345 827 828 829 368 368 368 381 382 368 368 368 368 368 368 368 368 368 368 368 368 368 368 368 368 368 368 368 368 368 368 368 368 368
368 368 368 368 368 368 368 368 368 368 368 368 368 368 368 368 368 368 547 368 386 388 368 381 382 368 368 368 368 368 368 368 368 368 334 593 605 603 603 603 603 603 603 603 607 334 368 368 437 414 414 414 414 414 414 420 447 368 368 344 345 429 411 414 414 414 414 414 366 367 414 414 414 366 367 414 362 345 368 368 381 382 344 345 336 337 368 378 113 380 368 827 828 828 828 828 828 828 829 368 368 368 827 829 368 368 368 368 368 368 368 368 368 368 368 368 368 368 368 368
368 368 368 368 368 368 368 368 368 368 368 368 368 368 368 368 368 368 368 368 368 827 829 368 368 368 368 368 368 429 430 430 431 368 368 334 334 603 603 603 603 603 603 603 603 334 368 368 445 419 414 414 414 420 446 447 368 368 368 368 368 437 414 414 414 414 414 414 350 343 343 343 343 343 351 420 447 827 829 368 368 368 368 368 344 345 368 386 121 388 368 378 107 108 108 108 109 108 830 828 828 829 381 382 368 368 368 368 368 368 373 374 368 368 368 368 368 368 368 368
368 368 368 368 368 368 368 368 368 368 368 368 368 368 368 368 368 368 368 368 368 381 382 368 827 829 368 368 429 411 350 351 412 431 368 368 368 334 598 598 598 598 598 598 586 334 368 368 368 445 446 446 446 447 368 368 368 368 368 368 429 411 414 414 414 414 350 343 190 107 108 108 108 109 359 354 337 381 382 368 368 368 368 368 368 368 368 368 368 827 829 378 123 137 113 113 190 108 108 108 109 830 828 828 828 828 828 828 829 368 381 382 373 374 373 374 368 368 368 368
368 368 368 368 368 368 368 368 368 368 368 368 368 368 368 368 368 368 368 368 368 368 827 829 378 380 535 368 437 414 366 367 414 439 368 368 368 334 598 598 598 598 598 586 597 334 368 368 368 368 368 368 368 368 368 368 368 368 368 429 411 414 414 414 414 350 190 107 108 190 116 124 124 125 359 362 345 368 368 368 368 368 368 368 368 368 368 368 368 381 382 386 137 123 124 137 113 113 113 113 190 108 108 108 108 109 113 113 830 829 368 368 381 382 381 382 368 368 368 368
368 368 368 368 368 368 368 368 368 368 368 368 368 368 368 368 368 368 368 368 368 368 381 382 378 830 829 368 445 419 414 414 420 447 368 368 334 580 588 598 598 598 598 594 597 578 334 368 368 368 368 368 368 368 368 368 368 368 429 411 350 351 350 343 343 190 107 190 116 124 125 116 121 121 367 439 368 368 368 368 368 368 368 368 368 368 368 368 368 368 368 368 386 121 137 123 137 113 113 113 113 113 113 113 113 190 108 109 113 830 828 374 368 368 368 368 373 374 336 337
368 368 368 368 368 368 368 368 368 368 368 368 368 368 368 368 368 368 368 368 368 368 368 368 378 113 380 368 368 445 446 446 447 368 368 368 334 592 607 588 598 334 334 334 334 334 578 334 334 334 334 334 334 334 334 334 368 368 437 414 366 367 358 107 108 108 190 116 125 116 121 367 420 446 446 447 368 368 368 368 368 368 368 368 368 368 368 368 368 368 368 368 368 368 378 113 123 124 124 124 124 137 113 113 113 113 116 125 113 116 121 388 368 368 368 368 381 382 344 345
368 368 368 368 368 368 368 368 368 368 368 368 368 368 368 368 368 368 368 368 368 368 368 368 378 113 380 368 368 368 368 368 368 368 368 368 334 596 334 334 334 368 368 368 368 368 334 334 334 603 603 603 603 334 334 334 368 368 437 414 414 414 358 123 124 124 124 125 116 367 420 446 447 368 368 368 368 368 368 368 368 368 368 368 368 368 368 368 368 368 368 368 368 368 386 121 121 121 121 137 113 123 124 124 124 124 125 113 116 388 368 368 368 368 368 368 368 368 368 368
368 368 368 368 368 368 368 368 368 368 368 368 368 368 368 368 368 368 368 368 368 368 368 368 386 137 380 531 368 368 368 368 368 368 368 334 580 334 368 368 368 368 368 368 368 368 368 368 368 334 334 334 334 368 368 368 368 368 445 419 414 414 366 121 121 121 121 121 367 420 447 368 368 368 368 368 368 368 368 368 368 368 368 368 368 368 368 368 368 368 368 368 368 368 368 368 368 368 368 386 124 121 121 121 121 121 121 121 388 368 368 368 368 368 368 368 368 368 368 368
368 368 368 368 368 368 368 368 368 368 368 368 368 368 368 368 368 368 368 368 368 368 368 368 531 378 830 829 336 337 368 368 334 334 334 334 334 368 368 368 368 368 368 368 368 368 368 368 368 368 368 368 368 368 368 368 368 368 368 445 360 361 446 446 446 446 446 446 446 447 368 368 368 368 368 368 368 368 368 368 368 368 368 368 368 368 368 368 368 368 368 368 368 368 368 368 368 368 368 368 368 368 368 368 368 368 368 368 368 368 368 368 368 368 368 368 368 368 368 368
368 368 368 368 368 368 368 368 368 368 368 368 368 368 368 368 368 368 368 368 368 368 368 368 535 386 137 380 344 345 336 337 368 368 368 368 368 368 368 368 368 368 368 368 368 368 368 368 368 368 368 368 368 368 368 368 827 829 827 829 344 345 368 368 368 368 368 368 368 368 368 368 368 368 368 368 368 368 368 368 368 368 368 368 368 368 368 368 368 368 368 368 368 368 368 368 368 368 368 368 368 368 368 368 368 368 368 368 368 368 368 368 368 368 368 368 368 368 368 368
368 368 368 368 368 368 368 368 368 368 368 368 368 368 368 368 368 368 368 368 368 368 368 368 535 535 386 382 368 368 344 345 368 368 368 368 368 368 368 368 368 368 368 368 368 368 368 368 368 368 368 368 368 368 368 368 381 382 381 382 368 368 368 368 368 368 368 368 368 368 368 368 368 368 368 368 368 368 368 368 368 368 368 368 368 368 368 368 368 368 368 368 368 368 368 368 368 368 368 368 368 368 368 368 368 368 368 368 368 368 368 368 368 368 368 368 368 368 368 368