Route122_Layout (40x40)
368 368 368 368 368 373 374 368 368 368 368 368 368 368 368 368 368 368 368 368 368 336 337 373 374 373 374 368 368 368 368 368 368 368 368 368 368 368 368 368
368 368 368 368 368 381 382 368 368 368 368 368 368 368 368 368 368 368 368 368 368 344 345 381 382 381 382 336 337 368 368 368 368 368 368 368 368 368 368 368
368 368 368 368 368 368 336 337 368 368 368 368 368 368 368 368 368 368 368 368 368 368 368 368 368 368 368 344 345 373 374 368 368 368 368 368 368 368 368 368
368 368 368 368 368 368 344 345 368 368 368 368 368 368 368 368 368 368 368 368 368 368 368 368 368 368 368 368 368 381 382 373 374 336 337 368 368 368 368 368
368 368 368 368 368 373 374 368 368 368 368 368 368 368 368 368 368 368 368 368 368 368 368 368 368 368 368 368 368 368 368 381 382 344 345 368 368 368 368 368
368 368 368 368 368 381 382 368 368 368 368 368 368 368 368 368 368 368 368 368 368 368 368 368 368 368 368 368 368 368 368 368 368 368 336 337 368 368 368 368
368 368 336 337 373 374 368 368 368 368 368 368 368 368 368 368 368 368 368 368 368 368 368 368 368 368 368 368 368 368 368 368 368 368 344 345 368 368 368 368
368 368 344 345 381 382 368 368 368 368 368 368 368 368 368 370 401 401 401 401 401 401 401 401 401 401 372 368 368 368 368 368 368 368 368 373 374 368 368 368
368 336 337 368 368 368 368 368 368 368 368 368 368 368 370 238 107 108 108 108 108 108 108 108 109 113 191 372 368 368 368 368 368 368 368 381 382 368 368 368
368 344 345 368 368 368 368 368 368 368 370 401 401 401 190 190 115 107 108 108 108 108 109 113 117 113 113 239 372 368 368 368 368 368 368 368 373 374 368 368
368 373 374 368 368 368 368 368 368 370 238 113 107 108 108 190 190 115 113 113 113 113 117 113 191 108 109 191 191 372 368 368 368 368 368 368 381 382 368 368
368 381 382 368 368 368 368 368 370 190 190 113 115 113 107 108 108 190 107 108 108 109 191 108 108 109 191 109 113 191 372 368 368 368 368 368 368 373 374 368
368 373 374 368 368 368 368 370 238 107 108 108 190 113 115 113 107 108 190 113 113 191 109 113 113 117 113 191 108 109 191 372 368 368 368 368 368 381 382 368
368 381 382 368 368 368 370 190 115 115 107 108 108 108 190 107 115 113 113 113 113 113 191 108 109 191 108 109 113 191 109 239 372 368 368 368 368 336 337 368
373 374 368 368 368 561 115 107 190 115 115 113 107 108 108 190 190 107 108 108 108 108 109 113 117 109 113 117 113 113 117 117 117 560 368 368 368 344 345 368
381 382 368 368 368 561 115 115 107 190 115 107 115 113 107 108 108 190 113 113 113 113 117 109 117 117 113 117 113 113 117 117 117 560 368 368 368 368 373 374
336 337 368 368 368 561 115 115 115 107 190 115 115 107 115 113 113 113 113 113 113 113 117 117 117 117 113 117 113 113 117 117 117 560 368 368 368 368 381 382
344 345 368 368 368 561 115 115 115 115 113 115 115 115 115 113 113 113 113 113 113 113 117 117 117 117 116 125 113 116 125 117 117 560 368 368 368 368 336 337
336 337 368 368 368 561 115 115 115 115 113 115 115 115 123 124 137 113 113 116 124 124 125 117 117 117 117 113 113 117 113 117 117 560 368 368 368 368 344 345
344 345 368 368 368 561 115 115 115 115 113 115 115 123 169 137 115 113 113 117 113 116 169 125 117 117 117 116 124 125 113 117 117 560 368 368 368 368 373 374
373 374 368 368 368 561 115 115 115 115 113 115 123 169 137 115 123 124 124 125 113 117 113 116 125 117 117 117 113 113 116 125 117 560 368 368 368 368 381 382
381 382 368 368 368 561 115 115 115 123 137 123 137 113 115 123 169 169 169 169 124 125 116 125 116 125 117 117 113 113 117 113 117 560 368 368 368 368 336 337
336 337 368 368 368 561 115 115 115 113 123 137 123 137 123 137 113 113 113 113 116 169 125 116 125 116 125 117 116 124 125 116 125 560 368 368 368 368 344 345
344 345 368 368 368 561 115 115 123 137 113 123 137 115 113 123 124 124 124 124 125 116 169 125 113 117 113 117 117 113 113 117 552 568 368 368 368 368 373 374
373 374 368 368 368 561 115 123 137 115 113 113 115 123 124 137 113 113 113 113 113 117 116 169 124 125 116 125 117 113 113 117 560 368 368 368 368 368 381 382
381 382 368 368 368 561 123 137 115 123 124 137 123 169 137 123 124 124 124 124 124 125 117 116 169 169 125 113 117 113 113 117 560 368 368 368 368 373 374 368
373 374 368 368 368 569 553 115 123 137 113 115 113 113 123 169 169 169 169 169 169 169 125 117 116 169 169 124 125 116 124 125 560 368 368 368 368 381 382 368
381 382 368 368 368 368 561 123 137 123 137 123 124 137 113 113 113 116 169 169 169 169 169 125 117 116 169 169 169 125 552 544 568 368 368 368 368 336 337 368
368 336 337 368 368 368 569 553 115 113 115 113 113 123 124 124 124 125 113 116 169 169 159 169 125 117 552 544 544 544 568 368 368 368 368 368 368 344 345 368
368 344 345 368 368 368 368 561 115 113 123 124 124 169 169 169 169 169 124 125 116 145 167 145 145 122 560 368 368 368 368 368 368 368 368 368 336 337 368 368
368 336 337 368 368 368 368 561 123 137 113 113 113 113 116 169 169 169 169 169 122 1 1 1 1 1 560 368 368 368 368 368 368 368 368 368 344 345 368 368
368 344 345 368 368 368 368 569 553 123 124 124 124 124 125 552 544 544 544 553 1 1 1 1 1 552 568 368 368 368 368 368 368 368 368 368 368 373 374 368
368 368 373 374 368 368 368 368 569 544 544 544 544 544 544 568 368 368 368 569 544 544 544 544 544 568 368 368 368 368 368 368 368 368 368 373 374 381 382 368
368 368 381 382 368 368 368 368 368 368 368 368 368 368 368 368 368 368 368 368 368 368 368 368 368 368 368 368 368 368 368 368 368 368 368 381 382 368 368 368
368 368 336 337 368 368 368 368 368 368 368 368 368 368 368 368 368 368 368 368 368 368 368 368 368 368 368 368 368 368 368 368 368 368 368 373 374 368 368 368
368 368 344 345 373 374 368 368 368 368 368 368 368 368 368 368 368 368 368 368 368 368 368 368 368 368 368 368 368 368 368 368 368 336 337 381 382 368 368 368
368 368 368 368 381 382 373 374 368 368 368 368 368 368 368 368 368 368 368 368 368 368 368 368 368 368 373 374 368 368 373 374 368 344 345 368 368 368 368 368
368 368 368 368 368 368 381 382 336 337 368 368 373 374 336 337 368 376 2 2 2 2 377 368 336 337 381 382 373 374 381 382 336 337 368 368 368 368 368 368
368 368 368 368 368 368 368 368 344 345 336 337 381 382 344 345 336 357 1 1 1 1 356 337 344 345 368 368 381 382 368 368 344 345 368 368 368 368 368 368
368 368 368 368 368 368 368 368 368 368 344 345 368 368 368 368 344 365 69 1 1 71 364 345 368 368 368 368 368 368 368 368 368 368 368 368 368 368 368 368