Route114_FossilManiacsTunnel_Layout (13x26)
631 631 616 617 617 617 617 617 617 618 631 631 631
631 616 632 616 617 617 617 617 618 626 631 631 631
631 624 616 632 616 617 617 618 626 634 618 631 631
631 624 624 616 632 771 772 626 634 618 626 631 631
631 624 624 624 771 796 765 634 618 626 626 631 631
631 624 624 624 687 633 773 772 626 626 626 631 631
631 624 624 624 788 633 633 711 626 626 626 631 631
631 624 624 624 788 633 633 765 626 626 626 631 631
631 624 624 772 709 633 633 765 626 626 626 631 631
631 624 772 696 624 788 633 703 626 626 626 631 631
631 631 696 624 624 788 633 765 626 626 626 631 631
631 631 624 624 624 788 633 710 771 626 626 631 631
631 631 624 624 624 687 765 626 695 626 634 618 631
631 631 624 624 624 788 765 626 788 634 618 626 631
631 631 624 624 624 788 765 626 788 633 626 626 631
631 631 624 624 624 788 765 626 788 633 626 626 631
631 616 632 624 772 709 765 626 788 633 626 626 631
631 624 765 624 765 624 780 626 797 789 626 626 631
631 624 711 624 765 624 780 634 618 788 626 634 618
631 624 765 624 703 624 779 772 626 788 626 788 626
631 624 765 624 765 624 788 765 626 788 626 797 626
631 624 765 624 765 624 788 703 626 788 634 618 626
616 632 765 624 799 624 788 765 626 797 789 626 626
624 633 765 624 616 632 788 765 634 618 788 626 626
624 633 765 624 624 771 796 773 772 626 788 626 626
624 633 765 624 624 788 689 690 765 626 788 626 626