Route110_TrickHousePuzzle5_Layout (15x22)
513 513 513 513 513 513 513 513 513 513 513 513 514 623 516
521 521 521 521 521 521 521 521 521 521 521 521 522 631 524
616 616 616 616 616 528 528 528 528 528 616 616 528 528 528
616 616 616 520 520 520 520 520 520 520 520 520 520 616 616
616 616 520 520 520 520 520 520 520 520 520 520 520 616 616
616 520 520 520 520 520 520 616 616 520 520 520 520 616 616
616 520 520 520 520 616 616 616 616 616 520 520 520 520 616
616 520 520 520 520 616 616 616 616 616 520 520 520 520 616
616 520 520 520 616 616 616 616 616 520 520 520 520 520 616
616 616 531 616 616 616 616 616 616 520 520 520 520 520 616
616 616 616 616 616 616 616 520 520 520 520 520 520 616 616
616 616 616 616 616 616 520 520 520 520 520 520 616 616 616
616 616 616 616 616 520 520 520 520 520 520 616 616 616 616
616 616 616 616 616 520 520 520 520 616 616 616 616 616 616
616 616 616 616 616 520 520 520 616 616 616 616 616 616 616
616 616 616 616 616 616 520 520 616 616 616 616 616 616 616
616 616 616 616 616 616 616 520 616 616 616 616 616 616 616
616 616 616 616 616 616 520 520 520 616 616 616 616 616 616
616 616 616 616 616 520 520 520 520 520 616 616 616 616 616
520 520 520 520 520 520 520 520 520 520 616 616 616 616 616
520 520 616 616 616 520 520 520 520 520 616 616 616 616 616
529 530 616 616 616 616 520 520 520 616 616 616 616 616 616