Route119_WeatherInstitute_1F_Layout (20x13)
607 607 622 619 607 607 607 619 607 607 607 607 607 648 649 607 636 637 638 607
615 615 4 619 615 615 615 619 556 557 556 557 615 656 657 615 644 645 646 639
620 621 630 619 618 634 634 619 564 565 564 565 618 664 665 634 652 653 654 647
628 629 594 627 626 594 594 627 618 634 634 634 631 594 594 594 594 594 594 594
626 594 594 624 626 594 594 624 626 594 594 608 609 594 594 594 608 609 594 594
626 594 594 632 626 594 594 632 626 594 606 595 596 598 594 606 595 596 598 594
626 597 594 640 631 594 594 640 631 594 594 650 651 594 594 594 650 651 594 597
655 614 602 616 594 594 594 616 602 602 602 602 602 602 602 602 602 602 602 614
607 607 607 624 594 594 594 624 607 607 607 607 607 607 607 607 607 607 607 607
615 615 615 632 594 594 594 632 615 615 615 615 615 615 615 615 615 615 615 615
618 634 634 640 594 594 594 640 634 634 634 634 634 634 634 634 634 634 634 634
626 594 594 594 594 594 594 594 597 594 594 597 594 594 594 594 594 594 594 594
626 594 594 594 594 594 594 594 605 518 519 605 594 594 594 594 594 594 594 594