Route104_MrBrineysHouse_Layout (12x9)
739 689 690 533 739 535 535 740 533 702 703 740
747 697 698 541 747 543 543 748 672 710 711 748
755 705 706 545 755 545 545 756 680 718 719 756
691 692 553 553 553 553 553 553 553 553 553 553
691 553 553 553 553 553 553 590 591 553 553 553
545 553 553 553 553 553 553 598 599 580 553 553
545 553 553 553 553 553 553 553 553 553 553 553
800 792 792 792 792 792 792 792 792 792 792 792
803 795 795 795 795 528 529 795 795 795 795 795