Route103_Layout (80x20)
468 469 468 469 468 469 468 469 468 469 468 469 468 469 468 469 468 469 468 469 468 469 468 469 468 469 400 368 368 368 368 368 368 368 368 368 368 368 368 368 368 402 115 113 113 115 113 113 113 115 113 113 113 113 113 113 113 113 113 113 113 113 113 113 113 113 113 113 113 113 113 113 113 116 124 125 113 113 113 117
476 477 476 477 484 485 484 485 484 485 484 485 484 485 484 485 476 477 476 477 476 477 476 477 476 477 400 373 374 368 368 368 368 368 368 368 368 368 373 374 368 402 123 124 137 115 113 113 113 123 137 113 113 113 113 116 124 124 124 124 124 124 124 137 113 113 113 113 113 113 113 113 116 125 113 113 113 113 113 117
468 469 468 469 1 1 1 1 1 1 13 13 13 13 13 13 468 469 468 469 468 469 468 469 468 469 400 381 382 368 368 368 368 368 368 368 368 368 381 382 368 410 393 385 115 123 137 113 113 113 123 124 124 124 124 125 113 116 169 169 169 137 113 123 124 124 124 124 124 124 124 124 125 113 113 113 113 113 113 117
476 477 484 487 1 1 1 1 464 465 465 466 13 13 13 13 486 485 476 477 476 477 476 477 484 487 400 368 368 368 368 368 368 373 374 336 337 368 368 368 368 368 368 402 123 137 115 113 116 124 169 169 169 169 169 169 124 125 113 113 113 123 124 169 169 169 169 169 169 169 169 169 169 124 124 124 124 124 124 125
468 469 13 13 1 1 1 1 480 481 481 482 1 13 13 13 13 13 468 469 468 469 468 469 392 393 408 368 373 374 368 368 368 381 382 344 345 368 368 373 374 368 368 410 385 115 123 124 125 116 206 206 206 206 206 206 145 145 121 121 121 145 206 206 206 206 206 206 206 206 206 206 206 206 206 206 206 206 206 206
476 477 13 13 13 13 213 135 135 135 135 135 135 111 13 13 13 13 486 485 476 477 476 477 356 337 368 368 381 382 373 374 336 337 368 368 368 336 337 381 382 373 374 336 357 115 113 113 113 117 198 198 198 198 198 198 1 331 332 332 332 333 199 22 199 22 199 22 199 22 199 199 199 22 199 22 199 199 199 199
468 469 13 13 13 13 13 13 13 1 1 1 1 141 135 135 135 135 135 214 468 469 468 469 364 345 373 374 368 368 381 382 344 345 368 368 368 344 345 368 368 381 382 344 365 123 124 124 124 122 22 22 198 198 198 198 15 275 276 276 276 277 22 15 22 15 22 1 22 1 22 22 22 15 199 15 199 22 199 23
476 477 13 13 13 13 13 13 13 1 1 1 1 1 1 1 1 1 1 1 486 485 484 487 400 368 381 382 368 368 368 368 368 368 368 368 368 368 368 368 368 368 368 368 410 393 393 393 394 1 1 1 22 198 198 199 199 15 1 15 1 15 1 22 15 22 15 1 15 1 15 15 1 199 22 22 22 1 22 1
468 469 13 13 13 13 13 13 13 1 1 1 1 464 465 465 465 466 1 1 1 1 392 393 408 368 368 368 368 368 368 368 368 368 368 368 368 368 368 368 368 368 368 368 368 368 368 368 402 1 1 1 1 22 22 199 199 199 15 199 15 199 15 1 22 1 22 1 22 15 22 199 1 22 1 1 1 1 1 1
476 477 454 455 13 13 13 13 13 1 1 3 1 480 481 473 473 473 466 1 1 1 400 368 368 368 368 368 368 368 368 368 368 368 368 368 368 368 368 368 368 368 368 368 368 368 368 368 402 1 280 281 281 282 1 22 22 22 199 22 199 22 199 15 15 15 15 15 15 22 1 22 1 1 1 280 281 281 281 281
468 469 468 471 13 13 13 13 1 1 1 1 1 1 1 480 481 481 482 1 1 1 400 368 368 368 368 368 368 368 368 368 368 368 368 368 368 368 368 368 368 368 368 368 368 368 368 368 402 1 296 297 289 289 281 281 281 282 22 1 22 1 22 22 22 22 22 22 22 1 1 1 1 280 281 289 289 297 297 297
476 477 476 477 13 13 13 13 1 1 1 1 1 1 13 13 13 13 1 1 1 1 400 368 368 368 368 368 368 368 368 368 368 368 368 368 368 368 368 368 368 368 368 368 368 368 368 368 402 1 1 1 296 297 297 297 289 289 281 281 281 281 281 281 281 281 281 281 281 281 281 281 281 289 289 297 298 1 1 1
468 469 468 469 213 135 135 135 135 135 135 135 135 214 13 13 13 13 13 1 1 1 2 212 377 368 368 368 368 368 368 368 368 368 368 368 368 368 368 368 368 368 368 368 368 368 368 368 402 1 1 15 15 15 1 15 296 297 297 297 297 297 297 297 297 297 297 297 297 297 297 297 297 297 298 1 1 14 14 14
476 477 476 477 1 1 1 1 1 1 1 13 13 13 13 13 13 13 454 463 462 463 462 463 356 337 336 337 368 368 368 368 368 368 368 368 368 368 373 374 368 368 368 368 368 403 403 403 402 1 15 199 199 199 15 199 15 15 1 15 1 15 1 15 1 15 1 15 1 15 1 15 1 14 14 1 14 199 199 199
468 469 468 469 1 1 1 1 1 1 1 13 13 13 13 13 13 13 470 469 468 469 468 471 364 345 344 345 373 374 368 368 368 368 336 337 336 337 381 382 368 373 374 368 376 198 198 198 29 15 199 199 199 199 199 199 199 22 15 22 15 22 15 22 15 22 15 22 15 22 15 22 15 22 199 14 199 199 199 199
476 477 476 477 462 463 1 1 1 1 1 1 454 455 454 455 454 455 476 477 476 477 476 477 648 649 377 368 381 382 373 374 336 337 344 345 344 345 368 336 337 381 382 336 357 198 199 199 199 199 199 199 199 199 199 199 199 15 22 15 22 15 22 15 22 15 22 15 22 15 22 15 22 15 22 199 199 199 199 199
468 469 468 469 468 471 1 1 1 1 1 1 470 469 468 469 468 469 468 469 468 469 468 469 468 471 400 368 368 368 381 382 344 345 368 368 368 368 368 344 345 368 368 344 365 198 198 198 198 199 199 199 199 199 199 199 199 199 15 199 15 199 15 199 15 199 15 199 15 199 15 199 15 199 15 199 199 199 199 199
476 477 476 477 476 477 462 463 1 1 1 1 476 477 476 477 476 477 476 477 476 477 476 477 476 477 400 373 374 368 368 368 368 368 368 368 368 368 368 368 368 368 368 368 402 198 198 198 198 199 199 199 199 199 199 199 199 199 199 199 199 199 199 199 199 199 199 199 199 199 199 199 199 199 199 199 199 199 199 199
468 469 468 469 468 469 468 471 1 1 1 1 468 469 468 469 468 469 468 469 468 469 468 469 468 469 400 381 382 368 368 368 368 368 368 368 368 368 368 368 368 368 368 376 29 198 198 198 198 199 199 199 199 199 199 199 199 199 199 199 199 199 199 199 199 199 199 199 199 199 199 199 199 199 199 199 199 199 199 199
476 477 476 477 476 477 476 477 1 1 1 1 476 477 476 477 476 477 476 477 476 477 476 477 476 477 400 368 368 368 368 368 368 368 368 368 368 368 368 368 368 368 368 402 198 198 198 198 198 199 199 199 199 199 199 199 199 199 199 199 199 199 199 199 199 199 199 199 199 199 199 199 199 199 199 199 199 199 199 199