Route114_FossilManiacsHouse_Layout (10x8)
689 690 533 749 750 751 533 533 533 534
697 698 541 757 758 759 541 790 791 542
705 706 545 765 766 774 775 686 687 576
545 553 553 553 553 782 783 694 695 726
545 590 591 580 553 726 726 553 553 553
601 598 599 553 553 553 553 553 553 553
800 792 792 792 792 792 792 792 792 792
803 795 795 795 528 529 795 795 795 795