Route113_Layout (100x20)
633 633 633 633 633 633 633 633 633 633 633 765 624 624 624 558 516 622 621 622 621 622 621 622 621 622 621 622 621 622 621 622 621 622 621 622 621 622 621 622 621 622 621 622 621 622 621 622 621 622 621 622 621 622 621 622 621 622 621 622 621 622 621 622 621 622 621 622 621 622 621 622 621 622 621 622 525 524 621 622 621 622 621 622 621 622 621 622 621 622 525 513 108 108 108 108 108 108 108 108
789 633 633 633 633 633 633 633 633 633 633 765 624 624 624 542 524 630 629 525 524 630 629 630 629 630 629 525 524 630 629 630 629 630 629 630 629 630 629 630 629 525 524 525 524 525 524 525 524 525 524 525 524 525 524 525 524 525 524 621 622 621 622 621 622 525 524 525 524 525 524 525 524 621 622 621 517 516 622 525 524 525 524 525 524 525 524 525 524 525 536 521 113 107 108 108 108 108 108 108
797 798 798 798 798 798 798 798 798 798 798 799 624 624 624 542 516 622 621 517 516 622 621 622 621 622 621 517 516 622 621 622 734 735 735 766 621 622 621 622 621 517 536 522 522 522 522 522 522 522 522 522 522 522 522 559 536 536 536 524 525 524 525 524 525 536 536 536 559 536 536 536 536 524 525 524 525 524 525 538 559 522 522 522 513 514 514 514 514 514 514 190 107 190 113 113 113 113 113 113
617 617 617 617 617 617 617 617 617 617 617 617 632 624 624 542 524 630 629 525 524 525 524 525 524 525 524 621 622 621 622 525 742 743 743 774 524 525 524 525 524 525 522 522 522 522 522 522 522 522 522 522 522 522 522 543 536 536 536 536 536 536 522 522 536 536 553 536 543 536 536 536 536 536 536 536 536 536 536 537 543 522 522 522 521 113 147 148 113 107 108 108 190 113 113 113 113 113 113 113
617 617 617 617 617 617 617 617 617 617 617 617 617 632 624 542 516 622 621 517 539 540 540 540 540 540 549 524 525 524 525 536 750 751 767 782 536 536 522 522 522 522 522 522 522 522 522 522 513 514 514 515 522 522 522 543 536 536 534 536 522 522 522 522 522 536 536 536 543 536 536 536 553 536 536 536 536 536 536 536 543 522 522 522 521 113 155 156 113 123 124 124 137 113 113 113 116 124 124 124
617 617 617 617 617 617 617 617 617 617 617 617 617 617 632 542 524 630 629 525 536 536 553 536 536 536 542 536 536 536 536 3 758 759 775 783 536 522 522 522 522 522 522 522 522 522 522 522 521 113 113 523 522 522 522 543 536 536 536 536 522 522 522 522 522 522 536 536 543 536 536 536 536 536 536 536 536 536 536 536 543 522 522 522 529 124 124 124 124 145 137 225 123 124 124 124 125 113 113 113
625 625 625 625 625 625 625 625 625 625 625 625 625 625 625 542 516 622 621 517 536 536 536 536 522 522 542 536 536 553 536 536 536 536 536 536 522 522 522 522 522 522 522 522 522 536 536 536 521 113 113 523 536 536 536 543 522 522 522 522 522 522 522 522 522 513 514 515 543 516 517 516 517 516 517 536 536 536 536 536 543 522 522 522 522 3 536 536 730 1 120 121 137 113 113 113 113 113 116 121
648 649 649 649 650 633 648 748 649 649 650 633 671 633 723 542 524 630 629 525 536 536 522 522 522 522 542 536 536 536 536 536 536 536 536 522 522 522 522 522 522 522 522 536 536 536 536 536 521 113 113 523 536 536 536 543 522 522 522 522 522 522 522 522 522 521 113 523 543 524 621 622 621 622 525 539 540 540 540 540 551 522 522 522 522 536 536 536 738 1 1 1 120 121 121 121 121 121 122 1
656 667 667 657 658 633 656 657 667 667 658 633 633 723 536 542 536 524 525 536 522 522 522 522 522 522 550 540 540 549 536 536 536 536 536 522 522 522 522 522 513 514 514 514 515 536 536 536 529 416 121 531 539 540 540 551 522 522 522 522 522 522 536 536 536 521 113 523 543 516 629 525 524 525 522 522 522 522 522 522 522 522 522 522 522 536 536 738 1 1 1 1 1 1 1 1 1 1 280 281
664 665 665 764 666 633 664 665 764 665 666 3 633 731 536 550 540 540 541 522 522 522 522 522 522 522 522 522 522 542 536 536 536 536 536 536 536 522 522 522 521 113 113 113 523 536 536 536 536 536 536 536 522 522 522 522 522 522 522 522 522 522 536 536 536 529 121 531 543 524 525 522 522 522 522 522 522 522 522 522 522 522 522 522 536 536 738 1 1 1 1 1 1 1 1 1 1 1 296 297
633 633 633 633 633 633 633 633 633 633 633 633 633 731 536 536 536 536 536 536 522 522 522 522 522 522 522 522 522 550 540 540 540 540 541 536 536 522 522 522 521 113 113 113 523 536 536 536 536 536 536 536 522 522 522 522 522 522 522 548 540 541 536 536 536 539 540 540 551 536 536 522 522 522 522 522 522 522 522 522 522 522 522 522 536 730 1 1 1 1 1 1 1 1 1 1 1 1 1 1
648 649 649 649 650 633 648 649 748 649 650 633 723 536 536 536 536 536 536 536 536 536 522 522 522 522 522 522 522 522 522 522 522 536 536 536 536 536 522 522 521 113 113 113 523 536 536 536 536 536 536 536 536 536 522 522 522 522 522 543 536 536 536 536 536 536 536 536 536 536 536 522 522 522 522 522 522 522 522 522 522 522 536 536 536 730 1 1 1 1 104 105 105 105 105 105 105 105 105 105
656 657 667 667 658 671 656 667 667 667 658 633 731 536 536 536 536 536 536 536 536 536 522 522 522 522 522 522 522 522 522 522 522 536 536 536 536 536 536 537 521 113 113 113 191 514 515 513 515 536 536 536 536 536 536 522 522 522 522 543 536 536 536 536 536 536 536 536 536 536 536 536 536 522 522 522 522 513 514 514 514 514 514 514 514 514 105 105 105 105 190 113 113 113 107 108 108 108 108 108
664 764 665 665 666 633 664 665 665 665 666 518 517 516 517 516 517 536 536 536 536 536 522 522 522 522 522 522 522 522 522 522 522 536 536 536 536 536 536 538 521 113 113 113 113 113 523 529 531 536 536 536 538 513 514 514 515 513 515 543 536 516 517 516 517 516 517 516 517 516 517 516 517 516 517 538 537 521 113 225 225 107 108 108 108 108 108 108 108 108 108 108 109 225 115 113 113 113 113 113
518 519 518 519 518 519 518 519 518 519 518 620 621 620 525 524 621 517 516 517 516 517 516 517 516 517 522 522 522 522 522 522 536 536 536 536 516 517 516 517 529 137 113 113 113 113 523 537 516 517 516 517 537 521 113 113 523 529 531 543 516 622 525 524 621 622 621 622 525 524 621 622 525 524 525 513 514 190 107 108 108 190 107 108 108 108 108 108 108 109 113 113 117 107 190 113 113 113 113 113
627 628 627 628 627 527 526 628 627 527 526 628 627 628 517 516 629 630 629 630 629 630 629 630 629 525 513 514 514 514 514 514 514 514 515 537 524 621 622 621 517 529 121 121 121 121 531 516 622 525 524 621 517 521 113 113 523 539 540 551 524 630 517 516 629 630 629 630 517 516 629 630 517 516 517 521 147 148 115 113 113 113 115 113 113 113 113 116 124 125 113 113 117 115 113 113 113 113 113 113
527 526 619 620 619 519 518 620 619 519 518 620 619 620 621 622 621 622 525 524 621 622 525 524 621 517 521 113 113 113 113 113 113 113 191 514 515 524 525 524 621 517 516 517 516 517 516 622 621 517 516 622 525 521 113 113 191 514 515 536 516 622 621 622 621 622 621 622 621 622 621 622 621 622 525 521 155 156 115 113 113 113 123 124 124 124 124 125 113 116 124 124 125 115 113 113 113 113 113 113
519 518 627 628 627 628 627 628 627 628 627 628 627 628 629 630 629 630 517 516 629 630 517 516 629 525 521 113 113 113 113 113 113 113 113 113 523 516 517 516 629 630 629 630 629 630 629 630 629 630 629 630 517 521 113 113 113 113 523 516 629 630 629 630 629 630 629 630 629 630 629 630 629 630 517 521 113 113 123 124 137 113 113 113 113 113 116 124 124 125 113 113 113 123 124 124 124 124 124 124
619 620 619 620 619 620 619 620 619 620 619 620 619 620 619 622 621 622 621 622 621 622 621 622 621 517 521 113 113 113 113 113 113 113 113 113 523 524 621 622 621 622 621 622 621 622 621 622 621 622 621 622 525 521 113 113 113 113 523 524 621 622 621 622 621 622 621 622 621 622 621 622 621 622 525 521 113 113 113 113 123 124 124 124 124 124 125 113 113 113 113 113 113 113 113 113 113 113 113 113
627 628 627 628 627 628 627 628 627 628 627 628 627 628 627 630 629 630 629 630 629 630 629 630 629 525 529 121 121 121 121 121 121 121 121 121 531 516 629 630 629 630 629 630 629 630 629 630 629 630 629 630 517 529 121 121 121 121 531 516 629 630 629 630 629 630 629 630 629 630 629 630 629 630 517 529 121 121 121 121 121 145 145 145 145 145 121 121 121 121 121 121 121 121 121 121 121 121 121 121