Route109_SeashoreHouse_Layout (15x10)
513 514 514 516 517 558 559 514 514 514 516 517 514 514 515
521 518 519 524 525 566 567 543 522 522 524 525 518 519 523
529 526 527 542 538 538 530 551 542 538 538 538 526 527 531
546 556 556 557 548 548 556 556 557 548 548 548 556 556 550
544 537 549 536 528 537 549 549 536 528 537 549 549 536 545
532 538 554 538 538 538 554 554 538 538 538 554 554 538 533
544 537 548 536 528 537 548 548 536 528 537 548 548 536 545
540 539 549 539 539 539 549 549 539 539 539 549 549 539 541
544 537 554 554 554 554 554 554 554 554 554 554 554 536 545
540 539 549 549 549 549 534 535 549 549 549 549 549 539 541