Route110_TrickHouseEntrance_Layout (12x8)
533 533 533 535 530 531 532 533 535 533 702 703
541 541 541 543 538 539 540 541 543 672 710 711
545 545 545 545 545 545 545 545 545 680 718 719
545 553 553 553 580 590 591 580 553 553 553 553
793 553 553 553 580 598 599 580 553 553 553 794
807 553 553 553 553 553 553 553 553 553 553 802
800 792 792 792 792 792 792 792 792 792 792 792
803 795 795 795 795 528 529 795 795 795 795 795