Route105_Layout (40x80)
368 368 368 368 368 368 368 336 337 368 368 368 368 368 368 368 368 368 368 368 368 368 368 368 368 368 336 337 368 368 368 378 468 469 468 469 468 469 468 469
368 368 368 368 368 368 368 344 345 368 368 368 368 368 368 368 368 368 368 368 368 368 368 368 368 368 344 345 368 368 368 378 476 477 476 477 476 477 476 477
368 368 368 368 368 368 368 373 374 368 368 368 368 368 368 368 368 368 368 368 368 368 368 368 368 368 368 336 337 368 368 378 468 469 468 469 468 469 468 469
368 368 368 368 368 336 337 381 382 368 368 368 368 368 368 368 368 368 368 368 368 368 368 368 368 368 368 344 345 368 368 378 486 485 476 477 476 477 476 477
368 368 368 368 368 344 345 368 368 368 368 368 373 374 368 368 368 368 368 368 368 368 368 368 368 368 373 374 368 368 368 386 121 137 468 469 468 469 468 469
368 368 368 368 368 373 374 368 368 368 368 368 381 382 368 368 368 368 368 368 368 368 368 368 368 368 381 382 368 368 368 368 368 378 486 485 476 477 476 477
368 368 368 368 368 381 382 368 368 368 368 368 368 368 368 368 368 368 368 368 368 368 368 368 368 368 368 368 373 374 368 368 368 386 121 137 468 469 468 469
368 368 368 368 368 368 373 374 368 368 368 368 368 368 336 337 368 368 368 368 368 368 368 368 368 368 368 368 381 382 368 370 372 368 368 378 486 485 484 485
368 368 368 368 368 368 381 382 368 368 368 368 368 368 344 345 368 368 368 368 368 368 368 368 368 368 368 368 368 368 370 180 380 368 368 386 121 121 121 121
368 368 368 368 368 336 337 336 337 368 368 368 368 368 368 368 368 368 368 368 368 368 368 368 368 368 368 368 368 368 378 113 380 368 368 368 368 368 368 368
368 368 368 368 368 344 345 344 345 336 337 368 368 336 337 368 368 368 368 368 368 368 368 368 368 368 368 336 337 368 378 113 380 368 368 368 368 368 368 368
368 368 368 368 336 337 368 368 368 344 345 336 337 344 345 336 337 368 368 368 368 368 368 368 368 368 368 344 345 368 378 113 380 368 368 368 368 368 368 368
368 368 368 368 344 345 368 368 368 368 368 344 345 368 368 344 345 368 368 368 368 368 368 368 368 368 368 368 368 368 378 113 380 368 368 368 368 368 368 368
368 368 336 337 368 368 368 368 368 368 368 368 368 368 368 368 336 337 368 368 368 368 368 368 368 368 336 337 368 370 180 113 380 368 368 368 368 368 368 368
368 368 344 345 368 368 368 368 368 368 368 368 368 368 368 368 344 345 368 368 368 368 368 368 368 368 344 345 368 378 113 116 388 368 368 368 368 368 368 368
336 337 368 368 368 373 374 368 368 368 368 368 373 374 368 336 337 368 368 368 368 368 368 368 368 368 368 368 368 378 113 380 368 370 372 368 368 368 368 368
344 345 368 368 368 381 382 368 368 368 368 368 381 382 368 344 345 336 337 368 368 368 368 368 368 368 368 368 368 378 113 380 370 180 380 368 368 368 368 368
368 336 337 368 368 368 368 368 370 379 372 368 368 368 368 368 368 344 345 368 368 368 368 368 368 368 368 368 368 378 116 388 378 113 380 368 368 368 368 368
368 344 345 368 368 368 368 370 115 113 117 372 368 368 368 368 336 337 368 368 368 368 368 368 368 368 368 368 368 378 380 368 386 121 388 368 368 368 368 368
336 337 368 373 374 368 283 136 123 100 125 138 285 368 373 374 344 345 336 337 368 368 368 368 368 368 368 368 368 378 380 368 368 368 368 368 368 368 368 368
344 345 368 381 382 368 291 144 121 167 145 146 293 368 381 382 368 368 344 345 368 368 368 368 368 368 368 336 337 386 388 368 368 368 368 368 368 368 368 368
336 337 368 368 368 368 291 292 292 292 292 292 293 368 368 368 368 336 337 368 368 368 368 368 368 368 368 344 345 368 368 373 374 368 368 368 368 368 368 368
344 345 368 368 368 368 299 325 292 292 292 326 301 368 368 368 368 344 345 368 368 368 368 368 368 368 368 368 368 368 368 381 382 370 372 368 368 368 368 368
368 336 337 368 368 373 374 299 300 300 300 301 373 374 368 368 368 336 337 368 368 368 368 368 368 368 368 368 368 373 374 368 370 180 380 368 368 368 368 368
368 344 345 368 368 381 382 368 368 368 368 368 381 382 368 368 368 344 345 368 368 368 368 368 368 368 368 368 368 381 382 368 378 113 380 368 368 368 368 368
336 337 368 368 368 368 368 368 368 368 368 368 368 368 368 368 336 337 368 368 368 368 368 368 368 368 368 368 368 368 368 368 378 113 380 368 368 368 368 368
344 345 368 368 368 368 368 368 368 368 368 368 368 368 368 368 344 345 368 368 368 368 368 368 368 368 368 368 368 368 368 368 378 113 380 368 368 368 368 368
368 336 337 368 368 368 368 368 368 368 368 368 368 368 368 336 337 368 368 368 368 368 368 368 368 368 368 368 368 336 337 370 180 113 380 368 368 368 368 368
368 344 345 368 368 368 368 368 368 368 368 368 368 368 368 344 345 368 368 368 368 368 368 368 368 368 368 368 368 344 345 378 113 113 380 368 368 368 368 368
368 368 336 337 368 368 368 368 368 368 368 368 368 368 336 337 368 368 368 368 368 368 368 368 368 368 368 368 368 368 368 378 147 148 380 368 368 368 368 368
368 368 344 345 368 368 368 368 368 368 368 368 368 368 344 345 336 337 368 368 368 368 368 368 368 368 368 368 368 368 368 378 115 117 380 373 374 368 368 368
368 368 368 336 337 368 368 368 368 368 368 368 368 336 337 368 344 345 368 368 368 368 368 368 368 368 368 368 368 368 368 378 115 117 380 381 382 368 368 368
368 368 368 344 345 368 368 368 368 368 368 336 337 344 345 368 368 368 368 368 368 368 368 368 368 368 368 373 374 368 368 378 115 117 180 372 368 368 368 368
368 368 336 337 368 368 368 368 368 368 368 344 345 368 368 368 368 368 368 368 368 368 368 368 368 368 368 381 382 368 368 378 115 180 148 380 368 368 368 368
368 368 344 345 368 368 368 368 368 368 336 337 368 368 368 368 368 336 337 368 368 368 368 368 368 368 368 368 368 368 368 378 115 113 117 380 368 368 368 368
368 368 368 373 374 368 368 368 368 368 344 345 368 368 368 368 368 344 345 368 368 368 368 368 368 368 368 368 368 368 368 378 115 113 117 380 368 368 368 368
368 368 368 381 382 368 368 368 368 368 368 373 374 368 368 368 368 368 368 368 368 368 368 368 368 368 368 368 368 368 370 180 115 113 117 380 368 368 368 368
368 368 336 337 368 368 368 368 368 368 368 381 382 368 368 368 368 368 368 368 368 368 368 368 368 368 368 368 368 368 378 147 180 116 156 380 368 368 368 368
368 368 344 345 368 368 368 368 368 368 373 374 368 368 368 368 368 368 368 368 368 368 368 368 368 368 368 368 373 374 378 115 113 117 116 388 368 368 368 368
368 336 337 368 368 368 368 368 368 368 381 382 368 368 336 337 368 368 336 337 368 368 368 368 368 368 368 368 381 382 378 115 113 117 380 368 368 368 368 368
368 344 345 368 368 368 368 368 368 368 373 374 368 368 344 345 368 368 344 345 368 368 368 368 368 368 368 368 368 368 378 155 137 117 380 368 368 368 368 368
368 368 373 374 368 368 368 368 368 368 381 382 336 337 368 368 368 368 368 368 368 368 368 368 368 368 368 368 368 368 386 137 115 117 380 368 368 368 368 368
368 368 381 382 368 368 368 368 368 368 368 368 344 345 537 537 368 368 368 368 368 368 368 368 368 368 368 368 368 368 368 378 155 156 380 368 368 368 368 368
368 373 374 368 368 368 368 368 368 368 368 336 337 283 579 579 285 368 368 368 368 368 368 368 368 368 368 368 368 368 368 378 113 116 388 368 368 368 368 368
368 381 382 368 368 368 368 368 368 368 368 344 345 291 579 579 293 368 368 368 368 368 368 368 368 368 368 368 368 368 368 378 113 380 368 373 374 368 368 368
368 368 336 337 368 368 368 368 368 368 368 368 368 291 570 579 318 284 285 368 368 368 368 368 368 368 368 368 368 373 374 378 113 380 368 381 382 368 368 368
368 368 344 345 368 336 337 368 368 368 368 283 284 317 569 579 292 292 293 368 368 368 368 368 368 368 368 368 368 381 382 378 116 388 368 368 368 368 368 368
368 373 374 368 368 344 345 368 368 368 368 291 292 292 579 579 292 292 293 368 368 368 368 368 368 368 368 368 368 368 368 378 380 368 368 368 368 368 368 368
368 381 382 368 368 368 368 368 368 368 368 291 292 569 579 579 569 292 293 368 368 368 368 368 368 368 368 368 368 368 368 378 380 368 368 368 368 368 368 368
368 368 368 336 337 368 368 368 368 368 368 291 292 579 570 579 579 292 293 368 368 368 368 368 368 368 368 368 368 368 368 386 388 368 368 368 368 368 368 368
368 368 368 344 345 368 368 368 368 368 283 317 292 579 569 579 579 292 293 368 368 368 368 368 368 368 368 368 368 368 368 368 373 374 368 368 368 368 368 368
368 336 337 368 537 537 368 368 368 368 291 292 292 579 570 579 570 292 293 368 368 368 368 368 368 368 368 368 368 368 368 368 381 382 373 374 368 368 368 368
368 344 345 283 579 579 285 368 368 368 291 292 292 579 569 570 292 292 293 368 368 368 368 368 368 368 368 368 368 368 336 337 368 368 381 382 368 368 368 368
368 336 337 291 579 579 293 368 368 368 299 325 292 570 579 292 292 292 293 368 368 368 368 368 368 368 368 368 368 368 344 345 370 372 336 337 368 368 368 368
368 344 345 291 579 579 318 284 285 368 368 291 292 292 579 292 292 292 293 368 368 368 368 368 368 368 368 368 368 368 368 370 180 380 344 345 368 368 368 368
373 374 368 291 579 579 569 292 293 368 368 291 292 292 570 292 292 292 293 368 368 368 368 368 368 368 368 368 368 368 368 386 121 388 368 368 368 368 368 368
381 382 368 291 579 579 579 292 293 368 368 299 325 292 292 292 292 292 293 368 368 368 368 368 368 368 368 368 368 336 337 368 368 368 373 374 368 368 336 337
368 373 374 291 579 579 579 292 293 368 368 368 291 292 292 292 292 326 301 368 368 368 368 368 368 368 368 368 368 344 345 368 368 368 381 382 368 368 344 345
368 381 382 291 570 579 570 326 301 368 368 368 291 292 292 292 292 293 368 368 368 368 368 368 368 368 368 368 368 368 368 368 373 374 368 368 368 368 368 368
336 337 368 299 325 579 292 293 368 368 368 368 291 292 292 292 326 301 368 368 368 368 368 368 368 368 368 368 368 368 368 368 381 382 368 368 368 368 368 368
344 345 368 368 291 570 292 293 368 368 368 368 299 325 292 292 293 368 368 368 368 368 368 368 368 368 368 368 368 373 374 370 379 372 368 368 368 368 368 368
368 373 374 368 299 338 339 301 368 368 368 368 368 291 292 292 293 336 337 368 368 368 368 368 368 368 368 368 368 381 382 378 113 380 368 368 368 368 368 368
368 381 382 336 337 344 345 368 368 368 336 337 368 299 300 300 301 344 345 368 368 368 368 368 368 368 368 368 368 368 370 180 113 380 368 368 368 368 368 368
368 368 368 344 345 368 336 337 368 368 344 345 336 337 368 368 336 337 368 368 368 368 368 368 368 368 368 368 368 368 378 147 148 380 368 368 368 368 368 368
368 368 368 368 368 368 344 345 373 374 368 368 344 345 373 374 344 345 368 368 368 368 368 368 368 368 368 368 368 368 378 115 117 380 368 368 368 368 368 368
368 368 368 368 368 368 368 368 381 382 368 368 373 374 381 382 368 368 368 368 368 368 368 368 368 368 368 368 368 368 378 115 117 380 368 368 368 368 368 368
368 368 368 368 368 368 336 337 368 368 368 368 381 382 368 368 368 368 368 368 368 368 368 368 368 368 368 368 368 368 378 115 117 380 368 368 368 368 368 368
368 368 368 368 368 368 344 345 368 368 368 336 337 368 283 284 285 368 368 368 368 368 368 368 368 368 368 368 368 368 378 155 156 380 368 368 368 368 368 368
368 368 368 368 368 368 368 368 368 373 374 344 345 368 291 292 293 368 368 368 368 368 368 368 368 368 368 368 368 368 378 113 116 388 368 368 368 368 368 368
368 368 368 368 368 368 368 368 368 381 382 368 368 368 299 300 301 368 368 368 368 368 368 368 368 368 368 368 368 368 378 113 380 368 368 368 368 368 368 368
368 368 368 368 368 368 368 368 336 337 368 368 368 368 368 368 368 368 368 368 368 368 368 368 368 368 368 368 368 368 378 116 388 368 368 368 368 368 368 368
368 368 368 368 368 368 537 537 344 345 368 283 284 284 285 368 368 368 368 368 368 368 368 368 368 368 368 368 368 368 378 380 368 368 368 368 368 368 368 368
368 368 368 368 368 283 579 579 285 368 368 291 292 292 293 368 368 368 368 368 368 368 368 368 368 368 368 368 368 368 378 380 368 368 368 368 368 368 368 368
368 368 368 368 368 291 579 579 318 284 285 299 325 292 293 368 368 368 368 368 368 368 368 368 368 368 368 368 368 368 386 388 373 374 368 368 368 368 368 368
368 368 368 368 368 291 579 579 569 292 293 368 299 300 301 368 368 368 368 368 368 368 368 368 368 368 368 368 368 368 368 368 381 382 368 368 368 368 368 368
368 368 368 368 368 291 579 579 579 292 293 368 368 368 368 368 368 368 368 368 368 368 368 368 368 368 368 368 368 368 368 373 374 368 368 368 368 368 368 368
368 368 368 368 368 291 570 579 570 326 301 368 368 368 368 368 368 368 368 368 368 368 368 368 368 368 368 368 368 373 374 381 382 368 368 368 368 368 368 368
368 368 368 368 368 299 325 570 292 293 368 368 368 368 368 368 368 368 368 368 368 368 368 368 368 368 368 368 368 381 382 368 368 368 368 368 368 368 368 368
368 368 368 368 368 368 299 338 339 301 368 368 336 337 368 368 368 368 368 368 368 368 368 368 368 368 368 368 368 336 337 368 368 368 368 368 368 368 368 368
368 368 368 368 368 368 368 344 345 368 368 368 344 345 368 368 368 368 368 368 368 368 368 368 368 368 368 368 368 344 345 368 368 368 368 368 368 368 368 368