Route110_TrickHousePuzzle7_Layout (15x22)
513 513 513 513 513 513 513 513 513 513 513 513 514 623 516
521 521 521 521 521 521 521 521 521 521 521 521 522 631 524
528 528 528 528 528 528 615 639 640 582 644 528 528 528 528
520 520 520 615 613 520 615 520 656 520 613 520 612 614 520
520 520 520 615 574 520 615 520 608 520 640 520 614 520 520
641 643 614 615 520 615 520 574 614 520 634 599 598 599 599
599 599 598 603 599 599 635 603 598 628 629 622 605 622 622
621 621 604 621 629 633 629 622 622 622 622 624 606 624 590
590 624 606 637 591 624 591 637 637 637 624 632 630 632 590
590 632 630 645 591 632 591 645 645 645 632 612 614 520 614
614 612 614 615 520 574 615 520 520 520 520 520 614 612 614
614 614 615 520 640 520 615 612 520 520 520 520 574 520 613
614 614 615 520 656 520 615 611 613 613 613 613 613 640 614
614 614 615 613 613 613 613 613 613 613 613 613 609 656 614
614 614 615 520 520 520 520 612 612 612 612 615 614 613 614
614 614 615 520 615 613 613 613 613 613 615 520 613 614 614
614 614 615 520 615 615 613 613 613 520 615 520 574 614 614
520 520 615 520 520 615 520 520 520 520 615 520 520 611 614
520 520 615 641 643 520 520 613 613 613 613 613 520 615 614
520 520 520 583 520 520 613 520 613 613 613 613 613 613 614
520 520 520 520 520 613 613 520 520 520 615 520 520 520 614
529 530 520 520 613 613 520 520 520 520 612 612 612 612 614