Route104_Layout (40x80)
468 469 468 469 468 469 468 469 468 471 462 463 1 1 1 1 1 1 1 1 1 1 1 1 1 1 1 1 1 1 1 1 1 1 468 469 468 469 476 477
476 477 476 477 476 477 476 477 476 477 468 471 1 1 1 1 1 1 1 1 1 1 1 1 1 1 1 1 1 1 1 1 462 463 476 477 476 477 468 469
468 469 468 469 468 469 468 469 468 469 476 477 462 463 1 280 282 1 1 1 1 1 1 1 1 1 1 1 200 202 1 1 470 469 468 469 468 469 476 477
476 477 476 477 476 477 484 485 476 477 468 469 468 471 1 288 289 281 281 281 281 281 281 281 281 282 1 1 216 209 202 1 476 477 476 477 476 477 468 469
468 469 468 469 468 469 13 13 468 469 476 477 476 477 1 296 297 297 297 297 297 297 297 297 289 290 1 1 1 216 218 1 468 469 468 469 468 469 476 477
476 477 484 485 484 487 1 13 486 485 468 469 468 469 1 1 1 1 200 202 1 1 1 3 288 290 1 1 1 1 1 4 486 485 484 485 484 485 468 469
468 469 13 1 13 13 13 1 13 13 476 477 476 477 462 463 1 1 216 218 1 1 1 1 288 290 1 200 202 1 1 1 1 331 332 332 332 333 476 477
476 477 13 13 13 13 13 13 13 1 468 469 468 469 468 471 462 463 462 463 1 200 202 1 296 298 1 216 218 1 1 1 4 275 276 276 276 277 468 469
468 469 13 13 13 1 13 13 454 455 476 477 476 477 476 477 468 469 468 471 1 216 218 1 1 1 1 1 1 1 1 1 1 1 4 1 4 4 476 477
476 477 13 1 13 13 454 455 470 469 468 469 468 469 468 469 476 477 476 477 176 177 177 177 848 849 177 177 177 177 177 177 177 177 177 177 177 178 468 469
468 469 13 13 13 13 470 469 476 477 476 477 476 477 476 477 468 469 468 469 184 527 526 525 846 847 522 521 520 527 526 525 524 523 522 521 520 186 476 477
476 477 13 13 454 455 476 477 468 469 468 469 468 469 468 469 484 485 484 487 184 520 527 526 846 847 523 522 521 520 527 526 525 524 523 522 521 186 468 469
468 469 1 13 470 469 468 469 476 477 476 477 476 477 484 487 176 177 177 177 192 521 520 527 846 847 524 523 522 521 520 527 526 525 524 523 522 186 476 477
476 477 1 1 476 477 476 477 468 469 468 469 468 469 176 177 192 526 525 524 523 522 521 520 846 847 525 524 523 522 521 520 527 526 525 524 523 186 468 469
468 469 1 1 468 469 468 469 484 498 499 498 499 487 184 521 520 527 526 525 524 523 522 521 846 847 526 525 524 523 522 521 520 527 526 525 524 186 486 485
476 477 1 584 585 586 587 588 589 468 469 468 469 176 192 522 521 520 527 526 525 524 523 522 846 847 836 836 836 836 846 847 521 520 527 526 525 186 1 1
468 469 519 592 593 594 595 596 597 476 477 476 477 184 524 523 522 521 520 527 526 525 524 523 838 839 844 844 844 844 846 847 522 521 520 527 526 186 462 463
476 477 519 600 601 602 603 604 605 468 469 468 469 184 525 524 523 522 521 520 527 526 525 524 819 820 845 845 845 845 846 847 523 522 521 520 527 186 470 469
468 469 519 608 609 610 611 612 613 486 485 476 477 184 526 525 524 523 522 521 520 527 526 525 524 523 522 521 520 527 846 847 524 523 522 521 520 186 476 477
476 477 519 518 519 1 518 519 518 519 519 468 469 184 527 526 525 524 523 522 521 520 527 526 525 524 523 522 521 520 846 847 525 524 523 522 521 186 468 469
468 469 4 4 4 1 1 3 4 4 4 486 487 184 520 527 526 525 524 523 522 521 520 527 526 525 524 523 522 521 846 847 526 525 524 523 522 186 476 477
476 477 4 4 4 1 1 1 4 4 4 1 1 184 521 520 527 526 525 524 523 522 521 520 527 526 525 524 523 522 846 847 527 526 525 524 523 186 468 469
468 469 331 332 333 280 282 1 1 1 1 1 1 2 2 2 2 2 2 2 2 2 2 2 2 2 2 2 2 2 1 1 2 2 488 489 488 489 476 477
476 477 267 268 269 288 290 1 1 1 1 1 1 1 1 1 1 27 1 1 1 1 1 1 1 1 1 1 1 1 280 282 1 1 470 469 468 469 468 469
468 469 267 268 269 288 289 281 281 281 281 281 281 281 281 281 281 281 281 281 281 281 281 281 281 281 281 281 281 281 289 290 462 463 476 477 476 477 476 477
476 477 267 268 269 296 297 297 297 297 289 289 297 297 297 297 297 297 297 297 297 297 297 297 297 297 297 297 297 297 297 298 470 469 468 469 468 469 468 469
468 469 275 276 277 1 1 1 1 1 288 290 1 1 1 1 1 1 1 1 1 1 1 1 1 1 1 1 1 1 1 1 492 493 492 493 476 477 476 477
476 477 462 463 462 463 1 1 1 1 288 290 1 1 329 329 329 64 64 329 329 329 329 64 64 64 329 329 329 329 64 64 199 199 199 199 468 469 468 469
468 469 468 469 468 469 64 64 329 329 296 298 329 329 15 14 14 199 199 14 14 14 14 199 198 198 15 14 15 15 199 199 199 199 199 199 492 493 476 477
476 477 492 493 492 493 199 199 15 15 774 774 15 15 199 199 199 199 199 199 199 199 198 198 198 199 199 199 199 199 199 199 199 199 199 199 199 199 468 469
468 469 199 199 199 199 199 199 199 199 782 782 199 199 199 199 199 199 199 199 199 199 199 199 199 199 199 199 199 199 199 199 199 199 199 199 199 199 476 477
492 493 199 199 199 199 199 199 199 199 790 790 199 199 199 199 199 199 199 199 199 199 199 199 199 199 199 199 199 199 199 199 199 199 199 199 199 199 468 469
198 199 199 199 199 199 199 199 199 199 199 199 199 199 199 199 199 199 199 199 199 199 199 199 199 199 199 199 199 199 199 199 199 199 199 199 199 199 492 493
199 199 199 199 199 199 199 199 199 199 199 199 199 199 199 199 199 199 199 199 199 199 199 199 199 199 199 199 199 199 199 199 199 199 199 199 199 199 199 199
199 199 199 199 199 199 199 199 199 199 199 199 199 199 199 199 199 199 199 199 199 199 199 199 199 199 199 199 199 199 199 199 199 199 199 199 199 199 199 199
199 199 199 199 199 199 199 198 198 199 199 199 199 199 199 199 199 199 199 199 199 199 199 199 199 199 199 199 199 199 199 199 199 199 199 199 199 199 199 199
199 199 199 199 199 199 199 199 199 199 199 199 199 199 199 199 199 199 199 199 199 199 199 199 199 199 199 199 199 199 199 199 199 199 199 199 199 199 199 199
22 22 22 22 22 198 199 198 199 199 775 775 199 199 199 199 199 199 199 199 199 199 199 199 199 199 199 199 199 199 199 199 199 199 199 199 199 199 199 199
121 121 121 121 137 198 198 199 199 199 783 783 199 199 199 199 198 198 199 199 199 199 199 199 199 199 199 199 199 199 199 199 199 199 199 199 199 199 199 199
300 300 300 325 136 22 198 199 23 23 791 791 23 22 199 199 199 199 198 199 199 199 199 199 199 199 199 199 199 199 199 199 199 199 199 199 199 199 199 199
368 368 368 291 144 137 22 23 329 329 280 282 329 329 23 23 199 198 199 199 199 22 22 22 22 22 199 199 199 199 199 199 199 199 199 199 199 199 199 199
368 368 368 299 325 144 137 13 13 13 288 290 13 13 13 13 23 22 22 23 23 331 332 332 332 333 198 199 199 199 199 199 775 775 199 199 199 199 199 199
368 368 368 368 299 325 136 13 13 13 288 290 13 13 13 13 13 1 1 1 1 275 276 276 276 277 198 199 199 199 199 199 783 783 199 199 199 199 500 501
368 368 368 368 368 291 136 13 13 13 288 289 281 281 281 281 281 281 281 281 281 281 281 281 282 1 198 199 199 199 199 22 791 791 500 501 199 199 468 469
368 368 368 368 368 291 144 137 13 13 296 297 297 297 297 297 297 297 297 297 297 297 289 289 290 1 198 198 199 199 199 1 1 1 468 469 500 501 476 477
368 368 368 368 368 299 325 136 13 13 13 13 13 13 13 13 13 13 1 1 1 1 288 289 290 1 198 199 199 199 199 1 1 1 476 477 468 469 468 469
368 368 368 368 368 368 291 144 121 121 137 13 13 13 13 13 13 13 13 1 1 1 288 289 290 1 22 199 199 199 22 1 1 1 468 469 476 477 476 477
368 368 368 368 368 368 299 300 300 325 144 121 121 121 137 616 617 618 619 620 1 1 288 289 290 1 1 198 199 199 1 1 1 1 476 477 468 469 468 469
368 368 368 368 368 368 368 336 337 299 300 300 300 325 136 624 625 626 627 628 1 1 288 289 290 1 1 22 23 22 1 1 1 1 468 469 476 477 476 477
368 368 368 368 368 368 368 344 345 368 368 368 368 291 136 632 633 634 635 636 1 1 288 289 290 1 1 1 254 1 1 1 1 1 476 477 468 469 468 469
368 368 368 368 368 368 368 368 368 336 337 368 368 299 815 640 641 642 643 644 3 1 288 289 290 1 1 1 133 1 1 4 1 1 468 469 476 477 476 477
368 368 368 368 368 368 368 336 337 344 345 829 622 622 814 1 1 1 1 1 1 1 296 297 298 1 1 1 133 1 4 1 1 1 476 477 468 469 468 469
368 368 368 368 368 373 374 344 345 368 368 837 621 621 822 1 1 1 1 1 1 1 1 1 1 1 1 1 133 1 1 4 462 463 468 469 476 477 476 477
368 368 368 368 368 381 382 368 368 368 368 821 630 630 631 1 1 1 1 1 1 1 1 1 1 1 1 1 133 1 4 1 470 469 476 477 468 469 468 469
368 368 368 368 370 379 372 368 368 368 368 368 368 283 144 121 175 207 121 137 1 1 1 1 1 13 13 13 133 1 1 4 476 477 468 469 476 477 476 477
368 368 368 368 378 113 380 368 368 368 368 368 368 291 292 292 292 292 292 136 1 13 13 13 13 13 13 13 141 135 111 1 468 469 476 477 468 469 468 469
368 368 368 368 386 121 388 368 368 368 368 368 368 299 325 292 292 292 292 136 13 13 13 13 13 13 13 13 13 13 133 1 486 485 468 469 476 477 476 477
368 368 368 368 368 373 374 368 368 368 368 368 368 368 291 292 292 292 292 136 13 13 13 13 13 13 13 13 13 13 141 135 135 214 476 477 468 469 468 469
368 368 368 368 368 381 382 368 368 368 368 368 368 368 291 292 292 292 292 144 137 13 13 13 13 13 13 13 13 13 1 1 1 1 468 469 476 477 476 477
368 368 368 368 368 368 373 374 368 368 368 368 368 368 291 292 292 292 292 292 136 13 13 13 13 13 13 1 1 1 1 1 1 1 486 485 468 469 468 469
368 368 368 368 368 368 381 382 368 368 368 368 368 368 291 292 292 292 292 292 144 137 13 13 13 1 1 1 280 281 282 1 1 1 1 1 486 485 484 485
368 368 368 368 368 368 336 337 368 368 368 368 368 283 317 292 292 292 292 292 292 136 13 13 13 1 1 280 289 289 289 281 281 282 1 1 1 1 1 1
368 368 368 368 368 368 344 345 368 368 368 368 368 291 292 292 292 292 292 292 292 144 121 137 1 1 1 288 289 289 289 289 289 289 282 1 1 1 1 1
368 368 368 368 368 368 368 336 337 368 368 368 368 291 292 292 292 292 292 292 292 292 292 136 1 1 1 296 289 289 289 289 297 297 298 1 462 463 462 463
368 368 368 368 368 373 374 344 345 368 368 368 368 291 292 292 292 292 292 292 292 292 292 144 137 1 1 1 296 297 297 298 1 1 1 1 470 469 468 469
368 368 368 368 368 381 382 368 368 368 368 368 368 291 292 292 292 292 292 292 292 292 292 292 136 1 1 1 1 1 1 1 1 1 462 463 476 477 476 477
368 368 368 368 368 368 336 337 368 368 368 368 368 299 325 292 292 292 292 292 292 292 292 292 144 121 137 3 1 1 1 1 1 1 470 469 468 469 468 469
368 368 368 368 368 368 344 345 368 368 368 368 368 368 291 292 292 292 292 292 292 292 292 292 292 292 136 1 1 1 1 1 462 463 476 477 476 477 476 477
368 368 368 368 370 379 372 368 368 368 368 368 368 368 291 292 292 292 292 292 292 292 292 292 292 292 136 1 1 1 1 1 470 469 468 469 468 469 468 469
368 368 368 368 378 113 380 368 368 368 368 368 368 368 291 292 292 292 292 292 292 292 292 292 292 292 136 1 1 1 1 1 476 477 476 477 476 477 476 477
368 368 368 368 386 121 388 368 368 368 368 368 368 368 299 325 292 292 292 292 292 292 292 292 292 292 144 121 175 207 121 137 468 469 468 469 468 469 468 469
368 368 368 368 368 368 368 373 374 368 368 368 368 368 368 291 292 292 292 292 292 292 292 292 292 292 292 292 292 292 292 136 476 477 476 477 476 477 476 477
368 368 368 368 368 368 368 381 382 368 368 368 368 368 368 291 292 292 292 292 292 292 292 292 292 292 292 292 292 292 292 136 468 469 468 469 468 469 468 469
368 368 368 368 368 368 373 374 368 368 368 368 368 368 368 299 300 325 292 292 292 292 292 292 292 292 292 292 292 292 292 136 476 477 476 477 476 477 476 477
368 368 368 368 368 368 381 382 368 368 368 368 368 368 368 368 368 299 300 325 292 292 292 292 292 292 292 292 292 292 292 136 468 469 468 469 468 469 468 469
368 368 368 368 368 336 337 368 368 368 368 368 368 368 368 368 368 368 368 299 300 300 325 292 292 292 292 292 292 292 292 136 476 477 476 477 476 477 476 477
368 368 368 368 368 344 345 373 374 368 368 368 368 368 368 368 368 368 368 368 368 368 299 300 300 300 300 300 325 292 292 136 468 469 468 469 468 469 468 469
368 368 368 368 368 368 368 381 382 368 368 368 368 368 368 368 368 368 368 368 368 368 368 368 368 368 368 368 299 338 339 375 476 477 476 477 476 477 476 477
368 368 368 368 368 368 336 337 368 368 368 368 368 368 368 368 368 368 368 368 368 368 368 368 368 368 368 373 374 344 345 378 468 469 468 469 468 469 468 469
368 368 368 368 368 368 344 345 368 368 368 368 368 368 368 368 368 368 368 368 368 368 368 368 368 368 368 381 382 368 368 378 476 477 476 477 476 477 476 477