Route110_TrickHousePuzzle4_Layout (15x22)
513 513 513 513 513 513 513 513 513 513 513 513 514 623 516
521 521 521 521 521 521 521 521 521 521 521 521 522 631 524
528 528 528 528 528 528 528 528 528 528 528 528 528 528 528
520 520 520 649 642 642 642 642 642 650 520 520 520 520 520
520 520 520 648 520 520 520 520 644 648 520 520 520 520 520
531 520 520 657 650 520 520 520 520 648 520 520 520 520 520
641 642 642 642 658 520 520 520 520 657 642 642 642 650 520
520 520 520 520 520 520 520 640 520 520 520 520 520 648 520
520 520 641 642 642 642 642 658 520 520 520 520 520 656 520
520 520 520 520 520 520 641 650 520 520 520 520 520 520 520
520 640 520 520 520 520 520 648 520 649 642 659 642 643 520
641 651 520 641 642 650 520 648 520 648 520 656 520 520 520
520 656 520 520 520 648 520 648 520 656 520 520 641 643 520
641 643 520 644 520 656 520 656 520 520 520 520 520 520 520
520 520 520 520 520 520 520 520 644 520 640 520 641 643 520
520 520 520 640 520 644 520 640 520 520 648 520 520 520 520
520 520 520 648 520 520 520 648 520 520 648 520 520 520 520
520 644 646 656 646 646 646 656 646 646 656 646 646 646 646
520 625 625 625 625 625 625 625 625 625 625 625 625 625 625
520 520 520 520 520 520 520 520 520 520 520 520 520 520 520
520 520 520 520 520 520 520 520 520 520 520 520 520 520 520
529 530 520 520 520 520 520 520 520 520 520 520 520 520 520