Route109_Layout (40x60)
336 337 368 368 368 368 368 291 292 292 292 292 292 292 292 292 292 292 292 292 292 292 292 292 292 292 292 292 292 292 292 292 292 292 292 292 293 368 344 345
344 345 368 368 368 368 368 291 292 292 292 292 292 292 292 292 292 292 292 292 292 292 292 292 292 292 292 292 292 292 292 292 292 292 292 292 293 368 336 337
368 373 374 368 368 368 368 299 325 292 704 705 705 705 706 292 292 292 292 292 292 292 292 292 292 292 292 292 292 292 292 292 292 292 292 326 301 368 344 345
368 381 382 368 368 368 368 368 291 292 712 713 713 713 714 292 292 292 292 292 292 292 292 292 292 292 292 292 292 292 292 292 292 292 292 293 368 368 373 374
368 368 336 337 368 368 368 368 291 292 728 721 723 721 730 292 292 292 738 739 292 292 292 292 738 739 292 292 292 292 292 292 292 292 292 293 368 368 381 382
368 368 344 345 368 368 368 368 291 292 717 19 731 19 718 3 292 292 746 747 292 292 292 292 746 747 292 292 292 292 292 292 292 292 292 293 368 368 373 374
368 368 373 374 368 368 368 368 291 740 741 292 292 292 292 740 741 292 754 755 292 740 741 292 754 755 292 740 741 292 292 292 292 292 326 301 368 368 381 382
368 368 381 382 368 368 368 368 291 748 749 292 292 292 292 748 749 292 292 292 292 748 749 292 292 292 292 748 749 292 292 292 292 292 293 368 368 373 374 368
368 373 374 368 368 368 368 368 291 756 757 292 738 739 292 756 757 737 292 292 292 756 757 737 292 292 292 756 757 292 292 292 292 292 293 368 368 381 382 368
368 381 382 368 368 368 368 368 291 736 292 292 746 747 292 292 292 745 292 292 292 292 292 745 292 292 292 292 292 292 292 292 292 292 293 368 336 337 368 368
368 368 368 336 337 368 368 368 291 744 292 292 754 755 737 292 292 753 292 292 292 292 292 753 292 292 292 292 292 660 292 736 292 326 301 368 344 345 336 337
368 368 368 344 345 368 368 368 291 752 292 292 292 292 745 292 292 292 292 292 292 292 292 292 292 292 292 292 292 292 292 744 292 293 368 368 368 368 344 345
368 368 368 368 336 337 368 368 299 325 292 292 292 292 753 292 740 741 292 292 292 292 292 292 740 741 292 292 292 292 292 752 292 293 368 368 368 373 374 368
368 368 370 372 344 345 368 368 368 299 325 292 292 292 292 292 748 749 292 292 292 292 292 292 748 749 292 292 292 292 292 292 292 293 368 368 368 381 382 368
368 368 378 180 372 368 368 368 368 368 291 292 292 742 743 292 756 757 737 292 742 743 292 292 756 757 292 742 743 292 292 292 326 301 368 368 368 368 373 374
368 368 386 121 388 368 368 368 368 368 291 292 292 750 751 292 292 292 745 292 750 751 292 292 292 292 292 750 751 736 292 292 293 368 368 368 368 368 381 382
368 368 368 368 373 374 368 368 368 368 291 292 292 758 759 737 737 292 753 292 758 759 292 292 292 292 292 758 759 744 292 292 293 368 368 368 368 336 337 368
368 368 368 368 381 382 368 368 368 368 299 325 292 292 292 745 745 292 292 292 292 292 292 292 292 292 292 292 292 752 326 300 301 368 368 368 368 344 345 368
368 368 368 336 337 368 368 368 368 368 368 291 292 292 292 753 753 292 292 292 292 292 292 292 292 292 292 292 292 292 293 368 368 368 368 368 336 337 368 368
368 368 368 344 345 368 368 368 368 368 368 299 325 292 292 292 292 292 292 292 292 292 292 292 292 292 736 292 292 326 301 368 368 368 368 368 344 345 368 368
368 368 368 373 374 368 368 368 368 368 368 368 291 292 292 292 292 292 292 292 292 292 292 292 292 292 744 292 292 293 368 368 368 368 368 368 368 373 374 368
368 368 368 381 382 336 337 368 368 368 368 368 299 300 300 325 292 292 292 292 292 292 292 292 292 292 752 326 300 301 368 368 368 368 368 368 368 381 382 368
368 368 368 368 368 344 345 368 368 368 368 368 368 368 368 291 292 292 292 292 292 292 292 292 292 292 292 293 368 368 368 368 368 368 368 368 368 370 379 372
368 368 368 368 368 368 373 374 368 368 368 368 368 368 368 291 292 292 292 292 292 292 292 292 292 326 300 301 368 368 368 368 368 368 368 368 370 180 113 380
368 368 368 368 368 368 381 382 368 368 368 368 368 368 368 299 300 300 325 292 292 292 292 326 300 301 368 368 368 368 368 368 368 368 368 368 378 113 116 388
368 368 368 368 368 373 374 368 368 368 368 368 368 368 368 368 368 368 299 300 300 300 300 301 368 368 368 368 368 368 368 368 368 368 368 368 378 113 380 368
368 368 368 368 368 381 382 368 368 368 368 368 368 368 368 368 368 368 368 368 368 368 368 368 368 368 368 368 368 368 368 368 368 368 373 374 386 121 388 368
368 368 368 368 370 379 372 368 368 368 368 368 368 368 368 368 368 368 368 368 368 368 368 368 368 368 368 368 368 368 368 368 368 368 381 382 368 368 368 368
368 368 368 370 180 113 380 373 374 368 368 368 368 368 368 368 368 368 368 368 368 368 368 368 368 368 283 284 284 285 368 368 368 368 368 368 373 374 368 368
368 368 368 378 113 113 380 381 382 368 368 368 368 368 368 368 368 368 368 368 368 368 368 368 368 283 317 740 741 318 284 285 368 368 368 368 381 382 368 368
368 368 368 378 113 116 388 368 368 368 368 368 368 368 368 368 368 368 368 368 368 368 368 368 283 317 292 748 749 292 292 318 284 285 368 336 337 368 368 368
368 368 368 386 121 388 368 368 368 368 368 368 368 368 368 368 368 368 368 368 368 368 368 368 291 292 292 756 757 736 292 292 292 293 368 344 345 368 368 368
368 368 373 374 368 368 336 337 368 368 368 368 368 368 368 368 368 368 368 368 368 368 368 368 291 292 292 292 292 744 292 292 292 293 368 368 336 337 368 368
368 368 381 382 368 368 344 345 373 374 368 368 368 368 368 368 368 368 368 368 368 368 368 368 291 292 292 292 292 752 292 292 326 301 368 368 344 345 368 368
368 368 368 368 368 368 368 368 381 382 368 368 368 368 368 368 368 368 368 368 368 368 368 368 299 300 325 292 292 292 326 300 301 368 368 336 337 368 368 368
368 368 368 368 368 368 370 379 372 368 368 368 368 368 368 368 368 368 368 368 368 368 368 368 368 368 299 300 300 300 301 368 368 368 368 344 345 368 368 368
368 368 368 368 336 337 378 113 380 368 368 368 368 368 368 368 368 368 368 368 368 368 368 368 368 368 368 368 368 368 368 368 368 368 373 374 368 368 368 368
368 368 368 368 344 345 386 121 388 368 368 368 368 368 368 368 368 368 368 368 368 368 368 368 368 368 368 368 368 368 368 368 368 368 381 382 368 368 368 368
368 368 368 373 374 368 368 368 368 368 368 368 368 368 368 368 368 368 368 368 368 368 368 368 368 368 368 368 368 368 368 368 368 373 374 368 368 368 368 368
368 368 368 381 382 368 368 368 368 368 368 368 368 368 368 368 368 368 368 368 368 368 368 368 368 368 368 368 368 368 368 368 368 381 382 368 368 368 368 368
368 368 373 374 368 368 368 283 284 284 285 368 368 368 368 368 368 368 368 368 368 368 368 368 368 368 368 368 368 368 368 373 374 368 368 373 374 368 368 368
373 374 381 382 368 368 283 317 292 292 293 368 368 368 368 368 368 368 368 368 368 368 368 368 368 368 368 368 368 368 368 381 382 368 368 381 382 368 368 368
381 382 368 368 368 368 291 292 292 292 293 368 368 368 368 368 368 368 368 368 368 368 368 368 368 368 368 368 368 368 368 368 336 337 368 368 368 368 368 368
368 368 373 374 368 368 291 292 292 326 301 368 368 368 368 368 368 368 368 368 368 368 368 368 368 368 368 368 368 368 368 368 344 345 368 368 368 368 368 368
368 368 381 382 368 368 299 300 300 301 368 368 368 368 368 368 368 368 368 368 368 368 368 368 368 368 283 284 284 285 368 368 368 373 374 368 368 368 368 368
368 368 368 368 368 368 368 368 368 368 368 368 368 368 368 368 368 368 368 368 368 368 368 368 368 283 317 292 292 293 368 368 368 381 382 368 368 368 368 368
368 368 368 368 368 368 368 368 368 368 368 368 368 368 368 368 368 368 368 368 368 368 368 368 368 291 292 292 292 318 285 368 368 368 373 374 368 368 368 368
368 368 368 368 368 368 368 368 368 368 368 368 368 368 368 368 368 368 368 368 368 368 368 368 283 317 292 292 292 292 293 368 368 368 381 382 368 368 368 368
368 368 368 368 368 368 368 368 368 368 368 368 368 368 368 368 368 368 368 368 368 368 368 368 291 292 292 292 292 292 293 368 368 336 337 368 368 368 368 368
368 368 368 368 368 368 368 368 368 368 368 368 368 368 368 368 368 368 368 368 368 368 368 368 291 292 292 292 292 326 301 368 368 344 345 368 368 368 368 368
368 368 368 368 368 368 368 368 368 368 368 368 283 284 284 285 368 368 368 368 368 368 368 368 299 300 300 300 300 301 368 368 368 370 379 372 368 368 368 368
368 368 368 368 368 368 368 368 368 368 368 368 291 292 292 318 285 368 368 368 368 368 368 368 368 368 368 368 368 368 368 368 370 180 113 380 368 368 368 368
368 368 368 368 368 368 368 368 368 368 368 368 291 292 292 292 293 368 368 368 368 368 368 368 368 368 368 368 368 368 336 337 378 113 116 388 368 368 368 368
368 368 368 368 368 368 368 368 368 368 368 368 291 292 292 292 293 368 368 368 368 368 368 368 336 337 373 374 368 368 344 345 386 121 388 368 368 368 368 368
368 368 336 337 373 374 368 368 368 368 368 368 299 300 300 300 301 368 368 368 373 374 336 337 344 345 381 382 373 374 368 368 368 368 368 368 368 368 368 368
336 337 344 345 381 382 368 368 368 368 373 374 368 368 368 368 368 368 368 368 381 382 344 345 368 368 368 368 381 382 368 368 368 368 368 368 368 368 368 368
344 345 368 368 368 373 374 370 379 372 381 382 368 336 337 336 337 368 368 373 374 368 368 368 368 368 368 368 368 368 368 368 368 368 368 368 368 368 368 368
368 368 368 368 368 381 382 378 113 380 368 336 337 344 345 344 345 373 374 381 382 368 368 368 368 368 368 368 368 368 368 368 368 368 368 368 368 368 368 368
368 368 368 368 368 368 368 386 121 388 368 344 345 368 368 368 368 381 382 368 368 368 368 368 368 368 368 368 368 368 368 368 368 368 368 368 368 368 368 368
368 368 368 368 368 368 368 368 368 368 368 368 368 368 368 368 368 368 368 368 368 368 368 368 368 368 368 368 368 368 368 368 368 368 368 368 368 368 368 368