Route110_TrickHousePuzzle1_Layout (15x22)
513 513 513 513 513 513 513 513 513 513 513 513 514 623 516
562 563 563 563 563 563 563 563 563 563 563 564 522 631 524
547 548 555 548 548 548 555 548 548 548 548 545 528 528 528
602 602 554 602 602 602 554 602 602 602 602 554 520 520 520
520 520 538 520 520 520 538 520 520 520 520 538 520 520 520
520 539 556 540 540 540 556 540 540 540 540 556 540 540 541
520 547 548 548 555 548 548 548 548 555 548 548 548 548 549
520 602 602 602 546 602 602 602 602 554 602 602 602 602 602
520 520 520 520 546 520 520 520 520 538 520 520 520 520 531
539 541 520 536 556 541 520 536 540 556 540 540 540 540 541
560 561 520 544 548 549 520 544 548 548 548 548 555 548 549
602 602 520 554 602 602 520 546 602 602 602 602 554 602 602
520 520 520 538 520 520 520 546 520 520 520 520 538 520 520
520 539 540 556 540 540 540 556 540 540 540 540 556 541 520
520 547 548 548 548 555 548 548 548 548 555 548 548 549 520
520 602 602 602 602 546 602 602 602 602 554 602 602 602 520
520 520 520 520 520 546 520 520 520 520 538 520 520 520 520
539 540 541 520 539 556 540 540 540 540 556 541 520 539 541
547 548 549 520 547 548 548 555 548 548 548 549 520 560 561
602 602 602 520 602 602 602 546 602 602 602 602 520 602 602
520 520 520 520 520 520 520 554 520 520 520 520 520 520 520
529 530 520 520 520 520 520 602 520 520 520 520 520 520 520