Route131_Layout (60x40)
113 113 113 113 113 113 113 113 113 113 113 116 124 124 125 117 116 169 124 125 384 408 368 368 342 335 335 335 335 335 335 335 335 335 335 335 335 335 335 335 335 335 342 368 368 368 368 368 368 368 368 368 368 368 368 368 368 368 368 368
113 113 113 113 113 113 113 113 116 124 124 125 113 113 116 125 117 384 393 393 408 368 368 368 342 335 335 335 335 335 335 335 335 335 335 335 335 335 335 335 335 335 342 368 368 368 368 368 368 368 368 368 368 368 368 368 368 368 368 368
124 124 124 124 124 124 124 124 125 113 113 113 116 124 125 116 125 400 368 368 368 368 368 368 368 342 335 335 335 335 335 335 335 335 335 335 335 335 335 335 335 335 342 368 368 368 368 368 368 368 368 368 368 368 368 368 368 368 368 368
113 113 113 113 113 116 169 169 169 124 124 124 125 113 116 125 384 408 368 368 368 368 368 368 368 342 335 335 335 335 335 335 335 335 335 335 335 335 335 335 335 342 368 368 368 368 368 368 368 368 368 368 368 368 368 368 368 368 368 368
113 113 116 124 124 125 113 113 113 116 169 169 169 124 125 384 408 368 368 368 368 368 368 368 368 342 335 335 335 335 335 335 335 335 335 335 335 335 335 335 335 342 368 368 368 368 368 368 368 368 368 368 368 368 368 368 368 368 368 368
124 124 125 113 116 169 124 124 124 125 384 393 393 393 393 408 368 368 373 374 368 368 368 368 368 368 342 335 335 335 335 335 335 335 335 335 335 335 335 335 335 342 368 368 368 368 368 368 368 368 368 368 368 368 368 368 368 368 368 368
169 169 169 124 125 384 393 393 393 393 408 373 374 368 373 379 374 368 381 382 368 368 368 368 368 368 342 335 335 335 335 335 335 335 335 335 335 335 335 335 342 368 368 368 368 368 368 368 368 368 368 368 368 368 368 368 368 368 368 368
384 393 346 347 393 408 368 368 368 368 368 381 382 368 378 113 380 368 368 368 368 368 368 368 368 368 368 342 335 335 335 335 335 335 335 335 335 335 335 335 342 368 368 368 368 368 368 368 336 337 368 368 368 368 368 368 368 368 368 368
408 368 344 345 368 368 368 368 373 374 368 368 368 368 386 121 388 368 368 368 368 368 368 368 373 374 368 342 335 335 335 335 335 335 335 335 335 335 335 335 342 368 368 373 374 373 379 374 344 345 368 368 368 368 368 368 368 368 368 368
368 368 368 368 373 379 374 368 381 382 368 368 373 374 336 337 368 368 368 368 368 368 336 337 381 382 368 342 335 335 335 335 335 335 335 335 335 335 335 342 368 373 374 381 382 378 113 380 368 368 373 374 368 368 368 368 368 368 368 368
368 368 368 368 378 113 380 368 368 368 368 368 381 382 344 345 368 368 373 374 368 368 344 345 368 373 379 374 342 335 335 335 335 335 335 335 335 335 335 342 368 381 382 368 368 386 121 388 336 337 381 382 368 368 368 368 368 368 368 368
336 337 368 368 386 121 388 368 368 373 374 336 337 368 368 368 336 337 381 382 368 336 337 368 368 378 113 380 342 335 335 335 335 335 335 335 335 335 342 368 373 374 368 368 368 368 368 368 344 345 368 373 379 379 374 368 368 368 368 368
344 345 368 368 368 368 368 336 337 381 382 344 345 368 373 374 344 345 368 336 337 344 345 368 368 386 121 388 368 342 335 335 335 335 335 335 335 335 342 373 180 380 368 368 368 373 374 368 368 368 373 180 113 113 180 374 368 368 368 368
368 368 368 368 368 368 368 344 345 368 368 368 368 368 381 382 368 368 368 344 345 368 368 368 368 368 368 373 374 368 342 335 335 335 335 335 335 342 368 378 113 380 368 368 368 381 382 336 337 368 386 121 121 121 121 388 336 337 368 368
368 368 368 368 368 368 368 368 368 368 368 368 368 368 368 368 368 368 373 374 368 368 368 368 368 368 368 381 382 373 374 342 342 342 342 342 342 373 374 386 121 388 368 368 368 368 368 344 345 373 374 368 368 368 368 368 344 345 373 379
368 368 368 368 368 368 368 368 368 368 368 368 368 368 368 368 368 368 381 382 373 379 374 368 368 368 368 368 368 381 382 368 368 368 368 336 337 381 382 368 368 368 368 368 368 368 368 368 368 381 382 368 368 368 368 368 368 368 378 113
368 368 368 368 368 368 368 368 368 368 368 368 368 368 368 368 368 368 368 368 378 113 180 379 374 368 368 368 368 373 374 368 368 373 374 344 345 368 368 368 368 368 368 368 373 379 374 368 368 368 368 368 368 368 368 368 373 374 386 121
368 368 368 368 368 368 368 368 368 368 368 368 368 368 368 368 368 368 368 368 386 121 121 121 388 368 368 368 368 381 382 373 374 381 382 368 368 368 368 368 368 368 373 379 180 113 380 368 368 368 368 368 368 368 368 368 381 382 368 368
368 368 368 368 368 368 368 368 368 368 368 368 368 368 368 368 368 368 368 368 368 368 368 368 368 368 368 368 368 368 368 381 382 368 368 368 368 368 368 368 336 337 378 113 113 113 380 368 368 368 368 368 368 368 368 368 368 368 336 337
368 368 368 368 368 368 368 368 368 368 368 368 368 368 368 368 368 368 368 368 368 368 368 368 368 368 368 368 368 368 368 368 368 368 368 368 368 368 368 368 344 345 386 121 121 121 388 368 368 368 368 368 368 368 368 368 368 368 344 345
368 368 368 368 368 368 368 368 368 368 368 368 368 368 368 368 368 368 368 368 368 368 368 368 336 337 368 368 373 374 368 368 368 368 368 368 368 373 379 374 368 368 368 368 368 368 368 368 368 368 368 368 368 368 368 368 368 368 368 368
368 368 368 368 368 368 368 368 368 368 368 368 368 368 368 368 368 368 368 368 368 368 368 368 344 345 336 337 381 382 368 368 368 368 373 374 373 180 113 380 368 368 368 368 368 368 368 368 368 368 368 368 368 368 368 368 368 368 368 368
368 368 368 368 368 368 368 368 368 368 368 368 368 368 368 368 368 368 368 368 368 368 368 368 368 368 344 345 368 368 373 379 379 374 381 382 386 121 121 388 368 368 368 368 368 368 368 368 368 368 368 368 368 368 368 368 368 368 368 368
368 368 368 368 368 368 368 368 368 368 368 368 368 368 368 368 368 368 368 368 368 368 368 368 368 368 368 368 368 368 386 121 121 388 368 368 368 368 368 368 368 368 368 368 368 368 368 368 368 368 368 368 368 368 368 368 368 368 368 368
368 368 368 368 368 368 368 368 368 368 368 368 368 368 368 368 368 368 368 368 368 368 368 368 368 368 368 368 368 368 368 368 368 368 368 368 368 368 368 368 368 368 368 368 368 368 368 368 368 368 368 368 368 368 368 368 368 368 368 368
368 368 368 368 368 368 368 368 368 368 368 368 368 368 368 368 368 368 368 368 368 368 368 368 368 368 368 368 368 368 368 368 368 368 368 368 368 368 368 368 368 368 368 368 368 368 368 368 368 368 368 368 368 368 368 368 368 368 368 368
368 368 368 368 368 368 368 368 368 368 368 368 368 368 368 368 368 368 368 368 368 368 368 368 368 368 368 368 368 368 368 368 368 368 368 368 368 368 368 368 368 368 368 368 368 368 368 368 368 368 368 368 368 368 368 368 368 368 368 368
368 368 368 368 368 368 368 368 368 368 368 368 336 337 368 368 368 368 368 368 368 368 368 368 368 368 368 368 368 368 368 368 368 368 368 368 368 368 368 368 368 368 368 368 368 368 368 368 368 368 368 368 368 368 368 368 368 368 373 374
368 368 368 368 368 368 336 337 368 368 368 368 344 345 368 368 368 368 368 368 368 368 368 368 368 368 368 368 368 368 368 368 368 368 368 368 368 368 368 368 368 368 368 368 368 368 368 368 336 337 373 374 368 368 368 368 368 368 381 382
368 368 368 373 374 368 344 345 368 368 368 368 368 368 368 368 373 374 368 368 368 368 368 368 368 368 368 368 368 368 368 368 368 368 368 368 368 368 368 368 368 368 368 368 368 368 368 368 344 345 381 382 368 368 368 368 368 368 373 379
336 337 368 381 382 368 368 368 373 379 374 368 368 368 368 368 378 180 374 368 373 374 368 368 368 368 368 368 368 368 368 368 368 368 368 373 374 368 368 368 368 368 368 368 368 368 373 374 368 368 368 368 368 368 368 368 368 368 378 113
344 345 368 368 368 368 368 368 378 113 380 368 373 374 368 368 386 137 180 374 381 382 368 368 368 368 368 368 368 368 368 368 368 336 337 381 382 368 368 368 368 368 368 368 373 374 381 382 368 368 368 368 368 368 368 368 336 337 386 121
379 379 379 379 372 368 368 368 386 121 388 368 381 382 373 374 368 386 121 388 368 368 368 368 368 368 368 373 379 379 374 368 368 344 345 368 368 373 374 368 368 368 368 368 381 382 368 368 368 336 337 368 373 374 368 368 344 345 368 368
113 113 113 113 180 379 372 368 368 368 368 373 374 368 381 382 368 368 373 374 368 368 368 368 368 368 368 378 113 113 180 379 374 368 368 368 368 381 382 373 374 368 368 373 379 379 374 368 368 344 345 368 381 382 368 373 374 368 368 368
108 108 108 108 109 113 180 379 379 379 372 381 382 368 368 368 373 374 381 382 368 368 373 379 379 374 368 386 137 113 113 113 180 374 368 368 368 368 368 381 382 368 373 180 113 113 180 379 379 374 373 379 379 379 374 381 382 368 368 368
113 113 113 113 191 108 108 109 113 113 180 379 372 368 368 368 381 382 368 368 373 379 180 113 113 380 373 374 386 121 121 121 121 388 368 368 368 368 368 368 336 337 386 121 121 121 137 113 113 180 180 113 113 116 388 368 368 368 368 368
113 113 113 113 113 113 113 191 109 113 113 113 117 372 368 368 368 368 368 368 378 113 113 113 116 388 381 382 368 368 368 368 368 368 368 368 368 368 368 368 344 345 368 368 368 368 386 121 137 113 113 113 116 388 368 368 368 368 336 337
113 113 113 113 113 113 113 113 191 108 108 109 117 117 379 372 368 368 373 374 386 121 121 121 388 368 368 368 368 368 368 368 368 368 368 368 368 368 368 368 368 368 368 368 368 368 368 368 386 121 121 121 388 368 368 368 368 368 344 345
113 113 113 113 113 113 113 113 113 113 113 191 191 191 108 191 372 368 381 382 368 368 368 368 368 368 368 368 368 368 368 368 368 368 368 368 368 368 368 368 368 368 368 368 368 368 368 368 368 368 368 368 368 368 368 368 368 368 368 368
113 113 113 113 113 113 113 113 113 113 113 113 113 113 113 113 117 372 368 368 368 368 368 368 368 368 368 368 368 368 368 368 368 368 368 368 368 368 368 368 368 368 368 368 368 368 368 368 368 368 368 368 368 368 368 368 368 368 368 368