Route110_TrickHousePuzzle2_Layout (15x22)
513 513 517 518 513 513 517 518 513 513 517 518 514 623 516
521 521 525 526 521 521 525 526 521 521 525 526 522 631 524
528 640 528 534 640 600 528 534 528 528 528 534 528 528 528
520 648 520 649 660 642 642 642 643 520 520 520 520 520 520
520 648 520 656 520 520 520 520 617 520 649 642 642 642 643
520 648 520 520 520 649 643 520 641 642 651 520 617 520 531
520 657 642 650 520 648 520 520 520 520 648 520 641 642 643
520 520 520 648 520 648 520 520 520 520 648 520 520 520 520
641 643 520 648 520 648 520 641 642 642 660 659 642 643 520
520 520 520 648 520 648 520 520 520 520 520 648 520 520 520
520 520 520 648 600 652 643 520 640 520 641 658 520 641 643
641 643 520 657 642 651 520 520 648 520 520 520 520 520 520
520 617 520 520 520 648 520 649 658 520 649 642 642 643 520
520 641 642 650 520 657 642 651 520 520 648 520 617 520 520
520 520 520 648 520 520 520 652 642 642 658 520 649 642 643
641 643 520 657 642 650 520 648 520 520 520 520 648 520 520
520 520 520 520 520 648 520 657 642 650 520 520 656 520 520
520 640 520 640 520 648 520 520 600 648 520 520 520 520 520
520 648 520 648 520 657 642 659 642 658 520 641 659 643 520
520 656 520 648 520 520 520 648 520 520 520 520 648 520 520
520 520 520 657 642 642 642 658 520 641 650 520 657 650 520
529 530 520 520 520 520 520 520 520 520 656 520 520 656 600