Route116_TunnelersRestHouse_Layout (10x9)
739 689 690 535 533 535 533 702 703 740
747 697 698 543 541 543 541 710 711 748
755 705 706 545 545 545 545 718 719 756
545 553 553 553 553 553 553 553 553 553
601 590 591 553 553 553 553 590 591 580
545 598 599 580 553 553 580 598 599 580
545 553 553 553 553 553 553 553 553 553
800 792 792 792 792 792 792 792 792 792
803 795 795 795 528 529 795 795 795 795