Route115_Layout (40x80)
325 136 198 199 198 199 198 199 198 199 198 199 198 199 198 198 576 579 579 577 579 587 588 587 613 588 577 577 577 577 577 577 577 577 577 577 577 577 577 577
291 136 198 198 198 198 198 198 198 198 198 198 198 198 198 23 576 579 579 577 587 588 579 577 577 579 577 577 577 577 577 577 577 577 577 577 577 577 577 577
291 136 198 198 198 198 198 198 198 198 198 198 198 198 198 568 563 579 579 577 577 579 579 577 577 587 588 577 577 577 577 577 577 577 577 577 577 577 577 577
291 136 198 198 198 198 198 198 198 198 198 198 198 198 198 576 577 579 579 577 577 579 587 613 588 577 579 577 577 577 577 577 577 577 577 577 577 577 577 577
291 136 198 198 198 22 22 22 198 198 23 23 23 23 23 576 577 579 587 613 588 587 588 577 579 577 587 613 613 588 577 577 577 577 577 577 577 577 577 577
291 136 198 198 22 13 13 13 23 198 331 332 332 332 333 576 577 579 577 577 579 577 579 577 587 588 577 577 577 587 613 613 613 613 588 577 577 577 577 577
291 136 198 198 13 13 13 13 13 198 275 276 276 276 277 576 577 579 577 577 579 577 587 588 577 587 613 613 613 612 612 612 520 588 587 613 613 588 577 577
291 136 198 198 13 13 13 13 13 198 14 1 1 14 14 576 577 579 577 597 587 613 588 587 613 611 588 597 577 577 577 577 577 587 588 577 577 579 577 577
291 136 198 198 13 13 13 13 13 198 198 1 1 198 198 584 588 579 577 577 577 577 587 520 588 577 587 810 232 811 613 588 577 577 579 577 577 579 577 577
291 136 198 198 14 14 13 13 14 198 198 1 14 198 198 14 576 579 577 577 577 577 577 577 587 613 612 818 232 819 588 579 577 577 579 577 577 579 577 577
291 136 198 198 198 198 14 1 198 198 198 1 198 198 198 198 576 579 577 577 577 577 577 577 577 577 577 577 577 577 579 579 577 577 579 577 577 579 577 577
291 136 198 198 198 198 198 1 23 198 198 1 198 198 198 198 576 579 577 577 577 577 577 577 577 577 577 577 577 577 579 579 577 577 587 588 577 587 588 577
291 136 198 198 198 198 198 14 1 23 23 1 198 198 198 198 576 587 175 207 613 613 613 613 613 613 613 175 207 588 579 579 577 577 577 579 577 577 579 577
291 136 23 198 198 198 198 198 14 14 14 1 23 198 198 198 584 613 175 207 588 577 577 577 577 577 577 577 577 579 579 579 577 577 577 579 577 577 579 577
291 144 137 198 198 23 23 23 23 23 23 1 1 23 198 198 14 1 1 1 576 577 577 577 577 571 572 573 577 579 579 579 577 577 577 579 577 577 579 577
299 325 136 23 23 14 14 14 14 14 1 14 14 1 23 198 23 1 1 1 576 577 577 577 577 587 520 589 577 579 579 579 577 577 577 579 577 577 579 577
368 291 144 124 137 23 23 198 198 198 1 198 198 1 1 23 1 1 568 569 563 577 577 577 577 577 577 577 577 579 579 579 577 577 577 579 577 571 563 577
368 299 300 325 144 124 137 198 198 198 1 23 23 1 1 14 14 1 576 577 571 572 573 577 577 597 577 571 572 563 579 579 577 577 577 579 577 579 577 577
368 368 368 299 300 325 136 23 23 198 14 1 1 14 1 198 198 1 576 577 587 520 589 577 577 571 572 563 571 572 563 563 577 577 571 563 577 579 577 577
368 368 368 336 337 291 136 30 31 198 198 1 14 198 1 23 23 1 576 577 577 577 577 577 577 579 577 571 579 577 577 577 577 577 579 577 577 579 577 577
368 368 368 344 345 291 136 38 39 198 198 1 198 198 14 1 1 1 576 597 577 577 571 572 572 563 571 563 563 577 577 577 577 577 579 577 577 579 577 577
368 840 841 368 368 291 136 1 1 198 198 1 198 198 198 14 14 568 563 577 597 577 579 577 571 563 579 577 577 577 577 577 577 571 563 577 577 579 577 577
368 848 849 368 368 291 144 137 1 23 198 1 23 198 198 198 198 576 571 572 572 572 563 571 563 572 563 577 577 577 571 572 572 563 577 571 572 563 577 577
368 368 368 368 368 299 325 136 14 1 198 1 1 23 23 198 198 576 579 577 577 577 571 579 571 572 573 577 577 577 579 571 572 572 572 563 577 577 577 577
368 368 368 368 368 336 341 136 198 1 198 14 1 1 1 198 23 576 579 577 571 572 563 579 587 520 589 577 577 571 563 563 577 577 577 577 577 577 577 577
368 368 368 336 337 344 349 136 198 1 23 198 14 1 14 198 568 563 579 577 579 577 571 563 577 577 577 577 571 579 577 577 577 577 577 577 577 577 577 577
368 368 368 344 345 368 291 136 198 14 1 198 198 1 198 198 576 577 579 571 563 577 579 577 577 577 577 577 579 579 577 577 577 577 577 577 577 577 577 577
368 368 840 841 368 368 291 136 198 198 1 23 198 1 198 198 576 577 579 579 577 577 579 577 577 571 572 572 563 563 577 577 577 577 577 577 577 577 577 577
368 368 848 849 368 368 291 136 198 198 1 1 23 1 198 198 576 577 579 587 588 577 579 577 571 579 577 577 577 577 577 577 577 577 577 577 577 577 577 577
368 336 337 368 368 368 291 136 23 23 1 1 1 1 198 23 576 577 579 577 579 577 579 577 579 579 577 577 577 577 577 577 577 577 577 577 577 577 577 577
368 344 345 368 368 368 291 144 424 137 1 1 1 1 198 568 563 577 579 577 587 588 587 588 579 587 588 577 577 577 577 577 577 577 577 577 577 577 577 577
368 368 840 841 368 368 291 292 292 144 137 1 1 1 23 576 577 577 587 588 577 579 577 579 587 588 587 588 577 577 577 577 577 577 577 577 577 577 577 577
368 368 848 849 368 368 299 300 300 325 136 1 1 1 1 576 577 577 577 579 577 579 577 587 588 587 588 587 588 577 577 577 577 577 577 577 577 577 577 577
368 368 368 840 841 368 368 368 368 291 144 175 207 124 137 576 597 577 577 579 577 579 577 577 587 588 579 577 587 613 613 613 588 577 577 577 577 577 577 577
368 336 337 848 849 368 368 368 368 291 292 292 292 292 136 576 577 577 577 579 577 587 613 588 577 579 587 588 577 577 577 577 587 613 613 613 613 613 588 577
368 344 345 368 368 368 368 368 368 291 292 292 292 292 136 576 577 595 596 579 577 577 577 579 577 587 588 587 613 613 613 613 612 612 612 612 612 588 579 577
368 840 841 368 368 368 368 368 368 299 338 339 325 292 136 584 588 603 604 587 588 577 577 579 577 577 587 601 612 612 612 612 612 612 612 588 577 579 587 588
368 848 849 368 368 368 368 368 368 368 344 345 299 325 136 1 576 577 577 577 579 577 577 587 613 613 613 609 612 612 612 612 588 577 577 579 577 587 588 579
336 337 368 368 368 368 368 368 368 368 368 840 841 291 136 1 576 577 577 597 587 613 613 588 577 3 577 577 597 577 577 577 587 613 588 587 613 588 579 579
344 345 336 337 368 368 368 368 368 368 368 848 849 291 144 137 584 588 577 577 577 595 596 579 577 577 577 577 580 613 613 613 520 588 579 577 577 579 579 579
368 368 344 345 368 368 368 336 337 368 368 368 368 299 325 136 313 584 585 588 577 603 604 579 577 577 577 577 581 595 596 577 577 579 579 577 577 579 579 579
368 840 841 368 368 368 368 344 345 840 841 368 368 368 291 136 320 1 1 584 585 585 588 579 577 577 577 577 581 603 604 577 577 579 579 577 577 579 579 579
368 848 849 368 368 368 840 841 368 848 849 368 368 336 341 136 328 329 329 329 329 313 576 587 175 207 613 613 589 577 577 577 577 579 587 588 577 579 579 579
840 841 368 368 368 368 848 849 368 368 368 336 337 344 349 136 1 1 1 1 1 320 576 577 577 577 577 577 595 596 577 577 571 563 577 579 577 579 579 587
848 849 368 368 368 368 368 368 368 368 368 344 345 368 291 136 1 1 1 1 1 320 576 577 577 577 577 577 603 604 577 571 563 577 577 579 577 579 579 577
368 336 337 368 368 368 368 368 368 336 337 368 368 283 317 136 1 1 1 1 1 320 576 595 596 577 577 577 577 577 577 579 577 577 577 587 588 579 587 588
368 344 345 368 368 368 368 368 368 344 345 368 283 317 292 144 175 207 137 1 1 320 576 603 604 577 577 577 577 577 577 587 520 588 577 577 579 587 588 587
368 840 841 368 368 368 368 368 368 368 368 368 291 292 292 292 292 292 136 1 1 320 584 585 588 577 577 577 577 577 577 577 577 579 577 577 579 577 587 611
368 848 849 368 368 368 368 368 368 368 368 368 291 292 292 292 292 292 136 1 1 328 329 313 584 585 175 207 585 585 585 585 588 579 577 577 587 613 611 611
368 368 840 841 368 368 368 368 840 841 368 368 291 292 292 292 292 292 136 1 1 1 1 328 329 1 1 1 1 329 329 329 576 587 613 613 613 612 612 612
368 368 848 849 368 368 368 368 848 849 368 368 291 292 292 292 292 292 136 1 1 1 1 1 1 1 280 282 1 1 1 1 584 726 727 726 727 726 727 726
368 368 368 336 337 368 368 368 368 368 368 368 291 292 292 292 292 292 136 1 1 1 1 1 1 1 288 290 1 254 1 1 1 470 469 468 469 468 469 468
368 336 337 344 345 368 368 368 368 368 368 368 299 325 292 292 292 292 144 137 1 1 462 463 1 1 288 290 1 133 1 1 1 476 477 476 477 476 477 476
368 344 345 368 368 368 368 368 368 368 368 368 368 291 292 292 292 292 292 144 416 137 470 471 1 1 288 290 1 133 1 1 1 468 469 468 469 468 469 468
368 368 840 841 368 368 368 368 368 368 336 337 368 291 292 292 292 292 292 292 292 136 476 477 1 1 288 290 1 133 1 1 1 476 477 476 477 476 477 476
840 841 848 849 368 368 368 368 368 368 344 345 368 299 300 300 300 300 300 300 325 136 468 469 1 1 288 290 1 133 1 1 1 468 469 468 469 468 469 468
848 849 368 368 368 368 368 368 368 368 368 368 368 368 368 368 368 368 368 368 291 136 476 477 1 1 288 290 1 133 1 1 1 476 477 476 477 476 477 476
336 337 368 368 368 368 368 368 368 368 368 368 368 368 368 368 368 368 368 368 291 136 468 469 1 1 288 290 1 133 4 1 1 468 469 468 469 468 469 468
344 345 368 368 368 368 368 368 368 368 368 368 368 368 368 368 368 368 368 368 291 136 476 477 1 1 288 290 1 133 1 1 4 476 477 476 477 476 477 476
368 336 337 368 368 368 368 368 368 368 368 368 368 368 368 368 368 368 368 368 291 136 468 469 1 1 288 290 1 133 4 1 1 468 469 468 469 468 469 468
368 344 345 368 368 368 368 368 283 284 284 284 284 284 284 284 284 284 284 284 317 136 476 477 1 1 288 290 1 133 1 1 4 476 477 476 477 476 477 476
368 336 337 368 368 368 283 284 317 292 292 292 292 292 128 211 2 2 2 2 2 2 468 469 1 1 288 290 1 133 4 1 1 468 469 468 469 468 469 468
368 344 345 368 368 283 317 292 292 292 292 128 211 2 2 1 1 1 1 462 463 4 486 487 1 1 288 290 1 133 1 1 4 476 477 476 477 476 477 476
336 337 368 368 368 291 292 292 292 292 292 136 1 1 1 1 1 1 4 470 471 1 254 1 1 1 288 290 1 133 259 260 261 468 469 468 469 468 469 468
344 345 368 368 368 291 292 292 292 128 211 2 1 1 1 1 3 1 1 476 477 4 133 1 1 1 288 290 1 133 267 268 269 476 477 476 477 476 477 476
373 374 368 368 368 291 292 292 292 136 1 1 1 1 1 1 1 1 4 468 469 1 133 1 1 1 288 290 1 133 267 268 269 468 469 468 469 468 469 468
381 382 368 368 368 291 292 292 292 136 1 1 1 1 1 1 1 1 1 486 487 4 133 1 1 1 288 290 1 133 275 276 277 476 477 476 477 476 477 476
368 336 337 368 368 291 292 292 292 136 1 1 1 1 1 1 1 1 1 4 1 1 133 1 1 1 296 298 1 141 135 135 214 468 469 468 469 468 469 468
368 344 345 368 368 291 292 292 292 136 1 1 1 1 1 254 1 1 1 1 1 1 133 1 1 1 1 1 1 1 1 1 462 499 498 499 498 499 498 499
373 374 368 368 368 291 292 292 292 136 1 1 1 1 1 133 1 1 1 1 1 1 141 135 135 135 135 135 135 135 135 214 470 469 468 469 468 469 468 469
381 382 368 368 368 291 292 292 292 144 175 207 137 462 463 133 1 1 1 1 1 1 1 1 1 1 1 1 1 1 1 1 476 477 476 477 476 477 476 477
336 337 368 368 368 299 325 292 292 292 292 292 136 470 471 141 135 135 135 214 1 1 1 1 1 1 1 1 1 1 1 1 468 469 468 469 468 469 468 469
344 345 368 368 368 368 291 292 292 292 292 292 136 476 477 462 463 1 1 1 1 1 1 213 135 135 135 135 135 135 135 214 476 477 476 477 476 477 476 477
368 373 374 368 368 368 299 325 292 292 292 326 375 468 469 468 471 1 1 1 1 1 1 1 1 1 1 1 1 1 1 1 468 469 468 469 468 469 468 469
368 381 382 368 368 368 368 299 300 300 300 301 378 476 477 476 477 1 1 1 1 1 1 1 1 1 1 1 1 1 462 463 476 477 476 477 476 477 476 477
368 368 373 374 368 368 368 368 368 368 368 368 378 468 469 468 469 213 135 135 135 214 1 1 213 135 135 135 135 214 470 469 468 469 468 469 468 469 468 469
368 368 381 382 336 337 368 368 368 336 337 370 211 476 477 476 477 1 1 1 1 1 1 1 1 1 462 463 462 463 476 477 476 477 476 477 476 477 476 477
368 368 368 368 344 345 373 374 368 344 345 378 1 468 469 468 469 1 1 1 1 1 1 1 1 1 470 469 468 469 468 469 468 469 468 469 468 469 468 469
368 368 368 368 368 368 381 382 336 337 368 378 1 476 477 476 477 1 1 1 1 1 1 1 462 463 476 477 476 477 476 477 476 477 476 477 476 477 476 477
368 368 368 368 368 368 368 368 344 345 373 488 463 468 469 468 469 462 463 1 1 1 1 1 470 469 468 469 468 469 468 469 468 469 468 469 468 469 468 469