Route124_Layout (80x80)
368 368 368 368 368 368 368 368 368 827 829 336 337 368 368 368 368 368 368 368 368 368 368 368 368 368 368 368 368 368 368 368 368 368 368 368 368 368 368 368 368 336 337 368 368 368 368 336 337 368 368 368 368 368 368 368 368 368 368 368 368 368 368 368 368 368 368 368 368 336 337 368 368 368 368 368 368 368 368 368
368 368 368 368 827 828 829 336 337 381 382 344 345 368 368 368 368 368 368 368 368 368 368 368 368 368 368 368 368 368 368 368 368 368 368 368 368 368 368 368 368 344 345 336 337 373 374 344 345 373 374 368 368 368 368 368 368 368 368 368 368 368 368 370 828 828 828 372 368 344 345 368 368 368 368 368 368 368 368 368
368 368 827 828 830 113 380 344 345 368 368 368 368 336 337 368 368 368 368 368 368 368 368 368 368 368 368 368 368 368 368 368 368 827 828 828 828 829 368 827 829 368 368 344 345 381 382 368 368 381 382 373 374 370 828 828 828 372 368 368 373 374 368 378 113 107 109 190 372 368 368 368 368 368 368 368 368 368 368 368
368 368 378 107 108 109 380 368 368 368 334 334 368 344 345 827 829 368 368 368 368 368 368 368 368 368 368 368 368 336 337 368 827 830 113 113 113 830 829 381 382 368 368 368 368 368 368 368 368 368 368 381 382 378 113 113 113 380 373 374 381 382 368 386 137 123 125 113 380 368 368 368 336 337 368 368 368 368 368 368
368 368 378 115 113 117 380 368 368 334 335 335 334 368 368 381 382 368 368 368 368 368 336 337 368 368 827 829 368 344 345 827 830 107 108 108 109 113 380 368 368 368 334 334 368 368 368 336 337 368 336 337 368 386 121 137 113 380 381 382 368 368 336 337 386 121 121 121 388 827 828 829 344 345 368 368 368 368 368 368
368 368 378 115 113 117 830 829 368 334 335 335 334 368 368 368 368 827 828 829 827 829 344 345 827 829 381 382 827 829 368 378 113 115 113 113 190 109 380 368 368 334 335 335 334 368 368 344 345 368 344 345 368 827 829 386 121 388 368 336 337 368 344 345 368 827 829 368 368 378 113 380 368 368 368 368 368 368 368 368
368 368 378 115 113 190 109 380 368 368 334 334 368 368 368 368 368 378 116 388 381 382 368 368 381 382 368 368 381 382 368 378 107 190 107 108 109 117 830 829 368 334 335 335 334 368 368 368 368 368 368 368 368 381 382 368 368 368 368 344 345 368 368 368 368 381 382 368 368 386 121 388 368 368 368 368 368 368 368 368
368 368 378 115 113 113 117 380 368 368 368 368 368 368 368 368 368 386 388 368 368 368 368 368 368 429 514 828 828 515 431 378 115 107 190 113 117 190 109 380 368 368 334 334 368 368 368 368 368 368 429 514 828 828 828 515 431 368 368 368 368 368 368 368 368 368 368 368 368 368 368 827 829 368 368 368 368 368 368 368
368 368 378 123 137 113 117 380 368 368 368 368 368 368 368 368 368 368 368 368 368 368 368 368 368 437 358 113 113 359 439 378 115 115 113 113 117 113 117 830 829 368 368 368 368 368 368 368 368 368 437 358 107 108 109 359 412 430 430 431 368 368 368 368 368 368 368 368 368 368 368 381 382 368 368 368 368 368 368 368
368 368 386 137 115 113 117 830 829 368 827 829 368 368 368 368 368 368 368 368 368 368 368 368 368 437 358 113 113 359 439 378 115 115 113 113 117 113 117 113 380 368 368 368 368 368 368 368 368 368 437 358 115 113 117 359 414 414 414 412 431 368 368 368 368 368 368 368 334 334 368 368 368 336 337 368 368 368 368 368
368 368 368 378 123 137 117 113 380 368 381 382 368 368 368 368 368 368 368 368 368 368 368 368 368 437 366 137 113 359 439 378 115 123 124 124 125 116 125 113 380 368 368 368 368 368 368 368 368 368 437 358 123 137 117 359 414 414 414 414 439 368 368 368 368 368 368 334 335 335 334 368 368 344 345 368 368 368 368 368
368 368 368 386 137 123 125 113 830 829 368 368 368 368 368 368 368 368 368 368 368 368 368 368 368 437 414 366 121 367 439 378 123 137 113 113 116 125 107 109 380 827 829 368 368 368 368 368 368 368 437 366 137 123 125 359 414 414 414 414 439 368 368 368 368 368 368 334 335 335 334 368 368 368 827 829 368 368 368 368
368 368 368 368 386 137 113 113 113 380 827 828 829 368 336 337 368 368 368 368 368 368 368 368 368 437 414 414 414 414 439 378 113 123 124 124 125 113 123 125 380 381 382 827 828 829 368 368 368 368 445 419 366 137 113 359 414 414 414 414 439 368 368 368 368 368 368 368 334 334 368 368 368 368 381 382 368 368 368 368
368 368 368 368 368 386 137 113 113 380 378 113 830 829 344 345 368 368 368 368 368 368 368 368 368 445 419 414 414 414 439 386 121 137 113 113 113 113 113 113 380 368 368 378 113 380 368 827 829 368 368 445 419 366 121 367 414 414 414 414 439 368 368 368 368 368 368 368 368 368 368 368 368 368 368 368 336 337 368 827
368 368 368 368 368 368 378 113 116 388 378 113 113 380 368 827 828 829 368 368 336 337 368 368 368 368 445 446 446 446 447 368 368 386 137 113 113 113 116 121 388 368 368 386 121 388 368 381 382 368 368 368 445 360 361 419 414 414 414 420 447 368 368 368 368 368 368 368 368 368 368 368 368 368 368 368 344 345 368 381
368 368 368 368 373 374 386 121 388 368 386 121 121 388 368 378 113 380 368 368 344 345 368 368 336 337 827 828 829 368 368 368 368 368 386 121 121 121 388 368 368 368 368 368 827 829 368 368 827 828 828 828 829 344 345 445 446 446 446 447 368 368 368 368 368 336 337 368 368 368 368 368 368 368 368 368 368 368 336 337
368 368 336 337 381 382 368 368 368 368 373 374 368 368 368 386 121 388 827 829 368 368 336 337 344 345 378 113 380 368 368 336 337 827 829 368 368 368 368 368 368 368 368 368 381 382 368 827 830 107 108 109 830 828 829 368 368 368 368 368 368 368 368 336 337 344 345 368 368 368 368 368 368 368 368 368 368 368 344 345
368 368 344 345 368 368 368 336 337 368 381 382 368 368 368 368 368 368 381 382 368 368 344 345 368 368 381 121 388 368 368 344 345 381 382 368 368 368 368 368 368 368 368 368 368 827 828 830 107 190 113 190 108 109 830 828 829 368 368 336 337 368 368 344 345 368 368 827 829 368 368 368 368 368 368 368 368 368 368 827
336 337 368 368 368 368 368 344 345 368 368 368 368 368 368 368 368 368 368 368 368 368 368 368 368 368 368 368 368 336 337 368 368 368 368 368 368 368 368 368 368 368 827 828 829 378 107 109 115 113 107 109 113 117 107 109 380 368 368 344 345 827 829 368 368 368 368 381 382 368 827 828 829 368 368 368 368 368 368 381
344 345 368 368 368 368 368 368 368 368 368 368 368 368 368 368 368 368 368 368 368 368 368 368 368 368 368 368 368 344 345 368 368 368 368 368 827 829 368 368 368 368 378 113 380 378 123 125 123 137 123 125 116 125 123 125 380 827 829 368 368 381 382 368 368 334 334 368 368 827 830 113 380 368 368 368 368 368 368 368
368 368 368 368 368 368 368 368 368 368 368 368 368 368 368 368 368 368 368 368 368 368 368 368 368 368 368 368 368 368 368 368 368 368 368 368 381 382 368 368 368 368 386 121 388 386 121 137 113 123 124 124 125 113 113 113 380 381 382 368 368 368 368 368 334 335 335 334 368 378 113 113 830 829 368 368 368 368 368 827
368 368 368 368 368 368 368 368 368 368 368 368 368 368 368 368 368 368 368 368 368 368 368 368 368 368 368 368 368 368 368 368 368 368 368 368 368 368 368 368 368 368 368 368 368 368 368 386 121 137 113 113 113 113 116 121 388 368 368 368 368 368 368 368 334 335 335 334 368 378 113 113 113 830 828 829 368 368 368 378
368 368 368 368 368 368 368 368 368 368 368 368 368 368 368 368 368 368 368 368 368 368 368 368 368 368 368 368 368 368 368 368 368 368 368 368 368 368 368 368 368 368 368 368 368 368 368 368 368 386 121 121 121 121 388 368 368 368 368 368 368 368 368 368 368 334 334 368 368 378 113 113 113 113 113 380 368 368 368 386
368 368 368 368 368 368 368 368 368 368 368 368 368 368 368 368 368 368 368 368 368 368 368 368 368 368 368 368 368 368 368 368 368 368 368 368 368 368 368 368 368 368 368 368 368 368 368 368 827 829 368 368 368 368 368 336 337 368 368 368 368 368 368 368 368 368 368 368 827 830 113 107 108 109 113 830 829 368 368 368
368 368 368 368 368 368 368 368 368 368 368 368 368 368 368 368 368 368 368 368 368 368 368 368 368 368 368 368 368 368 368 368 368 368 368 368 368 368 368 368 368 368 368 368 368 368 368 368 381 382 368 368 368 368 368 344 345 368 368 368 368 368 368 368 368 368 368 368 378 113 107 190 113 190 108 109 830 829 368 368
368 368 368 368 368 368 368 368 368 368 368 368 368 368 368 368 368 368 368 368 368 368 368 368 368 368 368 368 368 368 368 368 368 368 368 368 368 368 368 368 368 368 368 368 368 368 368 368 368 368 368 368 368 368 368 368 368 368 368 368 368 368 368 336 337 827 828 828 830 113 115 113 113 113 113 117 113 830 828 828
368 368 368 368 368 368 368 368 368 368 368 368 368 368 368 368 368 368 368 368 368 368 368 368 368 368 368 368 368 368 368 368 368 368 368 368 368 368 368 368 368 368 368 368 368 368 368 368 368 368 368 368 368 368 368 368 368 368 368 368 827 829 368 344 345 378 113 113 107 108 190 113 113 113 113 190 108 109 113 113
368 368 368 368 368 368 368 368 368 368 368 368 368 368 368 368 368 368 368 368 368 368 368 368 368 368 368 368 368 368 368 368 368 368 368 368 368 368 368 368 368 368 368 368 368 368 368 368 368 368 368 368 368 368 368 368 368 368 368 368 381 382 368 368 368 378 113 113 115 113 113 113 113 113 113 113 113 190 109 113
368 368 368 368 368 368 368 368 368 368 368 368 368 368 368 368 368 368 368 368 368 368 368 368 368 368 368 368 368 368 368 368 368 368 368 368 368 368 368 368 368 368 368 368 368 368 368 368 368 368 368 368 368 368 368 368 368 368 368 368 368 368 368 368 368 386 121 137 115 113 113 113 113 113 113 113 113 113 117 113
336 337 368 368 368 368 368 368 368 368 368 368 368 368 368 368 368 368 368 368 368 368 368 368 368 368 368 368 368 368 368 368 368 368 368 368 368 368 368 368 368 368 368 368 368 368 368 368 368 368 368 368 368 368 368 368 368 368 368 368 368 368 368 368 368 368 368 378 123 124 137 113 113 113 113 113 113 113 190 109
344 345 336 337 368 368 373 374 368 368 368 368 368 368 368 368 368 368 368 368 368 368 368 368 368 368 368 368 368 368 334 334 368 368 368 368 368 368 368 368 368 368 368 368 368 368 368 368 368 546 546 368 368 368 368 368 368 368 368 368 368 368 368 368 368 368 368 386 145 137 115 113 113 113 113 113 113 113 113 117
368 368 344 345 373 374 381 382 368 368 368 368 368 368 368 368 368 368 368 368 368 368 368 368 368 368 368 368 368 334 335 335 334 368 368 368 368 368 368 368 368 368 368 368 368 368 368 368 368 368 368 368 368 368 368 368 368 368 368 368 368 368 368 368 368 368 368 368 368 378 123 124 137 113 113 113 113 113 113 117
368 368 368 368 381 382 368 368 368 368 368 368 368 368 368 368 368 368 368 368 368 368 368 368 368 368 368 368 368 334 335 335 334 368 368 368 368 368 368 368 368 368 368 368 368 368 368 368 368 368 368 368 368 368 368 368 368 368 368 368 368 368 368 368 368 334 334 368 368 386 145 137 115 113 113 113 113 113 113 117
368 368 368 368 368 373 379 379 374 368 368 368 368 334 334 368 368 368 368 368 368 368 368 368 368 368 368 368 368 368 334 334 368 368 368 368 368 368 368 368 368 545 545 545 368 368 368 368 368 368 368 368 368 368 368 368 368 368 368 368 368 368 368 368 334 335 335 334 368 827 829 378 115 113 113 113 113 113 113 117
368 368 368 368 368 378 107 109 180 379 379 829 368 334 334 368 368 368 373 374 368 368 368 368 368 368 368 368 368 368 368 368 368 368 368 368 368 368 368 368 368 546 546 546 368 368 368 368 368 368 368 368 368 368 368 368 368 368 368 368 368 368 368 368 334 335 335 334 368 381 382 378 115 113 113 113 113 113 113 117
368 368 336 337 368 378 123 125 113 113 113 380 368 368 368 368 827 829 381 382 368 368 368 368 368 368 368 368 368 368 368 368 368 368 368 368 368 368 368 368 368 368 368 368 334 334 368 368 368 368 368 368 368 368 368 368 368 368 368 368 368 368 368 368 368 334 334 368 368 368 368 378 123 124 137 113 113 113 113 117
368 368 344 345 368 386 121 137 113 113 113 830 828 828 828 828 830 380 368 368 368 368 368 368 368 368 368 368 368 368 368 368 368 368 368 368 368 368 368 368 368 368 368 334 335 335 334 368 368 368 368 368 368 368 368 368 368 368 368 368 368 368 368 368 368 368 368 368 368 368 368 386 145 137 123 124 137 113 116 125
368 368 368 368 368 368 368 386 137 113 107 109 113 113 113 113 113 380 368 368 368 368 368 368 368 368 368 368 368 368 368 368 368 368 368 368 368 368 368 368 368 368 368 334 335 335 334 368 368 368 368 368 368 368 368 368 429 430 430 430 430 430 430 431 368 368 368 368 368 334 334 368 368 386 145 137 115 113 117 116
368 368 368 368 368 368 368 368 386 137 123 125 113 113 113 113 116 388 368 368 368 368 368 368 368 368 368 368 368 368 368 368 368 368 368 368 368 368 368 368 368 368 368 368 334 334 368 368 368 368 368 368 368 368 368 368 437 405 406 406 406 406 407 412 431 368 368 368 334 335 335 334 368 827 829 378 115 113 117 380
368 368 368 368 368 368 373 374 368 386 121 121 121 121 121 121 388 368 368 368 368 368 368 368 368 368 368 368 368 368 368 368 368 368 368 368 368 368 368 368 368 368 368 368 368 368 368 368 368 368 368 368 368 368 368 429 411 413 292 292 292 292 390 407 439 368 368 368 334 335 335 334 368 381 382 378 115 113 117 380
368 368 368 368 368 368 381 382 368 368 368 827 829 368 368 368 368 368 368 368 368 368 368 368 368 368 368 368 368 368 368 368 368 368 368 368 368 368 368 368 368 368 368 368 368 368 368 368 368 368 368 368 368 368 368 437 414 413 292 292 292 292 292 415 412 431 368 368 368 334 334 368 827 829 368 378 123 124 125 380
368 368 368 368 368 368 368 368 368 827 829 381 382 368 368 368 368 368 368 368 368 368 368 368 368 368 368 368 368 368 368 368 368 368 368 368 368 368 368 368 368 368 368 368 368 368 368 368 368 368 368 368 368 368 368 437 414 413 292 292 292 292 292 415 414 439 368 368 368 368 368 368 381 382 368 386 145 145 145 388
368 368 368 368 368 368 368 368 368 381 382 368 368 368 368 368 368 368 368 368 368 368 368 368 368 368 368 368 368 368 368 368 368 368 368 368 368 368 368 368 368 368 368 368 368 368 368 368 368 368 368 368 368 368 368 437 414 421 397 292 292 292 292 415 414 439 368 368 368 368 368 368 368 368 368 368 827 829 368 368
368 368 368 368 368 368 368 336 337 368 368 368 368 368 368 368 368 368 368 368 368 368 368 368 368 368 368 368 368 368 368 827 829 368 368 368 368 368 368 368 368 368 368 368 368 368 368 368 368 368 368 368 368 368 368 445 419 414 413 292 292 292 398 423 420 447 368 368 368 368 368 368 368 368 368 368 381 382 827 829
368 368 368 368 368 368 368 344 345 368 368 336 337 368 368 368 368 368 368 368 368 368 368 368 368 368 336 337 368 368 368 381 382 368 368 368 368 368 368 368 368 368 368 368 368 368 368 368 368 368 368 368 368 368 368 368 445 419 421 422 422 422 423 420 447 368 368 429 430 430 430 430 430 430 431 368 368 368 381 382
368 368 368 368 368 368 336 337 368 368 368 344 345 368 368 368 368 368 368 368 368 368 368 368 368 368 344 345 368 368 368 368 368 368 368 368 368 368 368 368 368 368 368 368 368 368 368 368 368 368 368 368 368 368 368 368 368 445 419 414 414 420 446 447 368 368 368 437 405 8 9 9 10 414 412 431 368 368 368 368
368 368 368 368 368 368 344 345 336 337 368 368 368 368 368 368 368 368 368 368 368 368 368 368 368 368 368 368 827 828 828 828 828 828 828 829 368 368 368 368 368 368 368 368 368 368 368 368 368 368 368 368 368 368 368 368 368 368 445 446 446 447 368 368 368 368 429 411 413 16 17 17 18 406 407 439 368 368 368 368
368 368 368 368 368 368 368 368 344 345 368 368 368 368 368 368 368 368 368 368 368 368 368 368 368 827 828 829 378 113 113 107 108 108 109 830 828 828 829 368 368 368 368 368 368 368 368 368 368 368 368 368 334 334 368 368 368 368 368 368 368 368 368 368 368 368 437 414 413 736 25 11 737 292 415 412 431 368 368 368
368 368 368 368 368 368 368 368 368 368 336 337 368 368 368 368 368 368 368 368 336 337 368 368 368 378 113 380 378 113 113 115 113 113 190 108 108 109 380 368 368 368 368 368 368 368 368 368 368 368 368 334 335 335 334 368 368 368 368 368 368 368 368 368 368 368 437 414 413 744 33 19 745 3 415 414 439 368 368 368
368 368 368 368 368 368 368 368 368 368 344 345 827 829 827 828 829 368 368 368 344 345 368 368 368 386 121 388 386 121 137 123 124 124 137 113 113 117 830 829 368 827 829 368 368 368 368 368 368 368 368 334 335 335 334 368 368 368 368 368 368 368 368 368 368 368 437 414 421 397 292 292 292 292 415 414 439 368 368 368
368 368 368 368 368 368 368 368 336 337 368 368 381 382 378 113 830 829 827 829 368 827 828 828 828 829 368 368 368 368 386 145 145 137 123 124 124 125 113 380 368 381 382 368 368 368 368 368 368 368 368 368 334 334 368 368 368 368 368 368 368 368 368 368 368 368 445 419 414 413 292 292 292 398 423 420 447 368 368 368
368 336 337 368 368 336 337 368 344 345 368 368 368 368 378 113 113 380 381 382 368 378 107 108 109 380 368 368 368 368 368 368 368 386 121 137 113 113 113 830 829 368 368 368 368 368 368 368 368 368 368 368 368 368 368 368 368 368 368 368 368 368 368 334 334 368 368 445 419 421 422 422 422 423 420 447 368 368 368 368
368 344 345 336 337 344 345 827 829 368 368 368 368 368 386 137 113 380 368 368 368 378 123 137 117 380 368 368 429 430 430 430 431 368 368 386 121 137 113 113 380 368 368 368 368 368 368 368 368 368 368 368 368 368 368 368 368 368 368 368 368 368 334 335 335 334 368 368 445 419 414 414 420 446 447 368 368 368 368 368
336 337 368 344 345 368 368 381 382 368 368 368 827 829 368 386 121 388 368 368 368 381 137 123 125 380 368 368 437 414 414 414 439 368 368 368 368 378 113 113 380 368 368 368 368 368 368 368 368 368 368 368 368 368 368 368 368 368 368 368 368 368 334 335 335 334 368 368 368 445 446 446 447 368 368 368 368 368 368 368
344 345 368 368 368 368 368 368 368 368 368 368 381 382 368 368 368 368 368 827 829 368 381 121 121 388 368 368 445 419 414 414 439 368 827 829 368 386 121 121 388 368 368 368 368 368 368 368 368 368 368 368 368 368 368 368 368 368 368 368 368 368 334 335 335 334 368 368 368 368 368 368 368 368 368 368 368 368 368 368
368 336 337 368 368 368 368 368 368 368 368 368 368 368 368 368 368 368 368 381 382 368 368 368 368 368 368 368 368 445 446 446 447 368 381 382 368 368 827 829 368 368 368 368 368 368 368 368 368 368 368 368 368 368 368 368 368 368 368 368 368 368 368 334 334 368 368 368 368 368 368 368 368 368 368 368 368 368 368 368
368 344 345 336 337 368 368 368 368 368 368 368 368 368 368 368 368 368 368 368 368 368 368 368 368 368 368 368 368 368 368 368 368 368 368 368 368 368 381 382 336 337 368 368 368 368 368 368 368 368 368 368 368 368 368 368 368 368 368 368 368 368 368 368 368 368 368 368 368 368 368 368 368 368 368 368 368 368 368 368
368 368 368 344 345 368 368 368 368 368 368 368 368 368 368 368 368 368 368 368 368 368 368 368 368 368 368 368 368 336 337 368 368 368 368 368 827 828 829 368 344 345 368 368 368 368 368 368 368 368 368 368 368 368 368 334 334 368 368 368 368 368 368 368 368 368 368 368 368 368 368 368 368 368 368 368 368 368 368 368
368 368 368 368 336 337 368 368 368 368 368 368 368 368 368 368 368 368 368 368 368 368 368 368 368 368 368 827 829 344 345 827 829 368 368 368 378 113 380 827 829 368 368 368 368 368 368 368 368 368 368 368 368 368 334 335 335 334 368 368 368 368 368 368 368 368 368 368 368 368 368 368 368 368 368 368 368 368 368 368
368 368 368 368 344 345 368 368 368 368 368 368 368 368 368 368 368 368 368 368 368 368 368 368 368 368 368 381 382 368 368 381 382 368 827 829 386 121 388 381 382 368 368 368 368 336 337 368 368 368 368 368 368 368 334 335 335 334 368 368 368 368 368 368 368 368 368 368 368 368 368 368 368 368 368 368 368 368 368 429
368 368 368 827 829 368 368 368 368 368 334 334 368 368 368 368 368 368 368 368 368 368 368 368 368 368 827 829 368 368 368 368 336 337 381 382 368 368 368 368 827 828 828 829 368 344 345 368 368 368 368 368 368 368 368 334 334 368 368 368 368 368 368 368 368 368 368 368 368 368 368 368 368 368 368 368 368 368 368 437
368 368 368 381 382 368 368 368 368 334 335 335 334 368 368 368 368 368 368 368 368 368 368 827 828 829 381 382 368 368 368 368 344 345 368 368 368 429 430 431 378 113 113 380 368 368 368 368 368 368 368 368 368 368 368 368 368 368 368 368 368 368 368 368 368 368 368 368 368 368 368 368 368 368 368 368 368 368 368 437
368 368 336 337 368 368 368 368 368 334 335 335 334 368 368 368 368 368 368 368 827 829 827 830 113 380 368 368 336 337 368 368 368 368 368 429 430 411 414 439 378 113 113 830 829 368 368 368 368 368 368 368 368 368 368 368 368 368 368 368 368 368 368 368 368 368 368 368 368 368 368 368 368 368 368 368 368 368 368 437
368 368 344 345 827 829 368 368 368 368 334 334 368 368 368 368 368 368 368 368 381 382 378 113 113 380 368 368 344 345 368 368 368 368 368 437 414 414 414 439 378 107 108 109 380 368 368 368 368 368 368 368 368 368 368 368 368 368 368 368 368 368 368 368 368 368 368 368 368 368 334 334 368 368 368 368 368 368 368 437
368 368 368 368 381 382 368 368 368 368 368 368 368 827 828 828 828 828 829 368 368 368 386 121 121 388 827 829 368 368 334 334 368 368 368 437 414 414 414 439 378 115 113 117 380 368 827 829 368 368 336 337 368 368 368 368 368 368 368 368 368 368 368 368 368 368 368 368 368 334 335 335 334 368 368 368 368 368 368 437
368 368 368 368 368 336 337 827 829 368 368 368 368 378 113 113 113 113 830 828 828 828 829 368 368 368 381 382 368 334 335 335 334 368 368 445 419 414 414 439 378 115 113 117 830 829 381 382 336 337 344 345 368 368 368 368 368 368 368 368 368 368 368 368 368 368 368 368 368 334 335 335 334 368 368 368 368 368 368 437
368 368 368 368 368 344 345 381 382 368 368 368 827 830 107 108 108 108 108 108 109 113 830 828 828 829 368 368 368 334 335 335 334 368 368 368 445 446 446 447 378 123 137 117 113 380 368 368 344 345 368 827 829 368 368 368 368 368 368 368 368 368 368 368 368 368 368 368 368 368 334 334 368 368 368 368 368 368 368 437
368 368 368 368 368 368 368 368 827 828 829 368 378 113 115 113 113 107 108 109 190 108 109 113 113 380 368 368 368 368 334 334 368 368 368 368 368 368 368 368 386 137 115 117 113 380 368 368 368 368 368 381 382 336 337 368 368 368 368 368 368 368 368 368 368 368 368 368 368 368 368 368 368 368 368 368 368 368 368 445
368 368 368 368 368 368 368 368 378 113 380 827 830 113 123 124 137 115 113 190 108 109 190 108 109 380 368 368 368 368 368 368 368 368 368 368 368 368 368 368 368 378 123 125 116 388 368 368 368 368 368 368 368 344 345 336 337 368 368 368 368 368 368 368 368 368 368 368 368 368 368 368 368 368 368 368 368 368 368 368
368 368 368 368 368 368 368 368 386 121 388 378 113 113 113 113 115 123 124 124 124 125 113 113 117 830 828 829 368 368 368 368 368 368 368 368 368 368 368 368 368 386 121 121 388 368 368 368 368 368 368 368 368 368 368 344 345 368 368 368 368 368 368 368 368 368 368 368 368 368 368 368 368 368 368 368 368 368 368 368
368 368 368 368 368 368 827 828 828 828 828 830 113 113 113 113 123 169 169 169 169 137 113 113 117 113 113 380 368 368 368 368 368 368 368 368 368 368 368 827 829 368 368 368 368 368 368 368 368 368 368 368 368 368 368 368 336 337 368 368 368 368 368 368 368 368 368 368 368 368 368 368 368 368 368 368 368 368 368 368
368 827 828 828 828 828 830 113 113 113 113 113 113 107 108 108 109 113 113 113 113 123 124 124 125 113 113 380 368 368 368 368 368 368 368 368 368 368 368 381 382 827 828 829 368 827 829 368 368 368 368 368 334 334 368 368 344 345 368 368 368 368 368 368 368 368 368 368 368 368 368 368 368 368 368 368 368 368 368 368
368 378 113 113 107 108 108 108 108 108 108 109 113 115 113 113 190 109 113 113 113 116 121 137 113 113 113 380 368 368 368 368 827 828 828 828 829 336 337 368 368 378 113 380 368 381 382 368 368 368 368 334 335 335 334 368 336 337 368 368 368 368 368 368 368 368 368 368 368 368 368 368 368 368 368 368 368 368 368 368
827 830 107 108 190 113 113 113 113 113 113 190 109 123 124 124 124 125 113 113 113 380 368 386 121 121 121 388 827 829 368 368 378 113 113 113 380 344 345 368 368 386 121 388 368 368 368 368 368 368 368 334 335 335 334 368 344 345 368 368 368 368 368 368 368 368 368 368 368 368 368 368 368 827 828 828 828 828 828 829
378 107 190 113 107 108 108 108 108 108 108 109 190 108 109 113 113 113 113 113 113 380 827 829 368 368 368 368 381 382 368 368 386 137 113 113 380 368 368 368 368 336 337 368 368 368 368 368 368 368 368 368 334 334 368 336 337 368 368 368 368 368 368 368 368 368 368 368 368 368 827 828 828 830 113 113 113 113 113 830
378 115 107 108 190 113 113 113 113 113 113 190 108 109 190 108 108 109 113 113 113 380 381 382 368 368 368 368 368 368 827 829 368 386 121 121 388 368 368 368 368 344 345 368 368 368 368 368 368 368 368 368 368 368 368 344 345 368 368 368 368 368 368 368 368 368 368 368 368 368 378 147 148 113 113 147 148 113 113 113
378 115 115 113 113 113 116 124 124 124 124 124 124 125 113 113 113 190 109 113 113 380 368 368 368 368 368 368 368 368 381 382 368 368 368 368 368 368 368 368 368 368 368 368 368 368 368 368 368 368 368 368 368 827 829 368 368 368 368 368 368 368 368 368 368 368 368 368 368 368 378 155 156 113 113 155 156 113 113 113
378 115 115 116 124 124 125 113 113 116 169 169 169 169 124 124 137 113 117 113 113 380 368 368 368 368 368 368 368 368 368 368 368 368 368 368 368 368 368 368 368 368 368 531 531 368 368 368 368 368 368 368 368 381 382 368 368 368 368 368 368 368 368 368 368 368 336 337 368 827 830 113 107 108 108 108 108 108 108 108
378 115 115 117 116 169 169 124 124 125 113 113 113 113 113 113 115 113 117 113 113 380 368 368 368 368 368 368 368 368 368 368 368 368 368 368 531 368 368 368 368 368 531 531 531 368 368 368 368 368 368 368 368 368 336 337 368 368 368 368 368 368 368 368 368 368 344 345 368 378 113 107 190 113 113 113 147 148 113 113
378 115 115 117 117 116 145 145 145 145 121 124 124 124 124 137 115 113 117 113 113 380 368 368 368 368 368 368 368 368 368 368 368 368 368 336 337 827 828 829 368 368 336 337 827 828 829 368 368 368 368 368 368 368 344 345 368 368 368 368 368 368 368 368 368 368 368 368 827 830 113 115 113 113 113 113 155 156 113 113