Route114_Layout (40x80)
619 620 619 620 619 620 619 620 619 620 619 620 619 620 619 519 791 798 799 624 624 788 633 633 791 798 798 798 798 798 798 798 798 798 798 798 798 798 798 798
627 628 627 628 627 527 526 527 526 527 526 527 526 527 526 527 765 616 617 632 624 788 633 633 765 616 617 617 617 617 617 617 617 617 617 617 617 617 617 617
619 620 619 620 527 798 798 798 798 798 798 798 798 798 798 798 799 624 616 617 632 797 798 798 799 624 616 617 836 837 837 838 617 617 617 617 617 617 617 617
627 628 627 527 765 616 617 617 617 617 617 617 617 617 617 617 617 632 624 781 616 617 617 617 617 632 624 616 645 646 646 647 706 707 706 707 706 707 706 707
619 620 619 519 765 624 616 617 617 617 617 617 617 617 617 617 617 617 632 616 632 616 617 617 617 617 632 624 653 669 670 655 714 715 714 715 714 715 714 715
627 628 627 527 765 624 624 771 625 384 393 393 393 393 393 393 393 393 385 624 616 632 616 617 617 617 617 632 661 677 678 663 648 649 649 650 648 649 649 650
527 526 527 633 765 624 624 788 633 400 368 368 368 368 368 368 368 368 402 624 624 616 632 771 625 625 625 625 796 633 633 679 656 667 667 658 656 667 667 658
798 798 798 798 799 624 624 788 633 400 368 368 368 368 376 616 617 617 617 632 624 624 771 796 384 393 393 385 633 744 746 3 656 657 667 658 656 657 667 658
617 617 617 617 617 632 624 788 633 400 368 368 376 616 617 632 616 617 617 617 632 624 788 671 400 368 368 402 633 752 754 633 664 665 665 666 664 665 665 666
617 617 617 617 617 617 632 797 798 400 368 368 402 624 616 617 632 616 617 617 617 632 788 633 400 368 368 402 671 752 754 633 633 633 633 633 633 633 633 633
617 617 617 617 617 617 617 617 617 187 179 179 188 632 624 616 617 632 771 625 625 625 796 633 756 756 756 756 633 752 754 633 633 633 633 633 633 633 633 633
616 617 617 617 617 617 617 617 617 185 185 185 185 617 632 624 771 532 519 633 744 745 745 745 745 745 745 745 745 753 754 633 648 649 649 650 648 649 649 650
624 616 617 706 707 706 707 617 617 185 185 185 185 617 617 632 788 526 527 671 752 753 761 761 761 761 761 761 761 761 762 633 656 667 657 658 656 657 667 658
624 624 771 714 718 719 718 533 625 44 52 52 60 625 532 533 796 384 393 385 752 754 633 633 671 633 633 633 633 633 518 519 656 667 667 658 656 667 667 658
632 624 788 518 620 619 627 527 633 400 368 368 402 518 627 619 519 400 368 402 752 754 633 384 393 393 393 385 671 633 526 527 664 665 665 666 664 665 665 666
617 632 788 526 527 526 527 633 384 408 368 368 402 526 527 526 527 400 368 402 752 754 633 400 368 368 368 402 633 518 519 633 633 633 633 633 633 518 519 679
393 393 393 393 393 346 347 393 408 368 368 368 402 633 679 633 633 756 756 756 752 754 633 400 368 368 368 402 518 620 628 519 518 519 671 633 518 620 619 519
368 336 337 368 368 344 345 336 337 368 368 368 410 393 393 385 633 518 519 633 752 754 671 400 368 368 368 402 526 628 627 628 620 619 519 518 620 527 526 619
368 344 345 716 717 716 717 344 345 368 368 368 368 368 368 402 518 620 628 519 752 754 633 756 756 756 756 756 633 526 619 620 628 627 628 627 619 519 518 627
625 625 532 719 718 627 619 533 377 368 368 368 368 368 368 402 526 628 627 527 760 762 633 633 633 633 518 519 633 518 620 527 526 628 627 628 627 628 627 619
546 518 620 619 620 619 627 527 400 368 368 368 368 368 368 402 633 526 527 633 633 633 633 633 633 633 526 527 671 526 619 519 518 620 619 620 619 620 619 620
554 526 628 627 628 627 619 519 400 368 368 368 368 368 368 410 393 393 393 704 651 651 705 393 393 393 393 393 393 385 526 628 627 628 620 527 526 628 627 628
564 546 526 619 620 619 620 527 400 368 368 368 368 368 368 368 368 368 368 712 659 659 713 368 368 368 368 368 368 402 518 620 619 620 619 519 518 620 619 620
577 564 546 526 527 526 527 384 408 368 368 368 368 368 368 368 368 368 368 712 659 659 713 368 368 368 368 368 368 402 526 628 627 527 526 628 627 628 627 628
577 577 564 545 545 545 546 400 368 368 368 368 368 368 368 368 368 368 368 712 659 659 713 368 368 368 368 368 368 402 518 620 619 519 518 620 619 620 619 620
573 577 577 577 577 577 554 400 368 376 211 2 2 212 377 368 368 368 368 712 659 659 713 368 368 368 368 368 368 402 526 527 526 619 620 619 627 527 526 527
581 577 577 577 577 577 554 400 368 402 1 30 31 1 400 368 368 368 368 712 659 659 713 368 368 368 368 368 368 410 393 393 385 526 527 526 527 544 545 545
564 572 573 577 577 577 554 400 368 402 4 38 39 4 400 368 368 368 368 712 659 659 713 368 368 368 368 368 368 368 368 368 402 544 545 545 563 563 577 577
577 577 581 577 577 577 554 400 368 402 1 1 4 1 400 368 368 368 368 712 659 659 713 368 368 368 368 368 368 368 368 368 402 552 577 577 577 571 572 572
577 577 564 573 577 577 554 400 368 410 393 393 393 393 408 368 368 368 368 712 659 659 713 368 368 368 368 368 368 368 368 368 402 552 577 577 577 579 577 577
577 577 577 581 577 577 554 2 377 368 368 368 368 368 368 368 368 368 368 712 659 659 713 368 368 368 368 368 368 368 368 368 402 552 577 577 577 579 577 577
577 577 577 581 577 577 554 1 400 368 368 368 368 368 368 368 368 368 368 712 659 659 713 368 368 368 368 368 368 368 368 368 402 552 577 571 572 563 577 577
577 577 577 581 577 577 554 1 400 368 368 368 368 368 368 368 368 368 368 712 659 659 713 368 368 368 368 368 368 368 368 368 402 576 577 579 577 577 571 572
577 577 577 581 577 577 554 1 2 2 2 2 2 2 377 368 368 368 368 712 659 659 713 376 2 8 9 9 9 10 2 2 2 576 577 579 577 577 579 577
577 577 577 564 572 573 564 569 569 569 569 570 1 1 2 2 2 2 2 1 1 1 1 2 1 16 17 17 17 18 13 13 1 576 577 579 577 577 579 577
572 572 572 573 577 564 572 572 572 572 573 581 1 1 1 1 1 1 1 1 1 1 1 1 1 24 11 25 11 26 13 13 13 576 577 579 577 571 563 577
573 577 577 581 573 577 577 577 577 577 581 564 569 570 816 825 825 825 826 1 1 1 824 825 817 32 19 33 19 34 1 13 13 576 577 579 577 579 577 577
564 572 573 564 564 572 572 573 577 577 581 577 577 554 828 1 1 1 1 1 1 1 1 1 829 826 480 481 482 824 817 13 13 576 577 579 577 579 577 577
577 577 581 577 577 577 577 581 573 577 564 573 577 554 828 1 1 1 1 1 1 1 568 570 1 3 1 1 1 1 827 13 13 576 577 579 577 579 577 577
577 577 581 577 577 577 577 581 581 573 577 581 577 554 828 1 1 1 1 1 1 13 584 586 1 1 1 1 1 1 827 1 13 576 577 579 577 579 577 577
577 577 581 577 577 577 577 581 581 581 577 581 577 554 828 1 1 1 1 1 13 13 13 568 570 1 1 1 1 1 827 1 1 576 577 579 577 579 577 577
577 580 589 577 577 580 613 589 581 581 577 581 577 554 828 1 1 816 825 825 826 13 13 584 586 1 1 1 1 1 827 1 1 576 577 579 577 579 577 577
580 589 577 577 580 589 577 577 581 581 577 581 577 554 828 623 1 828 13 13 13 13 13 13 13 1 1 1 1 1 831 260 261 576 577 579 577 579 577 577
581 577 577 580 589 577 577 577 581 581 577 581 577 554 828 1 1 828 13 13 13 13 13 13 1 1 1 1 1 1 812 268 269 576 577 579 577 579 577 577
581 577 577 581 577 577 577 577 581 581 577 581 577 564 564 570 1 828 13 13 13 13 13 1 1 1 1 824 817 1 812 268 269 576 577 579 577 579 577 577
581 577 580 589 577 580 613 613 589 581 577 581 577 577 577 564 570 828 13 13 13 13 1 1 1 1 1 1 827 1 812 268 269 576 577 579 577 579 577 577
581 577 581 577 580 589 580 613 613 589 580 589 577 577 577 577 578 828 13 13 1 824 825 825 825 825 817 1 827 1 820 276 277 576 577 579 577 579 577 577
564 573 581 577 581 580 589 577 580 520 589 577 577 577 577 577 578 828 1 1 1 1 1 1 1 1 827 1 834 623 834 568 569 563 572 563 577 579 577 577
577 581 581 577 581 581 577 577 581 577 577 577 577 577 577 577 578 835 1 1 1 1 1 1 1 1 827 1 568 569 569 563 571 572 572 572 572 563 577 577
577 581 581 577 581 581 577 580 589 577 577 577 577 580 175 207 586 13 13 13 568 570 1 1 1 1 827 568 579 571 572 572 563 571 572 572 572 572 572 572
577 581 581 577 581 564 573 581 577 577 577 577 577 578 13 13 13 13 13 13 584 586 1 1 1 1 827 576 579 579 577 577 571 563 577 577 577 577 577 577
577 581 564 573 564 573 581 581 577 577 577 577 577 578 13 13 13 13 13 13 13 13 1 1 1 1 827 576 579 587 520 588 579 577 577 577 577 577 577 577
577 581 577 581 577 581 581 581 595 596 577 577 577 578 13 13 13 13 13 13 13 13 13 1 1 1 834 576 579 577 577 579 579 577 577 577 577 577 577 577
577 581 577 581 577 581 581 581 603 604 577 577 577 564 569 569 570 13 13 13 13 13 13 568 569 569 569 563 579 577 577 579 579 577 577 577 577 577 577 577
577 581 577 581 577 581 581 564 572 596 577 577 577 577 577 577 578 13 13 13 13 13 13 576 571 572 572 572 563 577 577 579 587 588 577 577 577 577 571 572
577 581 577 581 577 564 564 573 577 564 572 596 577 577 577 577 564 569 570 13 13 13 13 576 579 577 577 577 577 577 577 579 577 579 577 577 577 577 579 577
577 564 573 564 572 572 573 564 573 577 577 564 572 596 577 577 577 577 578 13 1 13 13 576 579 577 577 577 577 577 577 579 577 587 588 577 577 577 579 577
577 577 564 572 572 573 564 573 564 572 572 573 577 578 577 577 577 577 578 1 623 1 13 576 587 175 207 588 577 577 577 587 520 588 579 577 577 571 563 577
577 577 577 577 577 581 577 564 573 577 577 581 573 578 577 577 577 577 564 569 569 569 569 563 577 577 577 579 577 577 577 577 577 579 579 577 577 579 577 577
577 577 577 577 577 581 577 577 581 577 577 581 581 578 577 577 577 577 577 577 577 577 577 577 577 577 577 579 577 577 577 577 577 579 579 577 577 579 577 577
577 577 577 580 613 589 577 577 581 577 580 589 581 578 577 577 577 577 577 577 577 577 577 577 577 577 577 579 577 577 577 577 577 579 579 577 577 579 577 577
577 577 580 589 580 613 613 613 589 580 589 577 581 564 572 572 572 572 572 572 572 573 577 577 577 577 571 563 577 577 577 577 571 563 579 577 577 579 577 577
577 577 581 580 589 580 613 613 601 589 580 520 589 577 571 572 572 572 572 572 573 578 571 572 572 572 563 597 577 577 577 577 579 577 579 577 577 579 577 577
577 577 581 581 577 581 580 613 609 613 589 577 597 571 579 577 577 577 577 577 564 564 563 572 573 597 595 596 577 577 577 577 579 577 579 577 577 579 577 577
577 577 581 581 580 589 581 3 577 577 577 577 571 563 563 577 577 577 577 577 577 577 577 577 581 573 603 604 577 577 577 571 563 577 579 577 571 563 577 577
577 577 581 581 581 577 581 577 577 577 577 571 579 577 577 577 577 577 577 577 577 577 577 577 564 564 573 577 577 577 577 579 577 571 563 577 579 577 577 577
577 577 581 581 581 580 589 577 577 577 577 579 579 577 577 577 577 577 571 572 572 573 577 577 577 577 581 573 577 577 577 579 577 579 577 577 579 577 577 577
577 577 581 581 581 581 595 596 577 577 577 579 587 175 207 613 588 571 563 577 577 581 577 577 577 577 581 581 577 577 577 579 577 579 577 577 579 577 577 577
577 577 581 581 581 581 603 604 577 577 577 587 588 577 577 577 579 579 577 577 580 589 577 577 577 577 581 581 577 577 577 579 571 563 577 577 579 577 577 577
577 577 581 581 564 564 573 577 577 577 577 577 587 175 207 588 579 587 588 577 581 577 577 580 175 207 589 581 577 577 577 579 579 577 577 571 563 577 577 577
577 577 581 563 573 577 581 573 577 577 577 577 577 577 577 579 587 588 587 520 589 577 580 589 577 577 577 581 577 577 577 579 579 577 577 579 577 577 577 577
577 577 581 577 581 577 581 581 577 577 577 577 577 577 577 587 588 579 577 577 577 577 581 580 175 207 613 589 577 577 577 579 579 577 577 579 577 577 577 577
577 577 581 577 581 577 564 564 573 577 577 577 577 577 577 597 579 579 571 572 572 573 581 581 577 577 577 577 577 577 577 579 579 571 572 563 577 577 577 577
577 577 581 577 564 572 573 577 581 573 577 577 577 577 577 571 563 563 579 577 577 581 581 581 577 577 577 577 577 577 571 563 563 579 577 577 577 577 577 577
577 577 564 563 573 577 581 577 564 564 572 572 572 572 572 563 571 572 563 577 577 581 564 564 573 577 577 577 577 571 579 577 571 563 577 577 577 577 577 577
577 577 577 577 581 577 581 577 577 577 577 577 577 571 572 572 563 577 571 572 573 564 573 577 564 572 572 572 572 563 563 577 579 577 577 577 577 577 577 577
577 577 577 577 564 573 564 572 572 572 572 572 572 563 577 571 572 572 563 577 581 577 581 577 577 577 577 577 577 577 577 577 579 577 577 577 577 577 577 577
577 577 577 577 577 564 573 577 577 577 577 577 571 572 572 563 577 577 577 577 564 573 564 572 573 577 577 577 577 577 571 572 563 577 577 577 577 577 577 577
577 577 577 577 577 577 564 572 572 572 572 572 563 577 577 577 577 577 577 577 577 564 572 573 564 572 572 573 577 577 579 577 577 577 577 577 577 577 577 577
577 577 577 577 577 577 577 577 577 577 577 577 577 577 577 577 577 577 577 577 577 577 577 564 573 577 577 564 572 572 563 577 577 577 577 577 577 577 577 577