Route110_SeasideCyclingRoadEntrace_Layout (15x6)
648 648 648 648 648 648 653 648 651 648 648 648 648 648 648
656 656 656 656 656 668 661 656 659 656 668 656 656 656 656
632 624 624 624 624 680 665 664 665 665 681 632 624 624 624
640 616 616 616 616 688 673 672 673 673 689 640 616 616 616
604 616 616 616 616 624 601 602 601 602 624 633 616 616 620
612 534 535 616 616 616 609 610 609 610 616 616 534 535 628