Route127_Layout (80x80)
113 113 113 190 108 109 113 113 113 113 113 115 113 123 124 124 137 113 117 113 117 113 380 381 382 368 368 368 368 368 531 533 531 531 437 414 760 761 760 761 760 761 760 761 420 446 447 531 535 535 533 531 533 531 533 531 533 533 373 374 368 368 368 368 368 368 368 368 368 535 531 535 531 378 113 115 117 190 372 531
108 109 113 113 113 190 109 113 113 147 148 123 124 124 124 137 123 124 125 116 125 116 388 533 368 368 368 368 368 368 531 533 531 531 445 446 446 446 446 446 446 360 361 446 447 531 827 829 535 535 533 531 533 531 533 531 533 533 381 382 368 368 368 368 368 368 368 368 368 535 531 535 531 378 113 115 117 113 380 531
113 117 113 113 113 113 117 113 113 155 156 113 113 113 113 123 124 137 113 117 116 388 368 368 368 368 368 368 368 368 368 368 368 531 531 533 368 368 368 368 368 344 345 827 828 829 381 382 535 535 533 531 533 531 533 531 533 533 368 370 371 371 371 371 371 371 372 368 368 531 368 827 829 378 113 115 190 109 380 531
113 117 113 113 113 113 117 113 113 113 116 121 121 121 121 121 137 115 113 117 380 368 368 368 368 368 368 368 368 368 368 368 368 368 531 368 368 368 368 368 336 337 368 378 113 380 368 531 535 535 533 531 533 531 533 531 533 533 370 190 113 107 108 108 108 109 190 371 372 336 337 381 382 378 113 123 137 117 380 531
113 117 113 147 148 113 117 113 113 113 359 414 414 414 414 414 358 123 124 125 380 368 368 368 368 368 368 368 368 368 368 368 368 368 531 368 368 368 368 368 344 345 368 378 113 380 368 531 827 829 541 519 533 531 533 531 533 533 378 113 113 115 113 113 113 117 113 113 380 344 345 368 368 386 137 113 115 117 380 531
113 117 113 155 156 116 125 113 116 121 367 414 414 414 414 414 366 121 137 113 380 827 829 368 368 368 368 368 368 368 368 368 368 368 368 368 368 368 368 368 368 368 827 830 113 380 368 531 381 382 531 533 533 531 533 531 533 533 378 113 113 123 137 113 113 117 113 113 380 368 368 368 368 368 378 113 115 117 380 531
113 117 113 113 113 117 113 113 380 414 414 414 414 414 414 414 414 439 378 113 380 381 382 368 368 368 368 368 368 368 368 368 368 368 368 368 368 368 368 368 368 827 830 113 113 380 368 531 535 535 531 531 531 531 531 336 337 531 386 121 137 113 123 124 124 125 113 116 388 518 537 334 334 536 378 113 115 117 190 372
113 117 113 113 113 117 113 113 359 414 414 414 414 414 414 414 414 439 378 113 380 531 531 531 368 368 368 368 368 368 368 368 368 368 368 368 368 368 531 531 531 378 107 108 109 380 531 531 535 336 337 531 531 827 829 344 345 827 829 368 386 121 121 121 121 121 121 388 368 529 334 571 571 334 386 137 115 117 113 380
116 125 113 113 116 125 116 121 367 414 414 414 414 414 414 414 414 439 386 121 388 531 531 531 531 531 531 531 531 531 531 368 368 368 368 368 368 827 829 368 827 830 115 113 117 380 827 829 531 344 345 531 531 381 382 368 368 381 382 531 531 531 531 531 535 531 535 535 531 529 334 579 579 334 528 378 115 190 109 380
125 113 113 116 125 113 380 414 414 414 414 414 414 414 414 420 446 447 368 368 368 531 531 531 531 531 531 531 531 531 531 368 368 368 368 368 368 381 382 827 830 107 190 113 117 380 381 382 336 337 531 336 337 368 368 368 368 368 368 531 531 531 531 531 535 518 543 535 531 529 334 592 593 334 528 378 123 137 117 380
113 113 113 117 113 113 380 414 414 414 414 414 414 414 414 439 531 531 368 368 368 531 531 531 531 531 531 531 531 531 531 368 368 368 368 368 368 368 531 378 113 115 113 116 125 380 368 368 344 345 531 344 345 368 368 531 535 368 368 531 531 531 531 531 535 535 518 543 531 529 334 596 594 334 528 378 113 115 117 380
113 113 113 117 113 113 380 414 414 414 414 414 414 420 446 447 531 429 430 430 431 368 531 531 531 531 531 531 531 531 531 368 368 368 827 829 368 531 827 830 113 123 124 125 116 388 368 368 368 368 531 531 531 531 531 531 535 531 535 531 531 531 531 531 535 535 535 531 518 537 334 596 594 334 528 378 113 115 117 380
113 113 116 125 113 113 380 414 414 414 414 414 414 439 531 531 531 437 414 414 412 431 368 368 531 531 531 531 531 531 531 368 368 368 381 382 827 828 830 113 113 113 116 121 388 368 368 368 368 368 531 541 519 533 531 533 533 533 531 531 531 531 531 531 535 535 535 518 537 334 583 596 594 334 536 386 137 115 117 380
113 113 117 113 113 116 388 446 446 446 446 446 446 447 531 531 531 437 414 414 414 439 368 537 334 334 536 519 541 519 533 368 368 368 368 368 378 113 147 148 116 121 388 368 368 368 368 368 429 430 430 430 430 430 430 430 430 430 431 547 546 546 546 546 368 368 535 529 334 583 592 604 594 578 334 528 378 115 117 380
113 113 117 113 113 380 368 368 368 368 368 368 368 368 531 531 531 437 414 414 414 439 368 334 580 578 334 536 519 533 533 368 368 827 828 828 830 113 155 156 380 368 368 368 368 368 368 429 411 414 414 414 414 414 414 414 414 414 412 430 431 368 368 368 368 368 535 529 334 592 604 598 602 593 334 536 378 115 117 380
113 113 190 109 113 380 368 368 368 429 430 430 430 430 431 368 368 445 446 446 446 447 368 334 592 593 578 334 528 533 533 827 829 378 113 107 108 109 113 113 380 368 368 368 368 429 430 411 414 414 414 405 406 406 406 406 407 414 414 414 412 431 368 368 368 368 535 529 334 587 588 598 598 594 578 334 378 115 117 380
113 113 113 117 113 380 827 829 368 437 414 414 414 414 412 431 368 368 531 531 531 368 368 334 599 605 593 334 528 533 541 381 382 378 107 190 113 117 116 121 388 368 368 368 429 411 414 414 414 405 406 389 128 129 129 130 390 406 407 414 414 412 430 430 431 368 535 529 334 564 596 598 598 594 595 334 378 115 117 380
147 148 113 117 113 380 381 382 368 437 414 414 414 414 414 439 368 368 531 531 531 368 368 334 599 595 597 334 528 541 519 533 368 378 115 113 113 117 380 368 368 368 429 430 411 414 414 405 406 389 128 129 190 113 113 191 129 130 390 406 407 414 414 414 439 368 535 547 521 334 587 588 598 602 593 334 378 115 117 380
155 156 113 117 113 380 545 368 368 437 414 414 414 414 414 439 368 368 531 531 531 368 368 334 599 595 597 334 536 519 533 533 368 378 115 113 116 125 380 531 368 368 437 414 405 406 406 389 128 129 190 113 107 108 108 108 109 191 129 130 390 406 406 407 412 431 535 531 529 334 564 596 598 598 594 334 378 115 117 380
113 113 113 117 113 380 368 336 337 437 414 414 414 414 414 439 368 368 531 531 531 368 368 334 601 591 597 578 334 528 533 541 368 378 115 113 117 116 388 531 368 368 437 405 389 128 129 129 190 113 113 113 115 113 113 113 191 108 109 191 129 129 130 415 414 439 547 527 547 521 334 587 588 598 594 334 378 115 117 380
137 113 113 117 113 380 368 344 345 445 446 419 414 414 420 447 368 368 531 531 531 368 368 334 564 599 597 595 334 528 541 519 368 378 123 137 117 380 547 531 368 429 411 413 128 190 107 108 109 113 113 113 123 124 137 113 113 113 117 113 113 113 138 415 414 439 527 535 531 529 334 564 596 598 594 334 378 115 117 380
115 113 113 117 113 380 368 368 368 368 368 445 446 446 447 368 368 368 368 368 368 368 523 521 334 599 605 593 334 528 531 533 368 378 113 123 125 380 547 531 368 437 414 413 136 107 190 113 117 113 116 121 121 137 123 124 124 124 125 113 116 424 146 415 414 439 535 535 531 547 521 334 587 588 594 334 378 115 117 380
115 113 116 125 116 388 368 368 368 368 368 368 368 368 368 368 368 368 368 368 368 368 531 529 334 601 591 597 334 536 519 533 368 378 113 113 116 388 547 531 368 437 414 413 136 123 124 124 125 116 146 292 292 144 121 121 121 121 121 121 146 398 422 423 414 439 535 547 526 527 529 334 564 588 594 334 378 115 117 380
115 113 117 116 388 368 368 368 368 368 368 368 368 368 368 368 368 368 368 368 368 368 531 529 334 564 599 597 578 334 528 533 368 386 137 113 380 368 531 531 368 437 414 413 136 113 113 116 121 146 292 398 422 422 422 422 422 422 422 422 422 423 414 414 414 439 547 526 527 535 547 521 334 596 594 334 378 115 117 380
115 113 117 380 368 368 368 368 368 368 368 368 368 368 368 368 368 368 368 368 827 829 531 523 521 334 599 597 595 334 528 541 368 368 378 113 380 368 368 531 368 445 419 413 144 424 121 146 398 422 422 423 414 414 414 420 446 360 361 446 446 446 446 446 446 447 526 527 535 535 531 529 334 596 594 334 378 115 117 380
123 137 117 380 531 827 829 368 368 368 368 368 368 368 368 368 368 368 368 368 381 382 531 523 529 334 599 605 593 334 536 519 368 545 378 116 388 368 368 531 368 368 437 421 422 422 422 422 423 414 414 414 414 420 446 447 368 344 345 827 829 368 368 368 368 368 531 535 535 535 531 529 334 596 334 560 378 115 117 380
113 115 117 380 531 381 382 368 368 368 368 368 368 368 368 368 368 368 827 828 829 368 368 531 529 334 599 595 597 570 334 528 368 519 378 380 368 368 368 531 368 368 445 419 414 414 414 414 414 420 446 446 446 447 368 368 368 368 368 381 382 368 368 368 368 368 368 535 535 535 531 529 334 596 334 568 378 115 117 380
113 123 125 380 531 545 368 368 368 368 368 368 368 368 368 368 368 368 378 113 380 368 368 531 529 334 601 591 597 578 334 528 368 536 378 380 827 829 368 531 368 368 368 445 446 446 446 446 446 447 368 368 368 368 368 368 368 827 828 829 368 827 829 368 368 368 368 535 535 535 531 529 334 596 334 568 378 115 117 380
137 113 116 388 531 368 368 368 368 368 368 368 368 368 368 368 368 827 830 113 380 368 368 531 529 334 564 599 597 595 334 528 368 368 386 388 381 382 368 531 368 368 368 368 368 531 531 518 537 334 536 519 533 541 519 368 368 378 113 380 368 381 382 827 829 368 368 368 368 368 368 529 334 334 334 827 830 115 117 380
378 113 380 533 368 368 368 368 368 368 368 368 368 368 368 368 368 378 107 109 380 827 828 829 523 521 334 599 605 593 334 528 368 531 531 531 531 531 531 531 368 827 829 827 828 829 531 529 334 579 334 528 533 531 533 368 827 830 113 380 368 368 531 381 382 368 827 828 828 828 829 547 545 609 608 378 113 115 117 380
378 116 388 368 827 829 368 368 368 368 368 368 368 368 368 368 368 378 115 117 380 378 113 380 527 529 334 599 595 597 334 536 368 531 531 531 531 531 531 531 368 381 382 378 113 380 531 529 334 595 334 528 541 519 541 368 378 107 109 380 368 368 531 368 336 337 378 107 108 109 380 527 523 547 546 378 107 190 117 380
386 388 368 368 381 382 368 368 368 368 368 368 368 368 368 368 827 830 115 117 380 386 121 388 535 529 334 599 595 597 578 334 368 531 531 531 531 531 531 531 368 531 827 830 113 380 531 529 334 595 334 536 519 533 531 368 378 115 117 380 531 368 531 368 344 345 378 123 137 117 380 336 337 531 531 378 115 116 125 380
368 531 368 368 368 368 368 368 368 368 368 368 368 368 368 368 378 113 115 117 830 829 531 531 535 529 334 599 595 597 595 334 368 368 368 368 368 368 531 531 368 531 378 107 109 380 531 529 334 595 578 334 528 368 368 827 830 115 117 380 531 368 531 368 368 368 381 137 123 125 380 344 345 531 531 378 115 117 116 388
368 368 368 368 368 368 368 368 368 368 368 368 368 368 368 368 378 113 115 190 109 380 531 545 535 529 334 599 595 597 595 334 528 368 368 368 368 368 545 546 545 827 830 115 117 380 531 529 334 564 595 334 536 368 368 378 107 190 117 380 531 531 531 368 368 368 368 381 121 121 388 547 535 523 568 378 115 117 380 545
368 368 368 368 368 368 368 368 368 368 368 368 368 368 368 368 378 113 115 113 117 380 531 531 535 529 334 599 595 597 595 334 528 533 531 529 529 334 334 536 519 378 113 123 125 380 547 547 521 334 595 578 334 368 368 378 115 116 125 380 531 531 429 430 430 430 430 430 431 368 827 828 829 368 827 830 115 117 380 545
368 368 827 829 368 368 368 368 368 368 368 368 368 368 368 368 386 137 123 137 117 380 531 531 535 529 334 599 595 605 593 334 528 533 531 535 529 334 578 334 528 378 113 113 116 388 547 531 529 334 595 595 334 368 368 378 115 117 116 388 531 531 437 752 753 752 753 414 439 368 381 137 380 368 378 107 190 117 380 531
368 368 381 382 368 368 368 368 368 368 368 368 368 368 368 368 368 378 113 123 125 380 531 531 531 529 334 599 592 593 597 334 528 533 531 535 529 334 595 334 528 386 137 113 380 368 531 531 529 334 595 595 334 368 368 378 115 117 380 368 429 430 411 760 805 804 805 753 412 431 368 381 382 368 378 115 116 125 380 531
368 368 368 368 368 368 368 368 368 368 368 368 368 368 368 368 368 378 113 113 116 388 547 547 531 529 334 599 596 594 597 334 528 533 518 543 529 334 595 334 536 545 378 116 388 368 368 531 529 334 595 595 334 368 368 378 115 117 380 531 437 414 414 752 804 805 804 761 414 439 368 368 827 829 378 123 125 116 388 531
368 368 368 368 368 368 368 368 368 518 543 529 334 334 528 541 368 386 137 113 380 368 547 547 531 529 334 599 596 594 597 334 528 533 535 518 537 334 595 578 334 368 386 388 827 829 368 531 529 334 595 595 334 368 827 830 115 117 380 531 437 414 752 804 761 760 805 753 414 412 431 535 381 382 378 113 116 388 547 547
368 368 368 368 368 368 368 368 518 543 518 537 334 334 536 519 368 368 378 113 380 368 531 531 527 529 334 599 596 594 597 334 528 541 543 529 334 580 592 593 334 368 531 531 381 382 368 518 537 334 595 595 334 368 378 113 115 117 830 829 437 752 804 761 414 752 804 805 753 414 439 547 527 535 378 113 380 368 547 547
368 368 368 368 368 368 368 368 535 518 537 334 583 578 334 528 368 545 378 113 380 368 368 531 535 529 334 599 596 594 597 334 528 531 531 529 334 592 607 597 334 531 531 531 531 531 545 529 334 580 595 595 334 368 378 113 115 190 109 380 437 760 805 753 414 760 805 804 805 753 439 531 535 547 378 113 380 368 531 531
368 368 368 368 368 368 368 531 535 529 334 583 592 593 334 536 368 368 378 116 388 368 368 531 535 529 334 599 596 594 597 334 536 519 531 529 334 599 595 597 334 531 531 531 531 531 545 529 334 595 595 562 334 368 378 113 115 113 117 380 437 414 760 761 414 414 760 761 760 761 439 531 547 547 378 113 380 368 368 531
368 368 368 368 368 368 368 531 535 529 334 592 604 594 578 334 368 368 386 388 827 829 368 531 535 537 334 599 596 594 597 570 334 528 531 529 334 599 595 597 334 536 545 531 531 531 546 529 334 595 595 334 520 368 386 137 115 113 117 380 445 419 414 414 414 414 414 414 414 414 439 531 531 535 378 116 388 368 368 531
368 368 368 368 368 368 368 531 535 529 334 601 588 594 595 334 368 545 368 531 381 382 368 531 535 334 575 599 596 594 597 578 334 528 531 529 334 599 595 597 570 334 545 531 531 531 546 537 334 595 595 334 528 368 568 378 115 113 117 380 531 445 419 414 414 414 414 414 414 414 439 531 531 535 378 380 368 368 368 531
368 368 368 368 368 368 535 531 535 529 334 564 596 602 593 334 368 545 368 368 531 531 368 531 535 334 583 599 596 594 597 595 334 528 531 529 334 599 595 597 578 334 368 531 531 531 546 334 580 595 595 334 528 368 827 830 115 113 117 380 547 531 445 419 414 414 414 414 414 414 439 531 531 547 378 380 368 368 368 531
368 368 368 368 368 368 535 535 535 547 521 334 601 588 594 578 334 545 368 368 368 368 531 531 535 334 595 599 596 594 605 593 334 528 531 529 334 587 591 597 595 334 368 531 531 531 546 334 595 595 595 334 528 568 378 107 190 113 117 380 547 531 531 445 446 446 446 446 446 446 447 531 531 531 386 388 368 368 368 531
368 368 368 368 368 827 829 535 535 531 529 334 564 596 602 593 334 545 368 368 368 368 531 531 535 334 592 607 596 602 593 597 334 528 531 529 334 564 596 597 595 334 368 368 368 545 546 334 595 595 562 334 528 827 830 115 113 116 125 380 531 531 531 531 531 531 531 531 531 531 531 531 531 531 531 336 337 531 531 531
368 368 368 368 368 381 382 535 523 527 547 521 334 601 588 594 334 519 531 533 368 368 531 531 535 334 599 595 596 598 594 597 334 536 519 523 521 334 596 597 562 334 528 533 518 543 529 334 595 595 334 368 568 378 107 190 116 125 116 388 368 531 531 531 531 531 531 531 531 531 531 531 531 531 531 344 345 368 368 531
368 368 368 368 368 531 535 535 531 535 531 529 334 564 596 594 334 536 519 533 541 543 531 535 529 334 599 592 604 598 594 597 570 334 528 531 529 334 596 597 334 520 523 533 535 518 537 334 595 562 334 368 827 830 115 116 125 116 388 547 368 531 531 531 531 531 531 531 531 531 531 368 334 334 368 531 531 827 829 531
368 368 368 368 368 827 829 535 531 535 531 547 521 334 596 594 578 334 528 541 519 531 518 543 529 334 599 596 598 598 594 597 578 334 528 531 529 334 596 597 334 528 531 541 543 529 334 580 595 334 520 368 378 107 190 117 116 388 547 547 531 531 531 531 531 531 531 531 531 531 531 334 335 335 334 531 531 381 382 531
533 368 368 368 827 830 380 535 531 535 531 531 529 334 596 602 593 334 528 531 533 531 535 531 529 334 599 596 598 598 594 597 595 334 528 531 529 334 596 597 334 528 531 531 518 537 334 595 595 334 528 368 378 115 116 125 380 547 531 531 531 531 531 531 531 531 531 336 337 531 531 334 335 335 334 336 337 531 531 531
533 827 829 368 378 113 380 368 368 368 368 368 546 334 601 588 594 334 536 519 533 531 535 518 537 334 599 596 598 598 594 605 593 334 528 518 537 334 596 597 334 528 531 531 529 334 580 595 562 334 368 368 378 115 117 113 380 336 337 531 531 531 535 531 535 531 535 344 345 531 531 368 334 334 368 344 345 531 531 531
533 381 382 827 830 113 380 368 827 829 368 368 546 334 564 596 594 578 334 528 533 531 535 529 334 575 596 601 588 598 602 593 597 334 536 537 334 575 596 597 334 528 531 518 537 334 595 595 334 368 368 368 378 123 125 116 388 344 345 531 531 518 531 531 531 368 827 829 368 336 337 533 531 531 531 531 827 829 531 531
533 368 368 378 107 109 380 368 381 382 368 368 546 521 334 596 594 595 334 528 533 531 535 529 334 575 601 591 596 598 598 594 597 570 334 334 576 580 596 597 334 528 531 529 334 580 595 595 334 368 368 368 378 113 116 388 547 368 827 829 531 535 531 531 336 337 381 382 368 344 345 336 337 531 531 531 381 382 531 531
533 368 368 378 115 117 380 531 368 531 368 368 546 529 334 596 602 593 334 528 533 531 535 529 334 575 595 599 601 588 598 594 597 578 577 574 572 596 607 597 334 528 531 529 334 595 595 562 334 368 368 368 378 113 380 368 368 368 381 382 827 829 336 337 344 345 368 368 334 334 368 344 345 827 829 827 828 829 368 531
533 368 827 830 115 117 380 531 368 531 368 368 546 529 334 596 598 594 334 528 533 531 535 529 334 575 595 601 591 596 598 594 605 593 578 579 580 596 589 587 334 528 531 529 334 595 595 334 520 368 368 368 378 116 388 368 368 368 368 531 381 382 344 345 368 368 368 334 335 335 334 519 519 381 382 378 113 380 368 531
533 368 378 113 115 117 830 829 531 531 368 368 546 529 334 596 598 594 334 528 533 531 535 529 334 585 564 595 599 596 598 602 593 597 595 595 596 607 594 562 334 528 531 529 334 595 562 334 528 368 368 368 378 380 368 368 368 531 531 531 368 368 368 368 368 368 368 334 335 335 334 519 368 368 827 830 113 380 368 531
827 829 378 113 115 190 109 380 531 827 828 829 545 529 334 601 588 594 334 528 533 531 535 529 334 574 575 595 599 596 598 598 594 597 595 595 596 595 597 334 520 546 531 529 334 595 334 368 368 368 368 368 378 380 368 368 368 368 368 368 368 368 368 368 368 368 368 368 334 334 368 519 368 368 378 107 109 380 368 531
381 382 378 113 115 113 117 380 531 378 113 380 545 529 334 564 596 594 334 528 533 531 535 529 334 574 575 595 599 596 598 598 594 605 606 606 607 595 597 334 528 531 531 529 334 595 334 368 368 368 368 368 386 388 368 368 368 368 368 368 368 368 368 429 430 430 430 430 430 431 368 368 519 368 378 115 117 380 531 531
337 368 378 113 115 113 117 380 531 386 121 388 368 547 521 334 596 594 334 528 533 531 535 547 521 334 585 564 599 601 588 598 602 593 595 595 595 589 587 334 528 531 531 529 334 334 560 368 368 368 368 368 368 368 368 429 430 430 430 430 431 368 429 411 405 406 406 406 407 439 368 368 533 827 830 115 117 380 531 531
345 368 386 137 115 113 117 380 531 531 368 368 368 531 529 334 596 334 560 546 533 531 523 527 529 334 574 575 601 591 596 598 598 602 593 595 589 587 595 334 528 531 531 547 545 545 827 829 336 337 368 368 368 368 429 411 405 406 406 407 412 430 411 414 413 292 292 292 415 412 431 368 531 378 113 115 117 830 829 531
533 368 368 378 115 113 117 830 829 531 368 368 368 531 547 561 334 334 568 525 546 525 527 535 529 334 574 585 564 599 601 588 598 598 594 595 597 595 562 334 528 525 526 526 526 526 381 382 344 345 368 368 429 430 411 405 389 292 292 390 406 407 414 405 389 163 129 130 390 407 412 431 531 378 113 115 190 109 380 531
533 368 368 378 123 137 117 113 380 531 368 368 368 531 531 569 334 334 568 533 525 546 535 535 529 334 574 574 575 601 591 596 598 598 594 589 587 562 334 368 368 368 368 368 336 337 368 368 368 368 368 429 411 414 405 389 128 129 129 130 292 390 406 389 292 171 137 191 130 415 414 439 531 378 113 115 113 117 380 531
533 368 368 378 113 115 190 109 380 531 368 368 531 531 531 531 334 334 568 533 533 531 535 535 547 521 334 574 575 595 599 596 598 598 594 597 595 570 334 368 368 368 368 368 344 345 368 368 526 368 429 411 414 405 389 292 136 113 113 191 130 292 292 292 292 292 171 424 172 415 414 439 531 378 113 115 113 117 380 531
368 368 368 378 113 115 113 117 830 829 368 368 827 829 531 531 334 334 568 533 532 532 532 532 368 529 334 574 585 564 599 596 598 598 594 597 595 334 520 368 368 368 368 368 827 828 829 368 368 368 437 414 414 413 292 292 136 107 108 109 191 130 292 398 422 422 422 422 422 423 414 439 531 378 107 190 113 117 380 531
368 368 368 386 137 123 137 190 109 380 531 368 381 382 531 531 334 334 568 533 532 827 829 532 368 529 334 574 574 575 599 601 588 598 594 597 595 334 528 368 368 368 368 368 378 113 380 368 368 429 411 414 414 413 292 292 136 123 137 117 113 138 292 415 414 414 414 414 414 414 420 447 827 830 115 113 116 125 380 531
368 368 368 368 386 137 115 113 117 830 829 531 368 368 368 368 334 334 568 533 532 381 382 532 368 547 521 334 574 575 601 591 596 598 594 597 562 334 528 368 368 368 368 827 830 113 380 368 368 437 414 414 414 421 422 397 144 137 123 125 113 138 292 415 414 414 414 420 446 446 447 368 378 113 115 113 117 116 388 531
368 368 368 368 368 378 115 113 117 113 380 368 368 827 828 829 368 553 523 533 368 368 368 368 368 527 547 521 334 585 564 599 596 598 594 597 570 334 368 368 368 827 829 378 107 109 380 368 368 445 419 414 420 446 419 421 397 144 121 424 121 146 398 423 414 414 420 447 368 368 368 531 378 113 115 113 117 380 531 531
368 368 368 368 368 378 115 113 190 109 380 368 368 378 113 380 368 368 368 368 368 827 828 829 368 535 531 529 334 574 575 599 596 586 587 597 334 520 368 368 368 381 382 378 115 117 380 531 368 368 445 446 447 368 445 419 413 292 292 292 292 398 423 414 414 420 447 368 368 368 368 827 830 107 190 113 117 380 531 531
368 368 368 368 368 378 123 137 113 117 830 829 827 830 113 380 368 531 368 368 368 378 113 380 368 368 527 547 521 334 575 599 596 594 595 597 334 528 368 368 368 368 827 830 115 117 380 531 368 368 368 368 368 368 368 437 413 292 292 292 292 415 414 414 414 439 368 368 368 368 368 378 113 115 113 116 125 380 531 531
368 368 368 531 368 386 137 115 113 117 113 380 378 107 109 380 368 368 368 368 827 830 113 380 368 368 535 531 529 334 575 599 596 594 595 597 334 528 368 368 368 368 378 113 115 117 830 829 531 368 368 368 368 368 368 437 413 163 129 129 130 415 414 420 446 447 368 368 827 829 827 830 107 190 113 117 116 388 531 531
368 368 368 368 368 368 378 115 113 117 113 380 378 115 117 380 368 368 368 533 378 107 109 380 368 368 547 527 529 334 575 599 596 594 595 597 334 528 368 368 368 368 378 113 115 191 109 380 531 531 531 531 531 531 368 437 413 171 137 113 138 415 414 439 368 368 368 368 381 382 378 113 115 113 116 125 380 531 531 531
368 368 368 368 368 368 378 123 137 117 113 380 378 115 117 380 368 368 368 533 378 123 125 380 531 368 531 532 529 334 575 599 596 594 595 597 334 528 368 368 368 368 378 113 115 113 117 380 531 531 531 531 531 531 368 437 421 397 171 424 172 415 414 439 368 368 531 531 531 531 378 113 115 116 125 116 388 531 531 531
368 368 368 368 368 531 378 113 115 190 109 190 190 115 117 380 368 368 368 533 386 137 113 380 368 368 527 532 529 334 575 599 596 594 595 597 334 528 368 368 368 368 378 113 115 113 117 380 531 531 531 531 531 531 368 445 419 421 422 422 422 423 414 439 368 368 531 531 531 531 378 107 190 117 116 388 547 531 531 531
368 368 368 368 368 531 386 137 123 137 190 109 113 115 117 830 829 531 368 533 368 378 113 380 368 368 535 532 529 334 575 599 596 594 595 597 334 528 368 368 368 368 378 113 115 113 117 380 531 531 531 531 531 531 368 368 445 446 419 414 414 414 414 439 368 368 531 531 531 531 378 115 116 125 380 531 547 531 531 531
368 368 368 368 368 531 368 378 113 115 113 190 109 115 190 109 380 531 368 368 545 378 113 380 368 368 535 532 529 334 575 599 596 594 595 597 334 528 368 368 368 368 378 113 115 113 117 380 531 827 829 531 531 531 368 368 368 368 445 446 446 446 446 447 368 368 531 827 829 368 378 115 117 116 388 368 531 531 531 531
531 368 368 368 368 531 535 386 137 115 113 113 190 190 113 117 380 531 368 368 368 378 116 388 368 368 535 532 529 334 575 599 596 602 594 597 334 528 368 368 368 368 386 137 115 113 117 380 531 381 382 531 531 531 531 531 531 531 531 531 531 531 531 531 531 531 518 381 382 368 378 123 125 380 547 368 368 531 531 531
531 368 368 368 368 531 535 368 378 115 113 113 113 113 113 117 380 368 535 547 368 386 388 368 368 368 535 532 529 334 575 599 596 598 594 597 334 528 368 368 368 368 368 378 123 137 117 830 829 531 368 368 368 368 368 368 368 368 368 368 368 531 531 531 531 531 518 531 368 827 830 113 116 388 368 368 368 531 531 531
531 368 368 368 368 531 535 531 378 123 124 137 113 113 113 117 830 829 526 368 368 368 368 368 368 368 535 532 529 334 575 599 596 598 594 597 334 528 368 368 368 827 829 378 113 115 191 109 830 828 829 368 531 531 368 368 368 827 829 368 368 531 531 531 368 827 828 828 828 830 113 113 380 368 368 368 368 531 531 531
531 531 531 535 531 531 535 531 386 121 137 115 113 113 113 117 113 380 368 368 532 532 827 829 532 368 535 532 529 334 575 599 596 598 594 597 334 528 368 368 368 381 382 386 137 115 113 117 113 113 830 828 828 828 829 368 368 381 382 368 368 531 827 828 828 830 113 107 108 108 109 113 380 368 368 368 368 531 531 531