Route106_Layout (80x20)
368 368 368 368 368 368 368 368 336 337 368 368 368 368 368 368 368 368 368 368 368 368 368 368 368 368 368 368 368 373 374 368 368 368 368 368 368 368 368 368 368 368 368 368 368 368 368 368 368 368 368 368 368 368 368 368 368 368 368 368 368 368 368 368 368 368 368 368 368 368 368 368 368 368 368 368 368 368 368 368
368 368 368 368 368 368 368 368 344 345 368 368 368 368 368 368 368 368 368 368 368 368 368 368 368 368 368 368 368 381 382 368 368 368 336 337 368 368 368 368 368 368 368 368 368 368 368 368 368 368 368 368 368 368 368 368 368 368 368 368 368 368 368 368 368 368 368 368 368 368 368 368 368 368 368 368 368 368 368 368
368 368 368 368 368 336 337 368 368 370 379 372 368 368 368 368 368 368 368 368 368 368 368 368 368 368 368 373 374 368 370 379 372 368 344 345 368 368 368 368 368 368 368 368 368 368 368 368 368 368 368 368 368 368 368 368 368 368 368 368 368 368 368 368 368 336 337 368 368 368 368 368 368 368 368 368 368 368 368 368
368 368 368 368 368 344 345 368 368 378 113 380 368 368 368 368 368 368 368 368 368 368 368 368 368 368 368 381 382 368 378 113 380 368 368 368 368 370 379 379 372 368 373 374 368 368 373 374 368 368 373 374 368 368 336 337 336 337 368 368 368 368 368 368 368 344 345 368 336 337 368 368 368 368 368 368 368 368 368 368
368 368 368 368 368 368 368 368 368 386 121 388 368 368 368 368 368 368 368 368 368 368 368 368 368 368 368 368 368 368 386 121 388 368 368 373 374 378 113 116 388 368 381 382 336 337 381 382 336 337 381 382 336 337 344 345 344 345 373 374 368 368 373 374 368 368 373 374 344 345 368 336 337 368 368 368 368 368 368 368
368 368 368 368 368 368 368 368 336 337 368 368 368 368 368 368 368 368 368 368 368 368 368 368 368 368 368 368 368 368 368 368 368 373 374 381 382 386 121 388 368 336 337 368 344 345 368 368 344 345 368 368 344 345 368 368 368 368 381 382 336 337 381 382 336 337 381 382 368 373 374 344 345 368 368 368 368 368 368 368
368 368 368 368 368 368 368 368 344 345 336 337 368 368 368 368 368 368 368 368 368 368 368 368 368 368 368 368 368 368 368 368 368 381 382 368 368 368 368 368 368 344 345 368 368 368 368 368 368 368 368 368 368 368 368 368 368 368 368 368 344 345 368 368 344 345 368 368 368 381 382 368 373 374 368 368 368 368 368 368
368 368 368 368 368 368 368 368 368 368 344 345 368 368 368 368 368 368 368 368 368 368 368 368 368 368 368 368 368 368 368 368 368 368 368 368 368 368 368 368 368 368 368 368 368 368 368 368 368 368 368 368 368 368 368 368 368 368 368 368 368 368 368 368 368 368 368 368 368 368 368 368 381 382 368 368 368 368 368 368
368 368 368 368 368 368 368 368 368 368 368 368 373 374 336 337 368 368 368 368 368 368 368 368 368 368 368 368 368 368 368 368 368 368 368 368 368 368 368 368 368 368 368 368 368 368 368 368 368 368 368 368 368 368 368 368 368 368 368 368 368 368 368 368 368 368 368 368 368 368 368 368 368 336 337 368 368 368 368 368
368 368 368 368 368 368 368 368 368 368 368 368 381 382 344 345 373 374 368 368 368 368 368 368 368 368 368 368 368 368 368 368 368 368 368 368 368 368 368 368 368 368 368 368 368 368 368 368 368 368 368 368 368 368 368 368 368 368 368 368 368 368 368 368 368 368 368 368 368 368 368 368 368 344 345 368 368 368 368 368
368 368 368 368 368 368 368 368 368 368 368 368 368 368 368 368 381 382 368 368 368 368 368 368 368 368 368 368 368 368 368 368 368 368 368 368 368 368 368 368 368 368 368 368 368 368 368 368 368 368 368 368 368 368 368 368 368 368 368 368 368 368 368 368 368 368 368 368 368 368 368 368 368 373 374 368 368 368 368 368
368 368 368 368 368 368 368 368 368 368 368 368 368 368 368 368 336 337 368 368 368 368 368 368 368 368 368 368 368 368 368 368 368 368 368 368 368 368 368 368 283 284 284 284 284 284 284 284 284 284 284 284 284 284 284 284 285 368 368 368 368 368 368 368 368 368 368 368 368 368 368 368 368 381 382 368 368 368 368 368
368 368 368 368 368 368 368 368 368 368 368 368 368 368 368 368 344 345 373 374 368 368 336 337 368 368 368 368 368 368 368 283 284 284 284 284 284 284 284 284 544 129 129 129 129 129 129 129 129 129 130 292 292 226 292 292 318 284 284 284 285 368 368 368 368 368 368 368 368 368 368 368 368 336 337 368 368 368 537 537
368 368 368 368 368 368 368 368 368 368 368 368 368 368 368 368 368 368 381 382 336 337 344 345 368 336 337 368 283 284 284 317 128 129 129 129 129 129 129 129 190 108 108 108 108 108 108 108 108 109 138 226 292 292 292 292 292 292 292 562 318 284 284 284 284 284 285 368 368 368 368 368 368 344 345 368 368 370 579 579
368 368 368 368 368 368 368 368 368 368 368 368 368 368 368 368 368 368 368 368 344 345 368 373 374 344 345 336 341 292 128 129 190 113 113 113 113 113 113 113 113 113 113 113 113 113 113 113 113 117 138 292 292 292 292 292 292 292 292 292 292 292 292 292 292 292 293 368 368 368 368 368 368 336 337 368 368 378 570 579
368 368 368 368 368 368 368 368 368 368 368 368 368 368 368 368 368 368 368 368 368 368 368 381 382 368 368 344 349 128 115 113 113 113 113 113 113 113 113 113 113 113 113 113 113 113 116 124 100 125 138 226 292 292 292 292 292 292 292 292 292 292 292 292 292 292 318 284 284 285 368 368 368 344 345 368 537 378 569 579
368 368 368 368 368 368 368 368 368 368 368 368 368 368 368 368 368 368 368 368 368 368 368 368 368 368 283 284 317 136 115 113 113 113 113 113 113 113 113 113 116 124 124 124 124 124 125 116 167 145 146 292 292 292 292 292 569 569 292 292 292 292 292 292 292 292 292 292 292 293 368 368 368 373 374 370 579 654 579 570
368 368 368 368 368 368 368 368 368 368 368 368 368 368 368 368 368 368 368 368 368 368 368 368 368 368 291 292 128 190 190 113 113 113 113 113 113 113 116 124 125 113 116 578 578 578 578 146 292 292 292 292 292 292 292 569 579 570 569 569 292 292 292 292 292 292 292 292 292 293 368 368 368 381 382 378 570 569 570 569
368 368 368 368 368 368 368 368 368 368 368 368 368 368 368 368 368 368 368 368 368 368 368 368 368 368 291 128 115 113 113 113 113 113 113 113 113 116 125 116 578 583 578 579 579 579 579 292 292 292 292 292 292 569 569 579 570 569 579 570 569 569 292 292 292 292 292 292 292 318 284 285 368 370 647 655 569 579 569 579
368 368 368 368 368 368 368 368 368 368 368 368 368 368 368 368 368 368 368 368 368 368 368 368 368 368 291 136 115 113 113 113 113 113 113 113 113 117 113 117 579 579 579 579 579 579 579 569 569 569 569 569 569 579 579 579 569 579 579 569 579 579 569 292 292 292 292 292 292 292 292 293 368 378 579 579 579 570 579 570