Route110_TrickHousePuzzle8_Layout (15x22)
513 513 513 513 513 513 513 513 513 513 513 513 514 623 516
521 521 521 521 521 521 521 521 521 521 521 521 522 631 524
533 533 533 533 533 533 533 533 533 533 533 533 528 528 533
619 619 619 619 619 619 619 619 619 619 619 620 619 619 620
619 619 619 619 619 619 619 619 619 619 619 619 619 619 619
620 619 619 619 619 619 619 619 619 619 619 619 619 619 619
619 619 619 619 619 619 619 619 619 619 620 619 619 619 619
619 619 619 620 619 619 619 619 619 619 619 620 619 619 619
619 619 619 619 619 619 619 620 619 619 619 619 619 620 619
619 619 619 619 620 619 619 619 619 620 620 619 619 619 619
619 620 620 620 620 620 619 620 620 620 620 620 620 620 620
520 520 520 520 532 532 520 531 532 520 520 532 520 520 520
532 532 532 520 532 532 532 532 532 532 520 532 532 532 520
619 619 619 619 619 620 619 619 619 619 619 619 619 619 619
619 620 619 619 619 619 619 619 619 619 619 619 620 619 619
619 619 619 619 619 619 619 619 619 619 619 619 619 620 619
620 619 619 619 619 619 619 619 619 619 619 619 619 619 619
619 619 619 619 619 619 619 619 619 619 619 619 619 619 619
619 619 619 619 619 619 619 619 619 620 619 619 619 619 620
619 619 619 619 620 619 619 619 619 619 619 619 620 619 619
520 520 532 532 532 532 532 532 532 532 532 532 520 520 520
529 530 520 520 532 532 532 532 532 532 532 520 520 520 520