RustboroCity_CuttersHouse_Layout (11x9)
889 890 870 871 824 824 825 824 888 824 824
897 898 878 879 832 832 833 832 896 854 855
905 906 886 887 811 811 811 811 904 862 863
811 891 892 892 893 812 812 812 812 812 812
811 899 574 574 901 812 812 812 874 875 837
811 899 574 574 901 812 812 836 882 883 837
811 907 908 908 909 812 812 812 812 812 812
838 839 812 812 812 812 812 812 812 812 812
846 847 812 812 812 844 845 812 812 812 812