RustboroCity_Flat1_2F_Layout (14x8)
824 808 809 810 826 824 824 824 826 824 824 824 824 826
832 816 537 818 834 832 832 832 834 852 823 853 841 834
811 811 811 811 811 811 811 811 811 860 831 861 849 811
811 812 812 812 812 812 812 812 891 892 892 892 893 812
811 836 894 895 910 837 812 812 899 574 574 574 901 812
811 812 902 903 911 837 812 812 899 574 574 574 901 812
811 839 839 812 812 812 812 812 907 908 908 908 909 812
811 847 847 812 812 812 812 812 812 812 812 812 812 812