RustboroCity_Flat2_1F_Layout (14x9)
824 824 808 809 810 727 824 824 825 824 825 888 824 824
832 832 816 523 818 768 832 832 833 832 833 896 854 855
811 811 811 811 811 768 811 811 811 811 811 904 862 863
811 812 812 812 812 768 811 812 836 874 875 837 812 812
811 812 812 812 812 768 811 812 836 882 883 837 812 812
811 812 812 812 812 768 811 812 669 798 798 798 798 798
811 812 812 812 812 735 811 812 670 824 824 824 824 824
811 812 812 812 812 743 811 812 671 832 832 832 832 832
811 812 844 845 812 811 811 812 811 811 811 811 811 811