RustboroCity_Flat2_2F_Layout (14x9)
808 809 858 809 810 727 870 871 825 824 825 824 824 824
816 523 866 537 818 768 878 879 833 832 833 832 835 835
811 811 811 811 811 768 886 887 811 811 811 811 846 846
811 812 812 812 812 768 811 812 812 812 812 812 872 873
811 812 812 812 812 768 811 812 812 812 812 836 880 881
811 812 812 812 812 768 811 812 669 798 798 798 798 798
811 812 812 812 812 735 811 812 670 824 824 824 824 824
811 812 812 812 812 743 811 812 671 832 832 832 832 832
811 812 812 812 812 811 811 812 811 811 811 811 811 811