RusturfTunnel_Layout (36x24)
518 517 539 537 537 537 537 537 537 540 529 517 529 563 545 564 529 517 563 545 545 545 564 518 529 529 539 537 537 537 537 537 537 540 529 529
529 529 530 513 514 514 514 513 513 528 529 529 529 576 572 577 517 529 576 572 572 572 577 529 529 529 530 539 537 537 537 540 517 528 529 529
539 537 538 514 514 513 513 513 513 536 537 537 537 537 537 537 537 537 537 537 537 537 537 537 537 537 538 530 518 517 514 528 517 528 529 529
530 529 539 537 537 537 537 537 543 537 537 537 537 537 537 537 537 537 537 537 537 537 537 537 537 537 537 538 514 514 514 528 529 536 537 540
530 529 530 515 513 513 513 513 513 513 513 513 513 513 513 513 513 513 513 513 513 513 513 513 513 513 513 513 513 514 518 528 529 529 529 528
530 539 538 516 513 513 513 513 513 513 513 513 513 513 513 513 513 513 513 513 513 513 513 513 513 513 513 513 513 513 513 536 540 529 529 528
530 530 539 537 543 537 537 537 540 520 521 521 521 521 521 521 521 521 521 521 521 521 521 521 521 521 521 522 513 513 513 513 536 537 540 528
530 530 530 513 513 513 513 513 528 528 529 529 529 529 517 563 545 545 564 529 529 518 529 529 517 529 529 530 513 513 513 513 513 516 528 528
530 530 530 513 513 513 513 513 528 528 529 563 564 529 529 576 572 572 577 518 529 563 564 529 529 529 517 530 514 513 513 513 513 514 528 528
530 530 530 513 513 513 513 513 528 528 529 576 577 518 529 529 517 529 529 529 529 576 577 529 529 518 529 530 514 513 513 514 514 514 528 528
530 530 530 514 519 514 513 515 528 528 517 529 529 529 529 529 529 529 529 529 529 529 517 529 529 529 529 530 539 543 537 537 537 540 528 528
530 530 521 592 593 594 521 521 521 528 529 529 529 529 529 518 563 545 564 529 539 537 537 537 537 537 537 538 530 513 513 516 516 528 528 528
530 521 521 521 521 521 521 521 521 521 529 529 529 529 529 529 576 572 577 529 530 539 537 537 537 537 537 537 538 513 513 513 515 528 528 528
530 529 529 529 529 563 545 545 564 544 521 521 521 521 521 546 539 537 537 537 538 530 515 514 514 514 515 514 513 513 513 513 513 528 528 528
530 518 529 563 564 576 572 572 577 528 529 529 563 564 529 530 530 539 537 537 537 538 514 513 513 513 513 513 513 513 513 513 520 521 528 528
521 521 546 576 577 529 529 544 521 521 517 518 576 577 539 538 530 530 513 513 515 513 513 513 513 513 513 513 513 513 513 513 528 529 528 528
517 529 521 546 529 529 544 521 529 529 529 529 529 529 530 539 538 530 513 513 513 513 515 513 513 513 513 513 514 519 514 513 528 544 521 528
529 518 529 521 521 521 521 529 529 529 529 529 529 529 530 530 539 538 513 513 513 513 520 521 521 521 521 521 592 593 594 521 521 528 529 528
529 529 529 529 529 529 529 529 529 563 564 529 529 529 530 530 530 513 513 513 513 520 521 544 521 521 521 521 521 521 521 521 521 521 529 528
529 529 529 529 529 529 529 529 529 576 577 529 529 529 530 530 530 513 513 513 513 528 529 528 544 521 521 521 521 521 521 521 521 521 521 521
529 529 529 529 529 529 529 529 529 529 529 529 529 529 530 530 530 514 519 514 515 528 544 521 528 529 529 529 529 529 529 529 529 529 529 529
529 529 529 529 529 529 529 529 529 529 529 529 529 529 530 530 521 592 593 594 521 521 528 529 528 529 529 529 529 529 529 529 529 529 529 529
529 529 529 529 529 563 545 564 529 529 529 529 529 529 530 521 521 521 521 521 521 521 521 529 528 529 529 563 545 564 529 529 529 529 529 529
529 529 529 529 529 576 572 577 529 529 529 529 529 529 521 521 521 521 521 521 521 521 521 521 521 529 529 576 572 577 529 529 529 529 529 529