RustboroCity_House1_Layout (13x8)
824 824 824 817 824 824 826 826 824 824 824 824 824
835 842 843 542 832 832 834 834 832 852 853 841 835
846 850 851 822 811 811 811 811 811 860 861 849 846
811 812 812 812 812 812 812 812 891 892 892 893 812
811 812 836 894 895 910 837 812 899 574 574 901 812
811 812 836 902 903 911 812 812 907 908 908 909 812
838 812 812 812 812 812 812 812 812 812 812 812 839
846 812 812 812 812 844 845 812 812 812 812 812 847