RustboroCity_House_Layout (12x9)
889 890 824 825 824 824 824 824 817 825 870 871
897 898 841 833 832 832 842 843 542 833 878 879
905 906 849 811 811 811 850 851 822 811 886 887
811 812 812 891 892 892 892 892 893 812 812 812
811 812 812 899 737 584 606 738 901 812 812 812
811 812 812 899 737 592 593 738 901 812 812 812
811 812 812 907 908 908 908 908 909 812 812 812
838 812 812 812 812 812 812 812 812 812 812 839
846 812 812 812 812 844 845 812 812 812 812 847