RustboroCity_Gym_Layout (11x19)
526 515 516 516 515 515 515 516 516 515 527
514 523 524 524 523 523 523 524 524 523 517
522 549 530 532 531 531 531 532 533 528 525
521 567 538 548 539 540 540 548 541 520 534
521 520 520 520 520 520 520 520 520 520 535
546 550 550 545 520 520 520 544 545 520 557
553 552 543 558 520 520 520 553 554 559 561
553 554 549 528 520 520 520 553 554 559 561
553 560 566 545 520 520 520 553 554 559 561
565 543 543 558 520 520 520 542 558 559 561
561 549 546 547 520 520 520 546 551 566 564
561 559 553 554 559 520 520 542 543 555 554
561 559 553 554 559 520 520 528 528 553 554
561 559 553 554 559 520 520 544 550 563 554
556 559 542 558 559 520 520 542 543 543 558
521 567 528 528 567 520 520 528 528 528 534
521 520 529 520 520 520 520 520 529 520 535
521 520 537 520 520 520 520 520 537 520 535
521 520 528 520 520 536 536 520 528 520 535