RustboroCity_DevonCorp_1F_Layout (19x9)
513 513 922 904 905 904 904 905 904 923 513 513 922 906 907 908 923 513 513
513 513 920 912 913 912 912 913 912 921 513 513 920 914 915 916 921 513 513
513 513 920 897 897 897 897 897 897 921 513 513 920 897 897 897 921 513 513
904 905 928 902 909 909 909 903 896 929 904 904 928 897 896 896 929 905 904
912 913 912 910 924 924 924 911 900 912 912 912 912 897 896 896 912 913 912
897 897 897 897 899 899 899 899 901 897 897 897 897 897 896 896 897 897 897
897 896 896 896 896 896 896 896 896 896 896 896 896 896 896 896 896 896 896
897 896 896 896 896 896 896 896 896 896 896 896 896 896 896 896 896 896 896
897 896 896 896 896 518 519 896 896 896 896 896 896 896 896 896 896 896 896