RustboroCity_DevonCorp_2F_Layout (19x9)
922 906 907 908 904 905 904 905 904 905 904 905 904 906 907 908 905 904 923
928 914 915 916 912 913 912 913 912 913 912 913 912 917 918 919 913 912 929
912 897 897 897 897 897 897 897 897 897 897 897 897 897 897 897 897 897 912
897 897 896 896 896 896 931 932 896 896 931 932 896 896 931 932 896 896 897
897 925 933 934 896 896 939 940 896 896 939 940 896 896 939 940 896 896 896
897 935 941 942 896 896 935 925 896 896 935 896 896 896 935 896 896 896 896
897 896 935 935 896 896 931 932 896 896 931 932 896 896 931 932 896 896 896
897 896 896 896 896 896 939 940 896 896 939 940 896 896 939 940 896 896 896
897 896 896 896 896 896 935 896 896 896 935 896 896 896 935 896 896 896 896