RustboroCity_PokemonSchool_Layout (12x11)
520 521 521 520 521 521 521 521 520 521 521 520
528 529 530 523 552 553 554 555 528 529 530 528
536 537 538 536 560 561 562 563 536 537 538 536
544 545 545 545 568 540 541 569 545 545 545 545
514 513 513 513 513 548 549 513 513 513 513 513
514 524 513 525 513 513 513 513 524 513 524 513
514 532 513 533 513 513 513 513 532 513 532 513
514 524 513 524 513 513 513 513 526 513 524 513
514 532 513 532 513 513 513 513 534 513 532 513
514 524 513 524 513 513 513 513 524 513 524 513
514 532 513 532 513 6 7 513 532 513 532 513