RustboroCity_Flat2_3F_Layout (14x9)
808 809 810 824 727 889 890 824 825 824 825 824 824 824
816 537 818 832 768 897 898 841 833 832 833 852 823 853
811 811 811 811 768 905 906 849 811 811 811 860 831 861
811 812 812 812 768 811 812 891 892 892 892 893 812 812
811 812 812 812 768 811 812 907 908 908 908 909 812 812
811 812 812 812 768 811 812 812 669 798 798 798 798 798
811 812 812 812 735 811 812 812 670 824 824 824 824 824
811 812 812 812 743 811 812 812 671 832 832 832 832 832
811 812 812 812 811 811 812 812 811 811 811 811 811 811