RustboroCity_DevonCorp_3F_Layout (19x9)
904 906 907 908 904 905 904 905 904 905 904 905 904 905 904 905 904 905 904
912 917 918 919 912 913 912 913 841 842 843 913 912 913 912 913 912 913 912
897 897 897 897 897 897 897 897 849 850 851 897 897 897 897 897 897 897 897
897 896 896 896 896 896 896 952 953 953 953 954 896 896 896 952 954 896 896
897 733 896 896 896 840 896 960 961 961 961 962 896 896 896 960 962 767 896
897 741 896 896 896 848 896 955 956 956 956 957 896 896 896 955 957 775 896
897 733 896 896 896 936 896 963 964 964 964 965 896 896 896 963 965 937 896
897 741 896 896 896 896 896 958 966 966 966 959 896 896 896 958 959 896 896
897 896 896 896 896 896 896 896 896 896 896 896 896 896 896 896 896 896 896