RustboroCity_Flat1_1F_Layout (14x8)
824 808 809 810 826 824 824 824 826 824 888 824 824 826
840 816 523 818 834 832 832 832 834 832 896 854 855 834
848 811 811 811 811 811 811 811 811 811 904 862 863 811
811 836 812 812 812 812 812 812 891 892 892 892 892 893
811 872 873 812 812 812 812 812 899 737 584 585 738 901
811 880 881 837 812 812 812 812 899 574 592 593 738 901
838 839 812 812 812 812 812 812 907 908 908 908 908 909
846 847 812 812 812 812 844 845 812 812 812 812 812 812