RustboroCity_Layout (40x60)
336 337 368 368 368 368 368 368 368 368 378 468 469 476 477 476 477 468 471 1 1 1 1 1 476 477 476 477 476 477 476 477 476 477 476 477 476 477 468 469
344 345 368 368 368 336 337 368 368 368 378 476 477 468 469 468 469 476 477 1 1 1 1 1 468 469 468 469 468 469 468 469 468 469 468 469 468 469 476 477
368 368 368 368 368 344 345 368 368 368 378 468 469 476 477 476 477 468 469 1 1 1 1 1 476 477 476 477 476 477 476 477 476 477 476 477 476 477 468 469
368 368 368 368 368 368 368 368 368 368 378 476 477 468 469 468 469 476 477 1 1 1 1 1 468 469 468 469 468 469 468 469 468 469 468 469 468 469 476 477
368 368 368 368 368 368 368 368 368 368 378 468 469 476 477 476 477 468 469 1 1 1 1 1 486 485 476 477 476 477 476 477 476 477 476 477 476 477 468 469
368 368 368 368 368 368 373 211 2 2 2 486 485 468 469 468 469 476 477 1 1 1 1 1 1 1 468 469 468 469 468 469 468 469 468 469 468 469 476 477
368 368 336 337 368 373 211 1 1 1 1 1 1 484 485 484 485 468 469 1 1 1 1 1 1 1 486 485 484 485 484 485 484 485 484 485 484 485 468 469
368 368 344 345 368 378 1 648 649 649 651 652 652 653 649 649 650 484 487 736 737 737 737 737 702 679 679 679 679 679 679 679 679 679 679 679 850 1 486 485
368 368 368 368 368 378 795 656 657 657 659 660 660 661 657 657 658 850 736 699 699 699 699 699 699 699 699 699 699 699 3 699 699 699 699 699 746 1 1 1
368 368 368 368 368 378 792 664 665 666 654 655 662 663 666 666 667 711 699 699 760 761 761 761 761 761 761 761 761 761 761 761 761 761 761 761 762 1 1 1
368 368 368 368 368 378 792 672 673 674 668 669 669 670 674 674 675 732 699 699 768 94 777 777 777 777 777 777 777 777 777 777 777 777 777 777 778 1 1 1
336 337 368 368 368 378 792 664 665 666 676 677 677 678 666 666 667 748 701 699 768 770 699 699 699 699 699 699 699 699 699 699 699 699 699 699 746 1 1 1
344 345 368 368 368 378 792 672 673 674 668 669 669 670 674 674 675 748 707 699 768 770 699 699 699 699 699 699 699 699 699 699 699 699 699 699 754 462 463 1
368 368 368 368 368 378 792 680 681 681 676 677 677 678 682 682 683 748 707 699 768 770 699 699 702 679 679 679 679 679 679 679 679 679 679 679 794 470 471 1
368 368 368 368 368 378 792 688 689 689 684 685 685 686 690 690 691 748 707 699 768 770 699 699 710 699 699 699 699 699 699 699 699 699 699 699 793 486 498 463
368 368 368 368 368 378 792 708 707 707 692 693 693 694 707 707 707 748 707 530 768 770 530 699 714 715 715 715 715 731 699 548 549 549 549 550 793 1 468 471
368 368 368 368 368 378 792 699 531 707 707 707 707 707 707 531 707 748 707 538 768 770 538 699 434 435 435 435 435 436 699 566 574 574 574 567 793 462 499 485
368 368 368 368 368 378 792 699 538 699 699 708 707 707 707 539 699 711 699 699 768 770 699 699 712 441 442 435 443 713 699 556 557 557 557 558 793 470 469 1
368 368 368 368 373 211 792 699 699 699 699 699 699 699 699 699 699 711 699 699 768 770 699 716 720 449 450 453 451 721 699 532 578 535 578 534 793 486 498 463
368 368 368 368 378 1 792 699 699 530 699 699 699 699 530 699 702 725 699 699 768 770 699 724 728 729 722 461 723 730 699 540 541 543 541 542 793 1 468 469
368 368 368 368 378 1 792 699 699 538 699 699 699 699 538 699 699 3 699 699 768 770 699 699 699 699 699 699 699 699 699 699 699 699 699 699 793 462 499 485
368 368 368 368 378 1 792 699 699 699 699 699 699 699 699 699 699 699 760 761 94 94 761 761 761 761 761 761 761 761 761 761 761 761 762 699 793 470 469 1
368 368 368 368 378 1 792 699 699 699 699 699 699 699 699 699 699 699 776 777 94 94 777 777 777 777 777 777 777 777 777 777 777 777 778 699 793 486 498 463
368 368 368 373 211 1 813 764 764 764 764 764 764 764 764 764 764 703 699 530 768 770 530 699 699 699 699 699 699 699 699 699 699 699 699 699 793 1 468 469
368 368 368 378 1 1 792 699 699 699 699 699 699 699 699 699 699 699 699 538 768 770 538 699 699 699 699 699 548 549 549 549 550 699 699 699 793 462 499 485
368 368 368 378 462 463 792 699 699 544 545 545 545 545 545 545 546 547 699 699 768 770 699 699 702 764 764 764 566 574 574 574 567 679 679 679 794 470 469 1
368 368 368 378 470 471 792 699 699 552 553 553 553 553 553 553 554 555 699 699 768 770 699 738 734 1 462 463 556 557 557 557 558 753 753 699 793 486 498 463
368 368 373 211 476 477 792 699 699 560 561 561 561 561 561 561 561 563 701 699 768 770 699 738 734 4 470 471 532 578 535 578 534 4 4 744 793 1 468 469
368 368 378 1 468 469 792 699 699 568 570 569 570 569 570 569 570 571 707 699 768 770 699 738 734 4 486 487 540 541 543 541 542 4 4 744 793 462 499 485
368 368 378 1 476 477 792 699 699 568 570 569 569 551 569 569 570 571 707 699 768 770 699 738 734 1 4 4 1 1 1 1 1 4 4 744 793 470 469 1
368 373 211 1 468 469 792 699 699 576 577 577 577 559 577 577 577 579 707 530 768 770 530 699 544 545 545 545 545 546 547 1 1 1 736 699 793 486 498 463
368 378 462 463 476 477 792 699 699 708 707 707 707 707 707 707 707 707 707 538 768 770 538 699 552 553 553 553 553 554 555 1 1 736 717 679 794 1 468 469
368 378 470 469 468 469 792 699 699 699 699 699 699 699 699 699 699 699 699 699 768 770 699 699 560 561 561 561 561 561 563 737 737 699 699 699 793 462 499 485
368 378 476 477 476 477 792 699 699 699 699 699 699 699 699 699 699 699 699 699 768 770 699 699 568 570 570 551 570 570 571 699 699 699 699 699 793 470 469 1
2 2 468 469 468 469 792 544 545 545 546 547 699 699 699 699 699 699 699 699 768 770 699 699 576 577 577 559 577 577 579 699 699 699 699 699 793 486 498 463
462 463 476 477 476 477 792 552 553 553 554 555 699 699 699 598 606 607 599 699 768 770 699 699 699 3 699 699 699 699 699 699 699 699 699 699 793 1 468 469
468 469 468 469 468 469 792 560 561 561 561 563 699 699 699 80 81 82 83 699 768 770 699 699 699 699 699 699 699 699 699 699 699 699 699 699 793 462 499 485
476 477 476 477 476 477 792 568 570 551 570 571 699 699 699 88 89 90 91 530 768 770 530 699 699 699 699 699 699 699 699 699 699 699 699 699 793 470 469 1
468 469 468 469 468 469 792 576 577 559 577 579 3 699 699 614 97 98 638 538 768 770 538 699 699 699 699 824 825 826 699 699 699 699 699 699 793 486 498 463
476 477 484 485 484 485 792 699 699 699 699 699 699 699 699 699 699 699 699 699 768 770 699 699 699 699 699 832 833 834 699 548 549 549 550 699 793 1 468 469
468 469 795 695 695 695 745 699 760 761 761 761 761 761 761 761 761 761 761 761 94 770 699 699 699 699 699 840 841 842 699 566 574 574 567 699 793 462 499 485
476 477 792 699 699 699 699 699 776 777 777 777 777 777 777 777 777 777 777 777 94 770 699 699 699 699 699 699 699 699 699 556 557 557 558 699 793 470 469 1
468 469 792 699 699 699 699 699 699 699 699 699 699 699 699 805 615 615 806 699 768 770 699 699 544 545 545 545 545 575 699 532 533 533 534 699 793 486 498 463
476 477 792 548 549 549 549 549 549 550 699 699 699 699 699 48 49 50 51 699 768 770 699 699 552 553 553 553 553 583 699 532 578 578 534 701 793 1 468 469
468 469 792 566 574 574 574 574 574 567 699 699 699 699 699 56 57 58 59 530 768 770 530 699 560 561 561 561 561 563 699 532 533 533 534 707 793 462 499 485
476 477 792 556 557 557 557 557 557 558 699 699 699 699 699 614 65 66 639 538 768 770 538 699 568 570 551 570 570 571 699 532 578 578 534 707 793 470 469 1
468 469 792 532 578 533 578 533 578 534 699 699 699 699 699 699 699 699 699 699 768 770 699 699 576 577 559 577 577 579 699 540 541 541 542 707 793 486 498 463
476 477 792 532 578 533 578 533 578 534 701 699 699 699 699 760 761 761 761 761 94 94 761 761 761 761 761 761 762 699 699 708 707 707 707 707 793 1 468 469
468 469 792 532 533 533 533 533 533 534 707 701 699 699 699 768 94 777 777 777 777 777 777 777 777 777 777 777 778 530 699 699 699 699 699 699 793 462 499 485
476 477 792 532 578 533 578 533 578 534 707 707 699 699 699 768 770 699 699 3 699 699 699 699 699 699 699 699 699 538 699 699 699 699 699 699 793 470 469 1
468 469 792 532 578 535 578 533 578 534 707 707 699 699 699 768 770 699 699 699 699 699 699 699 699 699 699 699 699 699 699 702 764 764 764 764 801 476 477 1
476 477 792 540 541 543 541 541 541 542 707 707 699 699 699 768 770 699 699 699 699 699 699 699 699 699 699 699 699 699 699 789 1 462 463 462 463 468 469 1
468 469 792 708 707 707 707 707 707 707 707 707 699 699 699 768 770 699 699 699 699 699 699 699 699 699 699 699 699 699 699 789 1 470 469 468 471 484 498 463
476 477 792 699 708 707 707 707 707 707 707 707 699 699 699 768 770 699 699 699 699 699 699 699 699 699 699 699 699 699 699 789 1 476 477 484 498 463 468 469
468 469 800 764 764 764 764 764 764 764 764 703 699 699 530 768 770 530 699 699 702 764 764 764 764 764 764 764 764 764 764 812 1 468 469 1 468 469 476 477
476 477 462 463 462 463 462 463 462 463 1 797 699 699 538 768 770 538 699 699 789 1 462 463 462 463 462 463 462 463 462 463 462 499 498 463 476 477 468 469
468 469 468 469 468 469 468 469 468 471 1 797 753 753 753 768 770 753 753 753 789 1 470 469 468 469 468 469 468 469 468 469 468 469 468 469 468 469 476 477
476 477 476 477 476 477 484 485 484 487 1 735 1 1 1 272 274 1 1 1 734 1 486 485 484 485 484 485 484 485 484 485 484 485 476 477 476 477 468 469
468 469 468 469 468 469 1 1 1 1 1 735 1 1 1 1 1 1 1 1 734 1 1 1 1 1 1 1 1 1 1 1 1 1 468 469 468 469 476 477
476 477 476 477 476 477 823 831 830 831 695 743 1 1 1 1 1 1 1 1 742 695 695 695 695 695 695 695 695 695 695 695 727 1 476 477 476 477 468 469