SafariZone_RestHouse_Layout (10x9)
1 1 1 1 1 1 1 1 1 1
1 1 1 1 1 1 1 1 1 1
517 517 517 519 517 517 519 517 517 517
525 525 525 527 525 525 527 525 525 525
548 548 548 548 548 548 548 548 548 548
569 547 564 744 746 572 547 547 547 547
569 547 564 752 754 572 547 547 547 547
569 547 547 547 547 547 547 547 547 547
569 547 547 520 521 547 547 547 547 547