SafariZone_Northeast_Layout (40x40)
113 116 169 169 169 169 169 169 125 113 113 113 116 169 169 169 169 169 169 169 169 169 169 169 169 169 169 169 169 137 113 113 113 113 113 113 113 113 113 113
124 125 113 113 116 169 169 169 169 124 124 124 125 113 113 113 116 169 169 169 169 169 169 137 113 113 113 113 113 123 124 124 124 124 137 113 113 113 113 113
169 169 124 124 125 116 169 169 169 169 169 169 169 124 124 124 125 113 113 113 113 113 113 123 124 124 137 113 113 113 113 113 113 113 115 113 113 113 113 113
113 113 116 169 169 125 113 116 169 169 169 169 169 169 169 137 113 113 113 113 113 113 113 113 113 113 123 124 137 113 113 113 113 113 123 137 113 113 113 113
124 124 125 113 113 116 124 125 113 116 145 145 169 137 113 123 124 124 124 124 124 124 124 124 124 124 137 113 123 124 124 124 124 137 113 115 113 113 113 113
169 169 169 124 124 125 116 145 121 122 13 13 13 120 121 145 145 145 145 145 145 145 145 145 137 113 123 124 169 169 137 113 113 115 113 115 113 113 113 113
113 113 113 113 113 113 114 1 13 13 13 13 13 13 1 288 226 292 292 292 292 292 292 292 144 121 145 145 137 113 115 113 113 115 113 123 137 113 113 113
496 497 496 497 496 497 122 13 13 13 13 13 13 13 1 288 292 292 292 292 292 292 292 292 292 292 292 292 144 137 115 113 113 115 113 113 115 113 113 113
468 469 468 469 468 471 13 13 13 13 13 13 13 13 1 296 292 292 292 292 292 292 292 292 292 292 292 292 292 136 115 113 113 115 113 113 123 124 137 113
476 477 476 477 484 487 13 13 13 13 13 13 13 13 1 1 288 292 292 292 292 292 292 292 292 292 292 292 292 136 115 113 113 123 137 113 113 113 115 113
468 469 468 469 13 13 13 13 13 13 13 13 13 1 1 1 288 292 292 292 292 292 292 292 292 292 292 292 292 136 123 137 113 113 115 113 113 113 115 113
476 477 476 477 13 13 13 13 13 13 13 13 13 1 1 1 288 292 292 292 292 292 292 292 292 292 292 226 292 136 113 115 113 113 115 113 113 113 123 124
468 469 468 469 13 13 13 13 13 13 1 1 1 1 1 1 296 292 292 292 292 292 292 292 292 292 292 292 292 144 137 115 113 113 123 124 137 113 113 113
476 477 476 477 13 13 13 13 13 13 1 1 1 1 1 1 1 288 226 292 292 292 292 292 292 292 292 292 292 292 136 115 113 113 113 113 115 113 113 113
468 469 468 469 13 13 13 1 1 1 1 1 1 1 1 1 1 296 297 292 292 292 292 292 292 292 292 292 292 292 136 123 137 113 113 113 123 124 124 124
476 477 476 477 1 1 1 1 1 1 1 1 1 1 1 1 1 1 1 296 292 292 292 292 292 292 292 292 292 292 144 137 115 113 113 113 113 113 113 113
468 469 468 469 1 1 1 1 1 1 1 1 1 104 211 2 2 2 2 2 2 212 130 292 292 292 292 292 292 292 292 136 115 113 113 113 113 113 113 113
476 477 484 487 1 1 1 1 1 1 1 104 211 2 1 1 1 280 281 282 1 1 114 292 292 292 292 292 292 292 292 136 123 124 137 113 113 113 113 113
468 469 1 1 1 1 1 1 1 1 1 112 1 1 1 280 281 289 289 298 1 1 114 292 226 292 292 292 292 292 292 144 145 137 123 121 121 121 121 121
476 477 1 1 1 1 1 1 1 104 211 2 1 280 281 289 289 289 298 1 1 1 212 2 212 130 292 292 292 292 292 292 292 136 462 463 462 463 462 463
468 469 1 1 1 1 1 104 211 2 1 1 280 289 289 289 289 298 1 1 1 1 1 1 1 114 292 292 292 292 292 292 292 136 470 469 468 469 468 469
476 477 224 1 1 1 1 112 1 1 1 280 289 289 289 289 290 1 1 110 135 135 791 111 1 114 292 292 292 292 292 292 226 136 476 477 476 477 476 477
468 469 1 1 1 1 1 112 1 1 1 296 297 289 226 289 298 1 1 134 1 1 799 133 224 114 226 292 292 292 292 292 292 136 468 469 468 469 468 469
476 477 462 463 1 1 1 112 1 1 1 1 1 296 297 298 1 1 116 691 135 135 803 692 121 122 288 292 292 292 292 292 292 136 476 477 476 477 476 477
468 469 468 471 1 1 1 120 121 175 207 121 137 1 1 1 1 1 114 1 1 1 807 1 1 1 296 292 292 292 292 292 292 136 468 469 468 469 468 469
476 477 476 477 1 1 1 1 1 1 1 1 112 462 463 1 1 1 114 1 1 1 1 1 1 1 1 296 297 297 297 297 297 136 476 477 476 477 476 477
468 469 468 469 1 1 1 1 1 1 1 1 112 470 471 1 1 1 212 106 1 1 1 1 1 1 1 1 13 13 13 13 784 136 468 469 468 469 468 469
476 477 476 477 224 1 1 1 1 1 1 1 112 476 477 1 1 1 1 114 1 1 1 1 1 1 1 13 13 13 13 13 792 112 476 477 476 477 476 477
468 469 468 469 1 1 1 1 1 1 1 1 112 468 469 1 1 1 1 114 224 1 1 1 1 1 13 13 13 13 13 13 13 112 468 469 468 469 468 469
476 477 476 477 1 1 1 1 1 1 1 1 112 486 487 1 1 1 1 2 2 2 2 2 2 106 13 13 13 454 455 454 455 717 499 498 499 498 499 485
468 469 468 469 13 13 1 1 1 1 104 211 2 1 1 1 1 1 1 1 1 1 1 1 1 2 2 2 794 508 509 508 509 508 469 468 469 468 469 1
476 477 484 487 13 13 13 1 1 1 112 13 13 1 1 1 1 1 1 1 1 1 1 1 1 1 1 1 1 486 485 484 485 476 477 476 477 476 477 1
468 469 13 13 13 13 13 13 104 211 2 13 13 13 1 1 1 1 1 1 1 1 1 1 1 1 1 1 1 1 1 1 1 468 469 470 469 468 469 116
476 477 13 13 13 13 13 13 112 13 13 13 13 13 13 1 1 462 463 462 463 462 463 462 463 462 463 1 1 1 1 1 1 476 477 476 477 476 477 114
468 469 13 13 13 784 13 13 112 13 13 13 13 13 13 1 1 470 471 470 471 470 471 470 471 470 471 1 1 1 1 1 1 468 469 468 469 468 469 114
476 477 13 13 13 792 13 13 112 13 13 13 13 13 13 1 1 476 477 476 477 476 477 476 477 476 477 462 463 1 1 1 1 476 477 476 477 476 477 114
468 469 13 13 13 13 13 13 112 13 13 13 13 13 13 1 1 468 469 468 469 468 469 468 469 468 469 468 471 1 1 1 1 470 469 468 469 468 469 114
476 477 454 455 13 13 13 13 112 454 455 454 455 13 1 462 463 476 477 476 477 476 477 476 477 476 477 476 477 462 463 1 1 486 485 476 477 476 477 114
468 469 468 471 13 13 13 13 112 470 469 468 471 13 1 470 469 468 469 468 469 468 469 468 469 468 469 468 469 468 471 1 1 1 1 468 469 468 469 114
476 477 476 477 454 455 454 455 112 476 477 476 477 462 463 476 477 476 477 476 477 476 477 476 477 476 477 476 477 476 477 1 1 1 1 476 477 476 477 114