SafariZone_Southwest_Layout (40x40)
1 468 469 468 469 468 469 1 1 1 1 117 114 468 469 468 469 468 469 1 1 1 1 1 468 469 468 469 468 469 468 469 468 469 468 469 468 469 468 469
1 486 485 484 485 484 487 1 1 1 1 117 114 476 477 476 477 476 477 1 1 1 1 1 486 485 476 477 476 477 476 477 476 477 476 477 476 477 476 477
124 124 124 124 124 124 124 647 232 642 124 125 114 468 469 468 469 468 469 213 135 135 135 135 135 214 468 469 468 469 468 469 468 469 468 469 468 469 468 469
116 494 495 494 495 494 495 655 232 653 494 495 122 476 477 476 477 476 477 1 1 1 1 1 1 1 486 485 484 485 484 485 476 477 476 477 476 477 476 477
122 470 469 468 469 468 471 1 1 1 470 471 1 468 469 468 469 468 469 1 1 1 464 466 1 1 1 224 8 9 9 10 468 469 468 469 468 469 468 469
1 476 477 476 477 476 477 1 1 1 476 477 462 499 498 499 498 499 487 1 1 464 473 473 466 1 1 1 16 17 17 18 484 485 484 485 484 485 484 485
1 468 469 468 469 468 469 1 1 1 468 469 468 469 468 469 468 469 1 1 1 480 481 473 473 465 466 1 24 25 11 26 464 466 224 1 1 1 1 1
462 499 485 476 477 476 477 1 1 1 486 498 499 498 499 498 499 498 463 224 1 1 1 480 481 473 473 466 32 33 19 34 3 473 466 1 1 1 462 463
468 469 1 468 469 468 469 1 1 1 1 468 469 468 469 468 469 468 471 1 1 1 1 1 1 480 481 473 473 473 473 473 473 481 482 1 1 1 470 469
476 477 462 499 487 484 487 1 1 1 1 476 477 476 477 476 477 476 477 462 463 462 463 462 463 462 463 472 473 473 473 473 474 1 462 463 462 463 476 477
468 469 468 469 13 13 13 1 1 1 1 468 469 468 469 468 469 468 469 468 469 468 471 468 469 468 471 480 473 473 473 473 482 1 470 469 468 469 468 469
476 477 476 477 13 13 13 1 1 1 1 486 485 484 485 484 485 484 485 484 485 484 487 484 485 484 487 1 480 473 473 474 462 463 476 477 476 477 476 477
468 469 468 469 13 13 13 1 1 1 104 211 2 2 2 2 2 2 2 2 2 2 2 2 2 2 212 106 1 472 473 474 470 469 468 469 468 469 468 469
476 477 484 487 13 13 13 1 1 104 115 1 1 1 1 1 1 1 1 1 1 1 1 1 1 1 1 117 106 472 473 474 476 477 476 477 476 477 476 477
468 469 13 13 13 13 1 1 1 112 115 1 1 176 177 177 177 177 177 177 177 177 177 178 1 1 1 117 114 480 473 474 468 469 468 469 468 469 468 469
476 477 13 13 13 13 1 1 1 112 115 1 1 184 161 161 161 161 161 161 161 161 161 186 1 1 1 117 114 1 472 474 486 485 476 477 476 477 476 477
468 469 13 13 13 1 200 202 1 112 115 1 1 184 161 161 161 161 784 161 161 161 161 186 1 1 1 117 114 1 472 474 1 1 468 469 468 469 468 469
476 477 13 13 1 1 208 210 1 112 115 1 1 184 161 161 161 161 793 161 161 161 161 186 1 1 1 117 114 1 472 474 1 224 476 477 476 477 476 477
468 469 1 1 1 1 216 218 1 112 115 1 1 184 161 161 161 161 161 161 161 161 161 186 1 1 1 117 114 1 480 482 1 1 468 469 468 469 468 469
476 477 1 1 1 1 1 1 1 112 115 1 1 2 212 204 161 161 161 161 161 161 161 186 1 1 1 117 114 1 1 1 1 1 486 485 484 485 484 485
468 469 462 463 1 1 1 1 1 112 115 1 1 1 1 2 2 2 2 2 2 2 2 2 1 1 116 125 114 1 1 1 1 1 1 1 1 1 1 1
476 477 468 471 1 1 1 1 13 112 115 1 1 1 1 1 1 1 1 1 1 1 1 1 1 1 117 116 122 1 1 1 1 1 1 1 1 1 462 463
468 469 476 477 1 1 1 13 13 112 123 124 124 124 124 124 124 124 124 175 207 124 124 124 124 124 125 114 1 1 1 1 1 1 1 1 1 224 470 469
476 477 468 469 1 1 1 13 13 120 145 145 145 145 145 145 145 145 145 175 207 145 145 145 145 145 145 122 1 1 1 1 462 463 462 463 462 463 476 477
468 469 476 477 1 1 1 13 13 13 13 13 213 135 111 1 1 1 1 1 1 1 1 1 1 1 1 1 1 1 1 1 470 469 468 469 468 469 468 469
476 477 468 469 1 1 1 1 13 13 13 13 13 13 133 1 1 1 1 1 1 1 1 1 1 1 462 463 462 463 462 463 476 477 476 477 476 477 476 477
468 469 484 487 1 200 201 201 201 202 13 13 13 13 133 1 1 1 1 1 1 1 1 1 1 1 470 469 468 469 468 469 468 469 468 469 468 469 468 469
476 477 1 1 1 208 209 209 209 218 13 13 13 13 133 1 1 1 1 1 462 463 462 463 462 463 476 477 476 477 476 477 476 477 476 477 476 477 476 477
468 469 1 1 1 208 209 217 218 1 1 13 13 13 141 135 135 135 135 214 470 469 468 469 468 469 468 469 468 469 468 469 468 469 468 469 468 469 468 469
484 487 1 1 1 216 218 1 1 1 1 1 1 1 1 1 1 1 1 1 476 477 476 477 476 477 484 485 484 485 484 485 484 485 476 477 476 477 476 477
1 1 1 1 1 1 1 1 1 1 1 1 1 1 1 1 1 1 1 1 468 469 468 469 468 469 13 13 13 13 13 13 13 13 468 469 468 469 468 469
176 177 177 177 177 177 177 178 462 463 462 463 1 1 1 1 1 1 1 1 486 485 484 485 484 487 13 13 13 13 13 13 13 13 476 477 476 477 476 477
184 161 161 161 161 161 161 186 470 469 468 471 1 1 1 1 1 1 1 1 1 1 1 1 1 13 13 13 13 13 13 13 13 13 468 469 468 469 468 469
184 161 161 161 161 161 161 186 476 477 476 477 462 463 462 463 1 1 1 1 1 1 1 1 1 1 13 13 13 13 13 13 13 13 486 485 476 477 476 477
184 161 161 161 161 161 161 186 468 469 468 469 468 469 468 471 1 1 1 1 1 200 201 201 202 1 1 1 13 13 13 13 13 13 13 13 468 469 468 469
184 161 161 161 161 161 161 186 476 477 476 477 476 477 476 477 462 463 462 463 1 216 209 209 210 1 1 1 1 1 13 13 13 13 1 1 486 485 484 485
184 161 161 161 161 161 161 186 468 469 468 469 468 469 468 469 468 469 468 471 1 1 216 217 218 1 1 1 1 1 1 1 1 1 1 1 1 1 1 1
488 489 488 489 488 489 488 489 476 477 476 477 476 477 476 477 476 477 476 477 462 463 462 463 462 463 1 1 1 1 1 1 462 463 462 463 462 463 462 463
468 469 468 469 468 469 468 469 468 469 468 469 468 469 468 469 468 469 468 469 468 469 468 469 468 471 1 1 1 1 1 1 470 469 468 469 468 469 468 469
476 477 476 477 476 477 476 477 476 477 476 477 476 477 476 477 476 477 476 477 476 477 476 477 476 477 462 463 462 463 462 463 476 477 476 477 476 477 476 477