SafariZone_Northwest_Layout (40x40)
468 469 468 469 112 123 124 137 113 123 169 169 169 137 113 113 113 113 113 113 123 169 169 169 169 169 169 169 169 169 169 169 169 169 169 169 169 137 113 113
476 477 476 477 693 495 137 115 113 113 113 113 113 123 124 124 124 124 124 124 169 169 169 169 169 169 169 169 169 169 169 169 169 169 169 137 113 123 124 124
468 469 468 469 468 469 112 123 124 124 124 124 124 169 169 169 169 169 169 169 169 169 169 169 169 169 169 169 169 169 137 113 113 113 113 123 124 169 169 169
476 477 476 477 484 485 693 495 494 495 494 495 494 495 494 495 169 169 169 169 169 169 169 169 169 169 169 169 137 113 123 124 124 124 124 169 169 137 113 113
468 469 468 469 468 469 468 469 468 469 468 469 468 469 468 471 1 116 494 495 494 495 494 495 137 113 113 113 123 124 169 169 169 169 169 137 113 123 124 124
476 477 484 485 484 485 484 485 476 477 476 477 476 477 484 498 463 114 468 469 468 469 468 469 120 124 124 124 169 169 169 169 169 137 113 123 124 169 169 169
468 469 13 13 13 13 13 13 468 469 468 469 468 469 1 468 471 114 476 477 476 477 476 477 176 177 177 177 177 177 177 178 224 120 121 137 113 113 113 113
476 477 13 13 784 13 13 13 486 485 484 498 499 498 463 476 477 114 468 469 468 469 468 469 184 161 161 161 161 161 161 186 1 1 1 120 496 497 496 497
468 469 13 13 792 13 13 13 1 1 1 468 469 468 469 468 469 114 476 477 476 477 476 477 184 161 161 161 161 161 161 186 1 1 1 1 470 469 468 469
476 477 13 13 13 13 13 1 1 1 1 486 485 484 485 476 477 114 468 469 468 469 468 469 184 161 161 161 161 161 161 194 177 177 177 178 476 477 476 477
468 469 13 13 13 13 13 280 282 1 1 1 1 1 1 468 469 114 486 485 476 477 476 477 184 161 161 161 161 161 161 161 161 161 161 186 468 469 468 469
476 477 13 13 13 13 1 288 289 282 1 1 1 1 1 486 487 114 224 1 468 469 468 469 184 161 161 161 161 161 161 161 161 161 161 186 476 477 476 477
468 469 13 13 1 1 1 288 289 290 1 1 1 1 1 1 1 114 1 1 486 485 476 477 184 161 161 161 161 161 161 161 161 161 161 186 468 469 468 469
476 477 462 463 462 463 1 296 289 289 282 1 1 1 1 1 1 114 1 1 1 1 468 469 184 161 161 161 161 161 161 161 161 161 161 186 486 485 476 477
468 469 468 469 468 471 1 1 288 289 290 116 121 175 207 121 121 122 1 1 1 224 486 487 2 2 2 2 2 2 2 2 2 2 2 2 13 13 468 469
476 477 476 477 476 477 462 463 288 289 298 114 1 1 1 1 1 1 1 1 1 1 1 1 1 1 1 1 1 1 13 13 13 784 13 13 13 13 476 477
468 469 468 469 468 469 468 471 288 290 1 114 13 13 13 13 1 1 1 1 1 1 1 1 1 1 1 1 1 13 13 13 13 792 13 13 13 13 468 469
476 477 476 477 476 477 476 477 288 290 1 114 13 13 13 13 13 13 13 1 1 1 1 1 462 463 1 1 1 1 13 13 13 13 13 13 13 13 476 477
468 469 468 469 468 469 468 469 296 298 1 114 13 13 13 13 13 13 13 13 13 13 1 1 470 471 462 463 1 1 1 13 13 13 13 13 13 13 468 469
476 477 476 477 476 477 476 477 1 1 1 114 13 13 13 13 13 13 13 13 13 13 1 1 476 477 468 471 1 1 1 1 1 1 13 13 454 455 476 477
468 469 468 469 468 469 468 469 1 1 1 2 2 2 2 212 106 13 13 13 13 13 13 1 468 469 476 477 1 1 280 281 282 1 1 224 470 469 468 469
484 485 484 485 484 485 484 487 1 1 1 1 1 1 1 1 114 13 13 13 13 13 13 1 486 485 468 469 1 280 226 289 289 281 282 1 476 477 476 477
488 489 488 489 488 489 106 13 13 1 1 1 1 1 1 1 2 2 2 488 489 488 489 106 1 1 486 487 280 289 289 289 289 289 290 1 468 469 468 469
468 469 468 469 468 471 114 224 13 13 13 1 1 1 1 1 1 1 1 470 469 468 471 114 1 1 1 1 288 289 289 289 289 289 298 1 476 477 476 477
476 477 476 477 476 477 114 13 13 13 13 13 1 1 1 1 1 1 1 486 485 484 487 114 1 1 1 1 296 226 289 289 297 298 1 1 468 469 468 469
468 469 468 469 468 469 114 13 13 13 13 13 13 13 1 1 1 1 280 282 1 1 1 2 2 2 212 106 1 296 297 298 1 1 1 1 476 477 476 477
484 485 484 485 484 487 114 13 224 13 13 13 13 13 1 1 1 1 296 289 281 282 1 1 1 462 463 114 1 1 1 1 1 13 13 13 468 469 468 469
13 224 13 13 13 1 2 2 2 2 2 2 2 2 2 212 106 462 463 288 289 289 282 1 224 470 471 114 1 1 1 13 13 13 13 13 476 477 476 477
13 13 13 13 13 13 1 1 1 1 1 1 1 1 1 1 114 470 471 296 289 289 290 462 463 476 477 114 1 13 13 13 13 13 13 13 468 469 468 469
13 13 13 13 13 13 1 1 1 1 1 1 1 1 1 1 114 476 477 1 288 289 290 470 469 468 469 114 13 13 13 784 13 13 13 13 476 477 476 477
224 13 13 13 13 13 13 1 1 1 1 1 1 1 1 1 114 468 469 1 296 289 290 476 477 476 477 114 13 13 13 792 13 13 13 13 468 469 468 469
454 455 454 455 13 13 13 1 1 1 1 116 121 175 207 121 122 486 487 1 1 296 298 468 469 468 469 114 13 13 13 13 13 13 454 455 476 477 476 477
468 469 468 471 13 13 13 1 1 1 224 114 1 1 1 1 1 1 1 1 1 1 1 476 477 476 477 114 13 13 13 13 13 13 470 469 468 469 468 469
476 477 476 477 454 455 1 1 280 282 1 114 1 1 1 1 1 1 1 1 1 1 1 468 469 468 469 114 454 455 454 455 454 455 484 485 476 477 476 477
468 469 468 469 468 471 1 1 288 290 1 114 224 1 1 1 1 1 1 1 1 1 1 486 485 484 487 114 470 469 468 469 468 469 468 469 468 469 468 469
486 498 499 498 499 498 463 1 288 290 1 114 1 1 224 1 1 116 121 121 121 175 207 121 496 497 496 694 476 477 476 477 476 477 476 477 476 477 476 477
1 468 469 468 469 468 471 1 288 289 282 117 116 121 121 121 121 122 1 1 1 1 1 1 470 469 468 469 468 469 468 469 468 469 468 469 468 469 468 469
224 476 477 476 477 476 477 1 288 289 290 117 114 462 463 462 463 1 1 1 1 1 1 1 476 477 476 477 476 477 476 477 476 477 476 477 476 477 476 477
1 468 469 468 469 468 469 1 296 289 290 117 114 470 469 468 471 1 1 1 1 1 1 1 468 469 468 469 468 469 468 469 468 469 468 469 468 469 468 469
224 476 477 476 477 476 477 1 1 296 298 117 114 476 477 476 477 462 463 1 1 1 1 1 476 477 476 477 476 477 476 477 476 477 476 477 476 477 476 477