SafariZone_Southeast_Layout (40x40)
468 469 468 469 468 469 468 469 112 468 469 468 469 468 469 468 469 468 469 468 469 468 469 468 469 468 469 468 469 468 469 1 1 1 1 468 469 468 469 114
476 477 476 477 476 477 476 477 112 476 477 476 477 476 477 476 477 484 485 484 485 484 485 484 485 484 485 484 485 484 487 1 1 1 1 476 477 476 477 114
468 469 468 469 468 469 468 469 112 468 469 468 469 468 469 468 469 116 121 121 121 121 121 121 121 137 1 1 1 1 1 1 1 1 224 468 469 468 469 114
476 477 476 477 484 485 484 487 112 476 477 476 477 484 485 484 487 114 1 1 1 1 787 787 787 788 1 1 1 1 1 1 1 1 1 486 485 476 477 114
468 469 468 469 1 1 1 1 112 468 469 468 469 1 1 1 1 114 1 1 1 1 798 801 789 802 1 1 1 1 1 1 1 1 1 1 224 468 469 114
484 485 484 487 1 1 464 466 112 486 485 484 487 1 1 1 1 114 1 1 797 797 790 1 1 112 1 1 1 1 1 1 1 1 1 1 1 486 485 114
1 1 1 1 1 464 473 482 112 224 1 1 1 1 1 1 1 114 1 1 798 801 789 1 1 112 1 110 135 135 135 135 135 135 111 1 1 1 1 114
462 463 1 1 1 480 482 1 112 1 1 1 1 1 1 1 1 786 787 787 790 1 1 1 1 112 1 134 1 1 1 1 1 1 133 1 116 494 495 122
468 471 1 1 1 13 13 13 112 1 1 1 1 1 1 1 224 800 789 801 789 1 1 1 1 120 121 691 135 135 135 135 135 135 692 121 122 470 471 1
476 477 462 463 454 455 13 13 120 121 121 121 121 175 207 121 121 122 1 1 1 1 462 463 462 463 462 463 1 1 1 13 13 13 13 13 13 486 498 463
468 469 468 469 468 471 13 13 13 13 1 1 464 466 1 1 1 224 1 1 1 1 470 469 468 469 468 471 1 1 1 13 13 13 13 13 13 13 468 469
476 477 476 477 476 477 13 13 13 13 13 1 480 482 1 1 464 465 466 1 1 462 499 498 499 498 499 498 463 1 1 1 13 13 13 13 13 13 476 477
468 469 468 469 468 469 13 13 13 13 13 13 1 1 1 464 473 473 473 466 1 470 469 468 469 468 469 468 471 224 1 1 1 13 13 13 13 13 468 469
476 477 476 477 476 477 13 13 13 13 13 13 1 1 1 472 473 473 473 474 1 486 485 484 485 484 485 484 487 1 1 1 1 1 1 13 454 455 476 477
468 469 468 469 468 469 13 13 13 13 454 455 462 463 1 472 473 473 473 473 466 1 1 464 465 466 1 1 1 1 1 1 1 1 1 224 470 469 468 469
476 477 476 477 476 477 13 13 13 1 470 469 468 471 1 480 473 473 473 473 473 466 1 480 473 474 1 464 466 1 462 463 462 463 462 463 476 477 476 477
468 469 468 469 468 469 1 1 1 1 476 477 476 477 1 1 472 473 473 473 473 474 1 1 480 482 1 480 482 1 470 469 468 469 468 469 468 469 468 469
476 477 476 477 484 487 224 1 1 1 468 469 468 469 462 463 480 473 473 473 473 482 462 463 462 463 462 463 462 463 476 477 476 477 476 477 476 477 476 477
468 469 468 469 224 1 1 1 1 1 476 477 476 477 468 471 1 472 473 473 482 1 470 469 468 469 468 469 468 469 468 469 468 469 468 469 468 469 468 469
484 485 484 487 1 1 1 1 462 463 468 469 468 469 476 477 1 480 473 474 462 463 476 477 476 477 476 477 476 477 476 477 476 477 476 477 476 477 476 477
1 1 1 1 1 1 1 1 470 469 476 477 476 477 468 469 1 1 472 474 470 469 468 469 468 469 468 469 468 469 468 469 468 469 468 469 468 469 468 469
462 463 462 463 462 463 462 463 476 477 468 469 468 469 476 477 1 1 472 474 486 498 499 498 499 498 499 498 499 498 499 498 499 498 499 498 499 498 499 498
468 469 468 469 468 469 468 469 468 469 476 477 476 477 468 469 1 1 472 473 466 468 469 468 469 468 469 468 469 468 469 468 469 468 469 468 469 468 469 468
476 477 476 477 476 477 476 477 476 477 468 469 468 469 476 477 1 1 472 473 474 486 485 484 485 484 485 476 477 476 477 476 477 476 477 476 477 476 477 476
468 469 468 469 468 469 468 469 468 469 476 477 476 477 468 469 1 1 472 473 473 465 466 1 1 1 1 468 469 468 469 468 469 468 469 468 469 468 469 468
476 477 476 477 476 477 476 477 476 477 468 469 468 469 484 487 1 464 473 473 473 473 473 465 466 1 1 486 485 484 485 476 477 476 477 476 477 476 477 476
468 469 468 469 468 469 468 469 468 469 484 485 484 487 1 1 464 473 473 473 481 481 481 481 482 1 1 464 466 1 1 468 469 468 469 468 469 468 469 468
476 477 476 477 476 477 484 485 484 487 13 13 13 1 1 1 472 473 473 482 1 1 13 13 13 1 1 480 473 466 1 486 485 476 477 476 477 476 477 476
468 469 468 469 468 469 13 13 13 13 13 13 13 1 1 464 473 473 482 1 13 13 13 13 13 13 1 1 480 482 1 1 224 468 469 468 469 468 469 468
476 477 476 477 484 487 13 13 13 13 13 13 1 1 1 472 473 474 1 1 13 13 13 13 13 13 13 1 1 1 808 809 809 809 809 809 809 809 809 809
468 469 468 469 13 13 13 13 13 13 13 1 1 1 464 473 473 474 1 13 13 13 13 13 784 13 13 13 1 1 816 817 817 817 817 817 817 817 817 817
476 477 476 477 13 13 13 13 13 13 1 1 1 1 472 473 473 474 1 13 13 13 13 13 792 13 13 13 1 1 824 825 825 825 825 825 825 825 825 825
468 469 468 469 13 13 13 1 1 1 1 1 1 1 480 473 473 474 1 13 13 13 13 13 13 13 13 13 1 1 819 804 805 806 823 822 823 822 823 822
476 477 484 487 1 1 1 464 466 1 462 463 462 463 1 472 473 473 466 1 13 13 13 13 13 13 13 13 1 1 834 836 813 815 796 795 796 795 796 795
468 469 1 1 1 464 465 473 482 1 470 469 468 471 1 480 473 473 473 465 466 1 13 13 13 13 1 1 1 1 1 1 1 470 469 468 469 468 469 468
484 487 224 1 464 473 473 482 462 463 476 477 476 477 462 463 480 481 473 473 473 465 465 465 465 465 465 465 466 1 1 1 1 476 477 476 477 476 477 476
1 1 1 1 480 481 482 224 470 469 468 469 468 469 468 471 1 1 480 481 481 473 473 473 473 473 481 481 482 1 1 1 1 468 469 468 469 468 469 468
462 463 462 463 462 463 462 463 476 477 476 477 476 477 476 477 462 463 462 463 1 480 481 481 481 482 1 1 462 463 462 463 462 499 498 499 498 499 498 499
468 469 468 469 468 469 468 469 468 469 468 469 468 469 468 469 468 469 468 471 1 1 1 1 1 1 1 224 470 469 468 469 468 469 468 469 468 469 468 469
476 477 476 477 476 477 476 477 476 477 476 477 476 477 476 477 476 477 476 477 462 463 462 463 462 463 462 463 476 477 476 477 476 477 476 477 476 477 476 477