ScorchedSlab_Layout (15x20)
529 529 529 529 529 529 529 529 529 529 529 529 529 529 529
529 529 539 537 537 537 537 537 537 537 537 537 540 529 529
529 529 530 529 539 537 537 537 537 537 540 529 536 540 529
529 529 530 539 538 513 513 513 513 513 536 540 529 528 529
529 529 530 530 513 513 513 513 513 513 513 528 529 528 529
529 529 530 530 513 513 513 513 513 513 513 528 529 528 529
529 529 530 530 513 513 513 513 513 513 513 528 529 528 529
529 529 530 530 513 513 513 513 513 513 513 528 529 528 529
529 539 538 530 649 657 657 657 657 657 641 536 540 528 529
529 530 539 538 650 368 368 368 368 368 656 641 528 528 529
529 530 530 649 658 368 368 368 368 368 368 648 528 528 529
529 530 530 650 368 368 368 368 368 368 368 648 528 528 529
529 530 530 650 368 368 368 368 368 368 368 648 528 528 529
529 530 530 650 368 368 368 368 368 368 368 648 528 528 529
529 530 530 650 368 368 368 368 368 368 368 648 528 528 529
529 530 530 650 368 368 368 368 368 368 368 648 528 528 529
529 530 530 650 368 368 368 643 368 368 368 648 528 528 529
529 530 583 583 606 606 651 652 644 606 606 583 583 528 529
529 583 521 521 521 521 521 521 521 521 521 521 548 583 529
529 529 529 529 529 529 529 529 529 529 529 529 529 529 529