SeafloorCavern_Room6_Layout (24x23)
653 641 641 641 649 650 641 641 641 641 641 641 641 641 641 641 641 641 641 641 641 641 641 654
634 653 641 656 657 658 641 641 641 641 641 641 641 641 641 641 641 641 641 641 641 641 654 632
634 634 633 633 633 633 384 393 393 393 393 393 393 393 393 393 393 393 393 393 393 385 632 632
634 634 633 633 633 633 400 368 652 651 651 651 651 651 651 651 651 651 651 651 651 402 632 632
634 634 633 633 633 633 400 368 652 368 368 368 368 368 368 368 368 368 368 368 643 402 632 632
634 634 633 633 633 633 400 368 652 368 368 368 629 630 630 630 631 368 368 368 643 402 632 632
634 634 384 393 393 393 408 368 652 368 368 629 655 638 638 638 663 631 368 368 643 402 632 632
634 634 400 368 368 368 368 368 652 368 368 637 640 648 649 650 642 639 368 368 643 402 632 632
634 634 400 368 368 644 644 644 652 368 368 645 646 646 657 658 646 647 368 368 643 402 632 632
634 634 400 368 643 368 368 368 652 368 368 368 368 368 643 368 368 368 368 644 643 402 632 632
634 634 400 368 643 368 368 368 652 368 644 644 644 644 643 368 368 368 368 643 643 402 632 632
634 634 400 368 643 368 368 368 652 368 643 368 368 368 368 368 652 651 651 368 643 402 632 632
634 634 400 368 643 368 652 651 368 644 643 652 651 651 651 651 651 368 368 643 368 402 632 632
634 634 400 368 643 368 652 368 652 368 368 652 368 368 368 368 368 368 368 643 368 402 632 632
634 634 400 368 643 368 652 368 652 368 368 644 644 644 652 368 368 368 368 643 368 402 632 632
634 634 400 368 643 368 652 368 652 368 368 368 368 368 652 368 368 368 368 643 368 402 632 632
634 634 400 368 643 368 652 368 652 368 368 368 368 644 368 644 644 644 644 643 368 402 632 632
634 634 400 368 643 368 652 368 652 368 368 368 368 643 644 644 644 644 643 368 368 402 632 632
634 634 400 368 643 368 652 368 644 644 644 644 644 643 368 368 368 368 368 368 368 402 632 632
634 634 400 368 643 651 651 368 368 643 368 368 368 643 368 368 368 368 368 629 630 659 659 659
634 634 400 368 368 368 368 368 629 668 623 623 623 667 630 631 368 629 630 659 638 638 638 638
660 660 660 630 630 630 630 630 659 634 638 662 638 632 638 660 630 659 638 638 638 638 638 638
638 638 638 638 638 638 638 638 638 660 664 665 666 659 638 638 638 638 638 638 638 638 638 638