SeafloorCavern_Room8_Layout (11x14)
753 753 753 753 753 753 753 753 753 753 753
753 747 761 761 782 766 767 761 761 748 753
753 754 753 747 790 774 775 748 753 752 753
753 754 747 762 513 513 513 760 748 752 753
753 754 754 513 513 513 513 513 752 752 753
753 754 754 513 513 513 513 513 752 752 753
753 754 754 513 513 513 513 513 752 752 753
753 754 754 513 513 513 513 513 752 752 753
753 754 754 513 513 513 513 513 752 752 753
753 754 754 513 513 513 513 513 752 752 753
753 754 754 513 588 593 589 513 752 752 753
753 754 754 513 513 513 513 513 752 752 753
753 754 754 513 513 519 513 513 752 752 753
753 755 755 745 741 742 743 745 756 756 753