SeafloorCavern_Room3_Layout (16x17)
753 753 753 753 753 747 761 782 766 767 761 748 753 753 753 753
753 753 753 753 753 754 747 790 774 775 748 752 753 753 753 753
753 753 753 753 753 754 754 513 513 513 752 752 753 753 753 753
753 753 753 753 753 754 754 513 513 513 752 760 761 748 753 753
753 753 753 753 753 754 754 513 513 513 760 761 748 752 753 753
753 753 753 753 753 754 754 744 746 513 513 513 752 752 753 753
753 753 753 747 761 762 754 760 762 513 513 513 752 752 753 753
753 753 753 754 747 761 762 513 744 746 513 513 752 752 753 753
753 753 753 754 754 513 513 513 760 762 513 513 752 752 753 753
747 761 761 762 754 513 513 513 513 513 513 513 752 752 753 753
754 747 761 761 762 513 513 513 513 513 744 746 752 760 761 748
754 754 513 513 513 513 513 513 513 513 760 762 760 761 748 752
754 754 513 513 513 513 513 513 513 513 513 513 513 513 752 752
754 754 593 593 593 589 513 513 513 513 519 513 513 513 752 752
754 754 513 513 513 513 513 744 745 741 742 743 745 745 756 752
754 754 513 513 519 513 513 752 744 745 745 745 745 745 745 756
756 756 745 741 742 743 745 756 756 753 753 753 753 753 753 753