SeafloorCavern_Entrance_Layout (20x20)
753 753 753 753 753 753 747 761 761 782 766 767 761 761 748 753 753 753 753 753
753 753 753 753 747 761 787 747 761 790 774 775 761 748 786 761 748 753 753 753
753 753 753 753 779 747 761 781 292 292 292 292 292 780 761 748 752 753 753 753
753 753 747 761 787 773 292 292 292 292 292 292 292 292 292 772 786 748 753 753
753 753 779 747 761 781 292 292 292 292 292 292 292 292 292 780 748 752 753 753
753 747 787 773 292 292 292 292 292 292 292 292 292 292 292 292 772 786 761 748
753 779 747 781 292 292 292 292 292 292 292 292 292 292 292 292 780 761 748 778
753 779 773 292 292 292 292 292 292 292 292 292 292 292 292 292 292 292 772 778
753 779 773 292 292 292 292 292 398 422 422 422 397 292 292 292 292 292 772 778
753 779 773 292 292 292 398 422 423 414 414 414 421 422 397 292 292 292 772 778
753 779 773 292 292 398 423 414 414 414 414 414 414 414 421 397 292 292 772 778
753 779 773 292 398 423 414 420 446 446 446 446 446 419 414 421 397 292 772 778
753 779 773 398 423 414 420 447 368 368 368 368 368 445 419 414 413 292 772 778
753 779 773 415 414 420 447 368 368 368 368 368 368 368 445 419 421 397 772 778
753 779 773 423 414 439 368 368 368 368 368 368 368 368 368 437 414 413 772 778
753 779 773 414 414 439 368 368 368 368 368 368 368 368 368 437 414 413 772 778
753 756 912 679 414 439 368 368 342 342 342 342 368 368 368 437 687 663 755 755
753 753 753 912 679 439 368 342 660 660 660 660 342 368 694 912 912 753 753 753
753 753 753 753 912 912 695 342 660 660 660 660 342 694 912 753 753 753 753 753
753 753 753 753 753 753 912 912 912 912 912 912 912 912 753 753 753 753 753 753