SeafloorCavern_Room5_Layout (20x20)
753 747 761 782 766 767 761 761 761 761 761 748 753 753 753 753 753 753 753 753
753 754 747 790 774 775 761 761 761 761 748 752 753 753 649 657 657 657 641 753
753 754 754 513 513 513 513 513 513 513 752 752 753 753 650 659 659 659 648 753
753 754 754 513 513 513 513 513 513 513 752 752 753 753 650 659 659 659 648 753
753 755 755 745 745 745 746 513 513 513 752 752 753 753 755 755 642 659 648 753
649 657 641 753 753 753 754 746 513 513 752 760 761 761 761 748 650 659 648 753
650 659 648 753 747 761 762 754 513 513 760 761 761 761 748 752 755 755 755 753
755 755 755 753 754 747 761 762 513 513 513 513 513 513 752 752 753 753 753 753
753 747 761 761 762 754 513 513 513 513 513 513 513 513 752 760 761 761 761 748
753 754 747 761 761 762 513 513 513 744 745 746 513 513 760 761 761 761 748 752
753 754 754 513 513 513 513 513 744 752 753 754 746 513 513 513 513 513 752 752
753 754 754 513 513 513 513 513 752 752 753 754 754 513 513 513 513 513 752 752
753 754 754 513 513 744 745 746 752 752 753 754 754 513 513 519 513 513 752 752
753 754 754 513 513 752 529 754 752 752 753 755 755 745 741 742 743 745 755 755
753 754 754 513 744 755 529 754 752 760 761 748 753 753 753 753 649 657 657 641
753 754 754 513 760 761 761 762 760 761 748 752 753 753 753 649 658 659 659 648
753 754 754 513 513 513 513 513 513 513 752 752 753 649 657 658 659 659 659 648
753 754 754 513 513 513 513 519 513 513 752 752 753 650 659 659 659 659 640 755
753 755 755 745 745 745 741 742 743 745 755 755 753 755 642 659 640 755 755 753
753 753 753 753 753 753 753 753 753 753 753 753 753 753 755 755 755 753 753 753