SeafloorCavern_Room7_Layout (23x25)
653 641 641 641 648 649 650 641 641 641 641 641 641 641 641 641 641 641 641 641 641 641 654
634 653 641 641 656 657 658 641 641 641 641 641 654 638 638 638 638 638 638 638 638 638 632
634 634 633 633 633 633 633 633 633 633 633 633 632 638 638 638 638 638 638 638 638 638 632
634 634 633 633 633 633 633 384 393 393 393 385 640 641 641 641 641 641 641 641 641 654 632
634 634 384 393 393 393 393 408 368 368 368 410 393 393 393 393 393 393 393 393 385 632 632
634 634 400 368 368 368 368 368 368 368 368 368 368 368 368 368 368 368 368 368 402 632 632
634 634 400 368 652 651 651 651 651 651 651 651 651 651 651 651 651 651 651 368 402 632 632
634 634 400 368 652 368 368 368 368 368 368 368 368 368 368 368 368 368 643 368 402 632 632
634 634 400 368 652 652 644 644 644 644 644 644 644 644 644 644 644 644 643 368 402 632 632
634 634 400 368 652 652 368 368 368 368 652 368 368 368 368 368 368 368 368 368 402 632 632
634 634 400 368 368 652 368 368 368 368 644 644 644 644 644 644 644 644 652 368 402 632 632
634 634 400 368 368 652 368 368 368 368 368 368 368 368 368 368 368 368 652 368 402 632 632
634 634 400 652 368 652 368 368 651 651 651 651 651 651 651 651 651 368 652 368 402 632 632
634 634 400 652 368 652 368 368 652 651 368 368 368 368 368 368 643 368 652 368 402 632 632
634 634 400 652 368 652 368 368 652 643 368 368 368 368 368 368 643 368 652 368 402 632 632
634 634 400 652 368 644 644 644 652 643 651 651 651 651 651 651 368 644 652 368 402 632 632
634 634 400 652 368 368 368 368 652 368 368 368 368 368 368 368 643 368 652 368 402 632 632
634 634 400 652 368 368 368 368 652 368 368 368 368 368 368 368 643 368 652 368 402 632 632
634 634 400 652 651 651 651 651 651 651 651 651 651 368 368 368 643 651 651 651 402 632 632
634 659 668 625 377 368 368 368 368 368 368 368 643 368 368 368 643 368 368 368 402 632 632
634 633 634 633 400 368 368 368 368 368 368 368 643 368 368 368 643 368 368 368 402 632 632
634 633 634 633 625 625 625 625 625 377 368 368 643 368 368 368 643 368 368 368 402 632 632
634 653 642 633 633 633 633 633 633 400 368 368 643 368 368 368 643 368 368 368 402 632 632
634 634 633 661 633 633 627 633 628 400 368 368 644 368 368 368 643 368 368 368 402 632 632
660 660 664 665 625 625 659 659 659 659 630 630 630 630 630 630 630 630 630 630 659 659 659