SeafloorCavern_Room1_Layout (20x21)
753 753 753 753 753 753 753 753 753 753 753 753 753 753 753 753 753 753 753 753
753 753 747 761 761 782 766 767 761 761 761 761 761 761 748 753 753 753 753 753
753 753 754 753 747 790 774 775 748 529 529 529 529 529 760 748 753 753 753 753
753 753 754 753 754 513 513 513 752 529 529 529 529 529 529 760 748 753 753 753
753 753 754 753 754 513 513 513 760 761 516 748 529 529 529 529 752 753 753 753
753 753 754 753 754 749 513 513 513 513 513 760 748 529 529 529 752 753 753 753
753 753 754 753 756 746 751 513 513 513 513 513 760 748 529 529 760 748 753 753
753 753 754 753 753 754 759 513 513 513 513 513 513 752 529 529 529 752 753 753
753 753 754 753 753 756 745 745 745 745 745 746 513 752 529 529 529 760 748 753
753 753 754 747 761 761 748 753 753 753 753 754 513 752 529 529 529 749 752 753
753 753 754 754 513 513 760 761 761 761 761 762 513 760 748 529 529 529 760 748
753 753 754 754 513 513 513 513 513 513 513 513 513 513 752 529 529 529 749 752
753 753 754 754 513 513 744 745 745 745 745 746 513 749 752 529 529 529 529 752
753 753 754 754 513 513 752 753 753 753 753 754 513 513 752 529 529 572 529 752
753 753 754 754 513 744 755 753 753 753 753 754 513 513 752 788 741 742 743 755
753 753 754 754 513 752 753 753 747 761 761 762 513 513 752 752 753 753 753 753
753 753 754 754 513 760 761 761 762 513 513 513 513 513 752 752 753 753 753 753
753 753 754 754 513 513 513 513 513 513 513 744 745 745 756 752 753 753 753 753
753 753 754 754 513 519 513 513 513 513 513 752 753 753 753 752 753 753 753 753
753 753 754 756 741 742 743 745 745 745 745 755 753 753 753 752 753 753 753 753
753 753 755 745 745 745 745 745 745 745 745 745 745 745 745 755 753 753 753 753