SeafloorCavern_Room4_Layout (18x19)
747 761 761 782 766 767 761 761 761 761 761 761 782 766 767 761 761 748
754 747 761 790 774 775 748 753 753 753 753 747 790 774 775 748 753 752
754 754 513 513 513 513 752 753 753 753 753 754 513 513 513 752 753 752
754 754 513 513 513 513 752 753 753 753 753 754 513 513 513 752 753 752
754 754 588 593 593 589 760 761 761 761 761 762 513 513 513 752 753 752
754 754 513 513 513 513 513 513 513 513 569 513 513 513 513 760 748 752
754 754 513 513 513 513 513 513 513 513 569 513 513 513 513 513 752 752
754 754 513 513 513 513 513 744 745 745 756 746 513 513 513 513 752 752
754 754 513 513 513 513 744 752 753 753 753 754 746 513 513 513 752 752
754 754 513 513 513 513 752 760 782 766 767 762 754 513 513 513 752 752
754 754 513 513 513 513 760 761 790 774 775 761 762 513 513 513 752 752
754 754 513 513 513 513 513 569 513 513 513 513 513 513 513 513 752 752
754 756 745 746 513 513 513 569 513 513 513 513 513 513 744 745 756 752
754 753 753 756 745 745 745 745 746 588 593 593 593 589 752 753 753 752
756 745 789 753 753 753 753 753 754 513 513 513 513 513 752 753 753 752
753 753 756 745 789 753 753 753 754 513 519 513 513 513 752 753 753 752
753 753 753 753 756 745 789 753 756 741 742 743 745 745 756 753 753 752
753 753 753 753 753 753 754 753 753 753 753 753 753 753 753 788 745 756
753 753 753 753 753 753 756 745 745 745 745 745 745 745 745 756 753 753