SeafloorCavern_Room2_Layout (18x21)
753 753 753 753 753 753 753 753 753 753 753 753 753 753 753 753 753 753
747 761 761 761 782 766 767 761 761 761 761 782 766 767 761 761 761 748
754 747 761 761 790 774 775 748 753 753 747 790 774 775 761 761 748 752
754 754 513 513 513 513 513 752 753 753 754 513 513 513 513 513 752 752
754 754 744 745 745 746 513 752 753 753 754 513 744 745 745 746 752 752
754 754 760 761 761 762 513 760 761 761 762 513 760 761 761 762 752 752
754 754 513 513 513 513 513 513 513 513 513 513 513 513 513 513 752 752
754 754 513 744 745 746 513 744 745 745 746 513 744 745 746 513 752 752
754 754 513 752 753 754 513 752 753 753 754 513 752 753 754 513 752 752
754 754 513 760 761 762 513 760 761 761 762 513 760 761 762 513 752 752
754 754 513 513 513 513 513 513 513 513 513 513 513 513 513 513 752 752
754 754 513 744 745 746 513 744 745 745 746 513 744 745 746 513 752 752
754 754 513 752 753 754 513 752 753 753 754 513 752 753 754 513 752 752
754 754 513 760 761 762 513 760 761 761 762 513 760 761 762 513 752 752
754 754 513 513 513 513 513 513 513 513 513 513 513 513 513 513 752 752
754 755 745 745 745 746 513 744 745 745 746 513 744 745 745 745 755 752
754 753 753 753 747 762 513 752 753 753 754 513 760 748 753 753 753 752
754 753 753 753 754 513 513 752 753 753 754 513 513 752 753 753 753 752
754 753 753 753 754 513 513 752 753 753 754 513 513 752 753 753 753 752
754 753 753 753 754 519 513 752 753 753 754 513 519 752 753 753 753 752
755 745 745 745 741 742 743 755 745 745 755 741 742 743 745 745 745 755