SealedChamber_OuterRoom_Layout (21x23)
539 537 537 537 537 537 537 537 537 537 537 537 537 537 537 537 537 537 537 537 540
530 539 537 537 537 537 537 537 608 554 555 556 609 537 537 537 537 537 537 540 528
530 530 539 537 537 537 537 537 553 562 563 564 553 537 537 537 537 537 540 528 528
530 530 530 513 513 513 513 513 513 513 513 513 513 513 513 513 513 513 528 528 528
530 530 530 513 513 513 513 513 513 513 513 513 513 513 513 513 513 513 528 528 528
530 530 530 520 521 521 521 522 513 520 521 521 521 522 513 520 521 522 528 528 528
530 530 530 536 565 565 565 538 513 536 565 565 565 538 513 536 565 538 528 528 528
530 530 530 513 513 513 513 513 513 513 513 513 513 513 513 513 513 513 528 528 528
530 530 530 520 521 521 521 522 513 520 521 521 521 522 513 520 521 522 528 528 528
530 530 530 536 565 565 565 538 513 536 565 565 565 538 513 536 565 538 528 528 528
530 530 530 513 513 513 513 513 513 513 513 513 513 513 513 513 513 513 528 528 528
530 530 530 520 521 521 521 522 513 520 521 521 521 522 513 513 513 513 528 528 528
530 530 530 536 565 565 565 538 513 536 565 565 565 538 513 513 513 513 528 528 528
530 530 530 513 513 513 513 513 513 513 513 513 513 513 513 513 513 513 528 528 528
530 530 530 520 521 521 521 522 513 520 521 521 521 522 513 513 513 513 528 528 528
530 530 530 536 565 565 565 538 513 536 565 565 565 538 513 513 513 513 528 528 528
530 530 530 513 513 513 513 513 513 513 513 513 513 513 513 513 513 513 528 528 528
530 530 530 513 513 513 513 513 384 393 393 393 385 513 513 513 513 513 528 528 528
530 530 530 513 513 513 513 513 400 342 342 342 402 513 513 513 513 513 528 528 528
530 530 530 513 513 513 513 513 400 342 327 342 402 513 513 513 513 513 528 528 528
530 530 548 615 615 615 615 615 607 607 607 607 607 615 615 615 615 615 547 528 528
530 548 521 521 521 521 521 521 521 521 521 521 521 521 521 521 521 521 521 547 528
548 548 521 521 521 521 521 521 521 521 521 521 521 521 521 521 521 521 521 547 547