SealedChamber_InnerRoom_Layout (21x23)
753 747 761 761 761 761 761 761 761 761 761 761 761 761 761 761 761 761 761 748 753
753 754 747 761 761 761 761 761 761 761 761 761 761 761 761 761 761 761 748 752 753
747 762 754 747 761 761 761 761 748 753 753 753 747 761 761 761 761 748 752 760 748
754 747 762 754 513 513 513 513 752 753 753 753 754 513 513 513 513 752 760 748 752
754 754 747 762 513 513 513 513 760 567 567 567 762 513 513 513 513 760 748 752 752
754 754 754 513 513 513 513 513 513 513 513 513 513 513 513 513 513 513 752 752 752
754 754 754 513 513 744 745 746 513 513 513 513 513 744 745 746 513 513 752 752 752
754 754 754 513 513 752 753 754 513 513 513 513 513 752 753 754 513 513 752 752 752
754 754 754 513 513 760 567 762 513 513 513 513 513 760 567 762 513 513 752 752 752
754 754 754 513 513 513 513 513 513 513 513 513 513 513 513 513 513 513 752 752 752
754 754 754 513 513 513 513 513 513 513 513 513 513 513 513 513 513 513 752 752 752
754 754 754 744 745 746 513 513 513 513 513 513 513 513 513 744 745 746 752 752 752
754 754 754 752 753 754 513 513 513 513 513 513 513 513 513 752 753 754 752 752 752
754 754 754 760 567 762 513 513 513 513 513 513 513 513 513 760 567 762 752 752 752
754 754 754 513 513 513 513 513 513 513 513 513 513 513 513 513 513 513 752 752 752
754 754 754 513 513 513 513 513 513 513 513 513 513 513 513 513 513 513 752 752 752
754 754 754 513 513 744 745 746 513 513 513 513 513 744 745 746 513 513 752 752 752
754 754 754 513 513 752 753 754 513 513 513 513 513 752 753 754 513 513 752 752 752
754 754 756 746 513 760 567 762 513 513 513 513 513 760 567 762 513 744 755 752 752
754 756 771 754 513 513 513 513 513 513 519 513 513 513 513 513 513 752 770 755 752
756 771 754 756 745 745 745 745 745 741 742 743 745 745 745 745 745 755 752 770 755
753 754 756 745 745 745 745 745 745 745 745 745 745 745 745 745 745 745 755 752 753
753 756 745 745 745 745 745 745 745 745 745 745 745 745 745 745 745 745 745 755 753