SecretBase_YellowCave2_Layout (14x9)
513 514 514 514 514 514 514 514 514 514 514 514 514 515
521 526 522 522 522 522 522 522 522 522 522 522 522 523
521 522 522 522 522 522 522 522 517 530 530 519 522 523
521 522 522 522 522 522 522 522 523 528 528 521 522 523
529 519 522 522 522 522 522 522 523 528 528 521 522 523
528 521 522 522 522 522 522 522 525 515 528 521 522 523
528 521 522 522 522 522 522 522 544 523 528 521 522 523
528 521 522 522 522 522 522 522 522 523 528 521 516 523
528 529 530 530 530 530 530 530 530 531 528 529 524 531