SecretBase_RedCave3_Layout (15x8)
528 528 528 528 528 528 528 528 528 513 514 514 514 514 515
513 514 514 514 514 514 515 528 528 521 522 522 526 522 523
521 544 522 522 522 522 523 528 528 521 522 522 522 522 523
521 522 522 522 522 522 525 514 514 527 522 522 522 522 523
521 522 522 522 522 522 532 532 522 532 522 522 522 522 523
521 522 522 522 522 522 517 530 530 519 522 522 522 522 523
521 522 522 516 522 522 523 528 528 529 519 522 522 522 523
529 530 530 524 530 530 531 528 528 528 529 530 530 530 531