SecretBase_YellowCave1_Layout (11x9)
513 514 514 514 514 514 514 514 514 515 528
521 522 522 526 522 522 522 522 522 525 515
521 522 522 522 522 522 522 522 522 544 523
521 522 522 522 522 522 522 522 522 522 523
521 522 522 522 522 522 522 522 522 522 523
521 522 522 522 522 522 522 522 522 522 523
521 522 522 522 522 522 522 522 522 522 523
529 519 522 522 522 516 522 522 517 530 531
528 530 530 530 530 524 530 530 531 528 528