SecretBase_Shrub4_Layout (14x11)
513 514 514 514 514 514 514 514 514 514 514 514 514 515
521 522 522 546 522 522 522 522 522 522 522 522 522 523
521 522 522 547 522 522 522 522 522 522 522 522 522 523
521 522 522 517 530 530 530 530 530 519 522 522 522 523
521 522 522 525 514 514 515 528 513 527 522 522 522 523
521 522 522 532 522 522 523 528 521 544 522 522 522 523
521 522 522 522 522 522 523 528 521 522 522 522 522 523
521 522 522 522 522 522 523 528 521 526 522 522 522 523
521 522 522 522 522 522 523 528 529 519 522 516 522 523
521 522 522 522 522 522 523 528 528 529 530 524 530 531
529 530 530 530 530 530 531 528 528 528 528 528 528 528