SecretBase_YellowCave3_Layout (12x11)
528 528 528 528 528 528 528 513 514 514 514 515
513 514 514 515 528 528 528 521 522 522 522 523
521 522 522 523 528 528 528 521 522 522 522 523
521 522 522 523 528 528 528 521 522 522 522 523
521 522 522 525 514 514 514 527 522 522 522 523
521 522 522 544 522 522 522 526 522 522 522 523
521 522 522 522 522 522 522 522 522 522 522 523
521 522 522 522 522 522 522 522 522 522 522 523
521 522 522 522 522 522 522 522 522 522 517 531
528 519 522 522 522 516 522 522 522 522 523 528
528 529 530 530 530 524 530 530 530 530 531 528