SecretBase_RedCave1_Layout (11x9)
528 513 514 514 514 514 514 514 514 515 528
513 527 522 522 522 522 522 522 522 523 528
521 544 522 522 522 522 522 522 522 525 515
521 522 522 522 522 522 522 522 522 517 531
521 522 522 522 522 522 522 526 522 523 528
521 522 522 522 522 522 522 522 522 523 528
521 522 522 522 522 522 522 522 522 525 515
529 530 519 522 522 516 522 522 522 517 531
528 528 529 530 530 524 530 530 530 531 528