SecretBase_Shrub2_Layout (15x7)
513 514 514 514 514 514 514 514 514 514 514 514 514 515 528
521 544 522 522 522 522 522 522 522 522 522 522 522 525 515
521 522 522 522 522 522 522 522 522 522 522 522 522 526 523
521 522 522 522 522 522 522 522 522 522 522 522 522 522 523
521 522 522 522 522 522 522 522 522 522 522 522 522 522 523
529 530 530 530 519 522 522 516 522 522 522 522 522 517 531
528 528 528 528 529 530 530 524 530 530 530 530 530 531 528