SecretBase_Tree4_Layout (14x14)
528 528 528 528 528 528 528 513 514 514 514 514 514 515
513 514 514 514 514 514 515 521 522 522 522 522 522 523
521 522 522 522 522 522 523 521 522 522 522 522 522 523
521 522 522 522 522 522 523 521 522 522 522 522 522 523
521 522 522 522 522 522 523 521 522 522 522 522 522 523
529 519 522 522 517 530 531 521 522 522 522 522 522 523
528 529 519 546 523 528 528 521 522 522 522 522 517 531
528 528 521 547 523 528 528 529 530 530 519 546 523 528
528 528 521 532 525 514 514 514 514 514 527 547 523 528
528 528 521 522 544 522 522 522 522 522 526 532 523 528
528 528 521 522 522 522 522 522 522 522 522 522 523 528
528 528 521 522 522 522 522 522 522 522 522 522 523 528
528 528 521 522 522 522 522 516 522 522 517 530 528 528
528 528 529 530 530 530 530 524 530 530 531 528 528 528