SecretBase_BrownCave4_Layout (14x12)
513 514 514 514 514 514 514 514 514 514 514 514 514 515
521 544 526 522 522 522 522 522 522 522 546 522 522 523
521 522 522 522 522 522 522 522 522 522 547 522 522 523
521 522 522 522 517 530 530 530 530 530 530 519 522 523
521 522 522 522 523 528 528 528 528 528 528 521 522 523
521 522 522 522 523 528 513 514 514 514 514 527 522 523
521 522 522 522 523 528 521 522 522 522 522 532 522 523
521 522 522 522 523 528 521 522 522 522 522 522 522 523
521 522 516 522 523 528 521 522 522 522 522 522 522 523
529 530 524 530 531 528 521 522 522 522 522 522 522 523
528 528 528 528 528 528 521 522 522 522 522 522 522 523
528 528 528 528 528 528 529 530 530 530 530 530 530 531