SecretBase_Tree3_Layout (17x8)
513 514 514 514 514 514 514 514 514 514 514 514 514 514 514 515 528
521 522 522 522 522 522 522 522 522 522 522 522 522 522 522 525 515
521 526 522 522 522 522 517 519 522 517 519 522 522 522 522 544 523
521 522 522 522 522 522 523 521 522 523 521 522 522 522 522 522 523
521 522 522 522 522 522 523 521 522 523 521 522 522 522 522 522 523
529 519 522 522 522 522 523 521 522 523 521 522 522 522 522 522 523
528 529 519 522 522 522 523 521 516 523 529 519 522 522 522 522 523
528 528 529 530 530 530 531 529 524 531 528 529 530 530 530 530 531