SecretBase_YellowCave4_Layout (13x14)
513 514 514 514 514 514 514 514 514 514 514 514 515
521 522 522 522 522 522 522 522 522 546 522 522 523
521 522 522 522 522 522 522 522 522 547 522 522 523
521 522 522 522 522 522 522 517 530 519 522 522 523
521 522 522 522 522 522 522 523 528 521 522 522 523
529 530 530 530 530 530 530 531 528 521 522 522 523
528 528 528 528 528 528 528 528 528 521 522 522 523
528 528 513 514 514 514 514 514 514 527 522 522 523
528 528 521 522 522 544 522 522 522 526 522 522 523
528 528 521 522 522 522 522 522 522 522 522 522 523
528 528 521 522 522 522 522 522 522 522 522 517 531
528 528 521 522 522 522 522 522 522 522 517 531 528
528 528 521 522 522 522 516 522 522 522 523 528 528
528 528 529 530 530 530 524 530 530 530 531 528 528