SecretBase_BlueCave4_Layout (9x17)
513 514 514 514 514 514 514 515 528
521 522 522 522 522 522 522 525 515
521 522 522 522 522 522 522 532 523
521 522 522 522 522 522 522 522 523
521 522 522 522 522 522 522 522 523
521 522 522 522 522 522 522 522 523
521 522 522 522 522 522 522 522 523
521 522 522 522 522 522 522 522 523
529 530 519 522 522 517 530 530 531
528 528 529 519 546 523 528 528 528
528 528 528 521 547 523 528 528 528
528 528 528 521 532 523 528 528 528
528 528 513 527 522 525 515 528 528
528 528 521 544 522 526 523 528 528
528 528 521 522 522 522 523 528 528
528 528 521 522 516 522 523 528 528
528 528 529 530 524 530 531 528 528