SecretBase_BrownCave2_Layout (14x9)
513 514 514 514 514 514 514 514 514 514 515 528 528 528
521 522 522 522 522 522 522 522 522 544 525 514 514 515
521 522 517 530 519 522 522 522 522 522 522 526 522 523
521 522 523 528 521 522 522 522 522 522 522 522 522 523
521 522 523 528 521 522 522 522 522 522 522 522 522 523
521 522 523 528 521 522 522 522 522 522 522 522 522 523
521 522 523 528 521 522 522 522 522 522 522 522 517 531
521 516 523 528 529 530 530 519 522 522 522 522 523 528
529 524 531 528 528 528 528 529 530 530 530 530 531 528