SecretBase_BrownCave3_Layout (15x11)
513 514 514 514 514 514 514 514 514 514 514 514 514 515 528
521 522 522 522 522 522 522 522 522 522 522 522 522 523 528
521 522 522 522 522 517 530 530 530 519 522 522 522 525 515
529 519 522 522 522 523 528 528 528 521 522 522 522 544 523
528 521 522 522 522 523 528 528 528 521 522 522 522 522 523
528 521 522 522 522 523 528 528 528 521 522 522 522 522 523
513 527 522 522 522 523 528 528 528 521 522 522 522 522 523
521 526 522 522 522 523 528 528 528 521 522 522 522 522 523
521 522 522 522 522 523 528 528 528 521 522 522 522 522 523
521 522 522 522 522 523 528 528 528 521 522 516 522 522 523
529 530 530 530 530 531 528 528 528 529 530 524 530 530 531