SecretBase_RedCave4_Layout (9x15)
528 513 514 514 514 514 514 514 515
528 521 522 522 522 522 522 522 523
528 521 522 522 522 522 522 522 523
528 521 522 522 522 522 522 522 523
528 521 522 522 522 522 522 522 523
528 529 530 530 530 519 546 517 531
528 528 528 528 528 521 547 523 528
513 514 514 514 514 527 532 523 528
521 522 522 522 522 526 522 523 528
521 522 522 522 522 522 522 523 528
521 522 522 522 522 522 522 523 528
521 522 522 522 522 522 522 525 515
521 522 516 522 522 522 522 544 523
529 530 524 530 519 522 522 522 523
528 528 528 528 529 530 530 530 531