SecretBase_BlueCave3_Layout (10x17)
513 514 514 514 514 514 514 514 514 515
521 522 522 522 522 526 522 522 522 523
521 522 522 522 522 522 522 522 522 523
521 522 522 522 522 522 522 522 522 523
521 522 522 517 530 530 530 530 530 531
521 522 522 523 528 528 528 528 528 528
521 522 522 525 514 514 514 514 514 515
521 522 522 532 532 522 522 522 522 523
529 530 530 530 530 530 530 519 522 523
528 528 528 528 528 528 528 521 522 523
528 528 528 513 514 514 514 527 522 523
528 528 528 521 522 522 522 532 522 523
528 528 528 521 522 517 530 530 530 531
528 513 514 527 522 525 514 515 528 528
528 521 522 544 522 532 532 523 528 528
528 521 522 522 516 522 522 523 528 528
528 529 530 530 524 530 530 531 528 528