SecretBase_BlueCave2_Layout (15x7)
513 514 514 514 514 514 514 514 514 514 514 514 514 514 515
521 544 526 522 522 522 522 522 522 522 522 522 522 522 523
521 522 522 522 522 522 522 522 522 522 522 522 522 522 523
529 519 522 522 522 522 522 522 522 522 522 522 522 522 523
528 521 522 522 522 522 522 522 522 522 522 522 522 522 523
513 527 522 522 522 522 522 516 522 522 522 517 530 530 531
529 530 530 530 530 530 530 524 530 530 530 531 528 528 528