ShoalCave_HighTideEntranceRoom_Layout (35x35)
539 537 537 537 537 537 537 537 537 537 537 537 537 537 537 537 537 537 537 537 537 537 537 537 537 537 537 537 537 537 537 537 537 537 540
530 539 537 537 537 523 524 525 537 537 537 537 537 537 537 537 537 537 537 537 537 537 537 537 537 537 523 524 525 537 537 537 537 540 528
530 530 539 537 537 531 532 533 537 537 537 537 537 537 537 537 537 537 537 537 537 537 537 537 537 537 531 532 533 537 537 537 540 528 528
530 530 530 664 665 665 665 665 665 665 665 665 665 665 666 539 692 692 692 692 692 692 692 540 529 529 568 513 513 513 513 513 528 528 528
530 530 530 672 673 673 673 673 673 673 673 673 673 673 674 636 659 659 659 659 659 659 659 634 529 529 568 513 513 513 513 513 528 528 528
530 530 530 672 673 673 673 681 681 681 681 681 681 681 682 636 659 368 368 368 368 368 659 634 529 529 576 593 593 593 593 593 528 528 528
530 530 530 672 673 673 674 539 692 692 692 692 516 692 692 693 659 368 368 368 368 368 659 634 529 529 529 529 529 529 529 529 528 528 528
530 530 530 672 673 673 674 636 659 659 659 659 659 659 659 659 659 368 368 368 368 368 659 634 529 529 529 529 529 529 529 529 528 528 528
530 530 530 672 673 673 674 636 659 368 368 368 368 368 368 368 368 368 368 368 368 368 659 691 692 516 692 692 692 540 529 529 528 528 528
530 530 530 680 681 681 682 636 659 368 368 368 368 368 368 368 368 368 368 368 368 368 659 659 659 659 659 659 659 634 529 529 528 528 528
530 530 530 539 692 692 692 693 659 368 368 368 368 368 368 368 368 368 368 368 368 368 368 368 368 368 368 368 659 634 529 529 528 528 528
530 530 530 636 659 659 659 659 659 368 368 368 368 368 368 368 368 368 368 368 368 368 368 368 368 368 368 368 659 634 529 529 528 528 528
530 530 530 636 659 368 368 368 368 368 368 368 368 368 368 368 368 368 368 368 368 368 368 368 368 368 368 368 659 634 529 529 528 528 528
530 530 530 636 659 368 368 368 368 368 368 368 368 368 368 368 368 368 368 368 368 368 368 368 368 368 368 368 659 634 529 529 528 528 528
530 530 530 636 659 368 368 368 368 368 368 368 368 368 368 368 368 429 430 430 430 430 430 430 430 430 430 430 678 835 529 529 528 528 528
530 530 530 861 861 853 853 853 853 862 659 368 368 368 368 368 368 437 414 414 414 414 414 414 414 414 414 414 414 675 529 529 528 528 528
530 530 530 529 529 529 529 529 529 636 659 368 368 368 368 368 368 437 414 414 414 414 414 414 414 414 414 414 621 547 529 529 528 528 528
530 530 530 529 529 529 529 529 529 636 659 368 368 368 368 368 368 445 446 446 446 446 419 414 414 414 414 414 675 529 529 529 528 528 528
530 530 530 529 529 529 539 692 516 693 659 368 368 368 368 368 368 368 368 368 368 368 437 414 414 414 414 414 675 544 521 521 521 528 528
530 530 530 529 529 529 636 659 659 659 659 368 368 368 368 368 368 368 368 368 368 368 437 414 414 414 414 414 675 528 529 529 529 528 528
530 530 530 529 529 529 636 659 368 368 368 368 368 368 368 368 368 368 368 368 368 368 437 414 414 414 621 622 547 528 529 529 544 521 528
530 530 530 529 529 529 636 659 368 368 368 368 368 368 368 368 368 368 368 368 368 368 437 414 414 414 675 529 529 528 529 529 528 529 528
530 530 530 529 529 529 914 678 431 368 368 368 368 368 368 368 368 368 368 368 368 368 437 414 414 414 675 529 529 528 529 529 528 529 528
530 530 530 529 529 529 677 414 412 430 430 430 430 430 430 430 430 430 430 430 430 430 411 414 414 414 675 529 544 521 529 529 528 529 528
530 530 530 529 529 529 677 414 414 414 414 414 414 414 414 414 414 414 414 414 414 414 414 414 414 414 675 529 528 529 544 521 521 529 528
530 530 530 529 529 529 677 414 414 414 414 414 414 414 414 414 414 414 414 414 414 414 414 414 414 414 675 529 528 529 528 529 529 529 528
530 530 530 529 529 529 677 414 414 414 414 414 414 414 414 414 414 414 414 414 414 414 414 414 414 414 675 529 528 529 528 529 529 529 528
530 530 530 529 529 529 547 622 622 622 622 622 622 623 414 414 414 414 414 414 414 414 414 414 414 414 675 529 528 529 528 529 529 529 528
530 530 530 529 529 529 529 529 529 529 529 529 529 677 414 414 414 414 414 414 414 414 414 414 414 414 675 529 528 529 528 529 529 529 528
530 530 547 521 521 521 521 521 521 521 521 521 546 677 414 414 414 414 414 414 414 414 414 414 414 414 675 529 528 529 528 529 529 529 528
530 530 529 529 529 529 529 529 529 529 529 529 530 677 414 414 414 414 414 414 629 414 414 414 414 414 675 529 528 529 528 529 529 529 528
530 521 521 521 521 521 521 521 521 546 529 529 530 521 622 622 622 622 622 600 601 602 622 622 622 622 521 529 528 529 528 529 529 529 528
521 521 546 529 529 529 529 529 529 530 529 529 521 521 521 521 521 521 521 521 521 521 521 521 521 521 521 521 521 529 528 529 529 529 528
529 529 530 529 529 529 529 529 529 521 521 521 521 521 521 521 521 521 521 521 521 521 521 521 521 521 521 521 521 521 521 529 529 529 528
529 529 521 521 521 521 521 521 521 521 521 521 521 521 521 521 521 521 521 521 521 521 521 521 521 521 521 521 521 521 521 521 521 521 521