ShoalCave_LowTideInnerRoom_Layout (46x38)
529 529 529 529 529 539 537 537 537 537 537 537 537 537 537 537 537 537 537 537 537 537 537 537 537 537 537 537 537 537 537 537 537 537 537 537 537 537 537 537 540 529 529 529 529 529
529 529 529 529 529 530 539 537 537 537 537 537 537 537 537 537 537 537 537 537 537 537 537 537 537 537 537 537 537 537 537 537 537 537 537 537 537 537 537 540 528 529 529 529 529 529
539 537 537 537 537 538 530 539 537 537 537 537 537 537 537 537 537 537 537 537 537 537 537 537 537 537 537 537 537 537 537 537 537 537 537 537 540 529 529 528 528 529 529 529 529 529
530 539 537 537 537 537 538 530 539 537 537 537 537 537 537 537 537 537 537 537 537 537 537 537 537 537 537 537 537 537 537 537 537 537 537 540 528 529 529 528 536 537 537 537 537 540
530 530 529 529 529 529 529 530 530 539 537 537 537 537 537 537 537 537 537 537 537 537 537 537 537 537 537 537 537 537 537 537 537 537 540 528 528 529 529 528 529 529 517 529 529 528
530 530 529 529 529 529 529 699 699 699 700 700 700 700 700 700 700 700 700 700 700 700 700 700 700 700 700 700 700 700 700 700 700 700 701 701 701 529 529 528 529 529 529 529 529 528
530 530 529 529 529 529 529 707 707 707 708 708 708 708 708 708 708 708 708 708 708 708 708 708 708 708 708 708 708 708 708 708 708 708 709 709 709 529 529 536 537 537 516 537 540 528
530 530 529 529 529 529 529 530 530 530 513 513 513 513 513 513 513 513 513 513 513 513 513 513 513 513 513 513 513 513 513 513 513 513 528 528 528 529 529 529 529 529 529 529 528 528
530 530 529 529 529 539 537 538 530 530 513 513 513 513 513 513 513 513 513 513 513 513 513 513 513 513 513 513 513 513 513 858 513 513 528 528 528 529 529 529 529 529 529 529 528 528
530 530 529 529 529 530 859 529 530 530 513 513 513 513 513 513 513 513 513 513 513 513 513 513 513 513 513 513 513 513 513 513 513 513 528 528 536 537 537 537 537 537 537 540 528 528
530 530 529 529 529 530 529 529 530 530 513 513 513 520 521 521 521 521 521 521 521 521 521 521 521 521 521 521 521 521 521 521 521 521 547 528 529 529 529 529 529 859 529 528 528 528
530 530 529 529 529 530 529 529 530 530 513 513 513 528 529 529 529 529 529 529 529 529 529 529 529 529 529 529 529 529 529 529 529 529 529 528 529 529 529 529 529 529 529 528 528 528
530 530 529 529 529 530 529 529 530 530 513 513 513 528 544 521 521 521 521 521 521 521 521 521 521 521 546 529 529 529 529 529 529 529 529 536 537 516 537 537 537 537 540 528 528 528
530 530 529 529 529 530 539 516 538 530 513 513 513 528 528 529 859 544 521 521 521 521 521 521 521 546 547 521 546 529 529 539 537 537 516 537 537 537 537 537 537 540 528 528 528 528
530 530 529 529 529 530 530 539 537 538 513 513 513 528 528 529 529 528 529 517 529 529 529 529 529 530 529 529 530 529 529 530 539 537 516 537 537 537 537 537 540 528 528 528 528 528
530 530 529 529 529 530 530 530 513 513 513 513 513 528 528 529 529 528 529 529 529 529 529 529 529 530 529 529 530 529 529 530 530 513 513 513 513 513 517 513 528 528 528 528 528 528
530 530 529 529 529 530 530 530 513 513 513 513 513 528 528 529 529 536 537 537 540 529 529 529 529 530 529 529 530 529 529 530 547 521 521 521 521 521 521 521 547 528 528 528 528 528
530 530 529 529 529 530 530 530 513 513 513 513 513 528 536 537 516 537 537 540 528 529 529 529 529 530 529 529 530 529 529 547 521 521 521 521 521 521 521 521 521 547 528 528 528 528
530 530 529 529 529 530 530 530 539 537 537 516 540 536 523 524 525 537 540 528 528 529 529 529 529 530 529 529 530 529 529 529 529 529 529 529 529 529 529 529 529 529 528 528 528 528
530 530 529 529 529 530 530 530 530 513 513 513 536 531 531 532 533 540 528 528 528 529 529 529 529 530 529 529 530 529 529 529 529 529 529 544 521 521 521 521 521 521 547 528 528 528
530 530 529 529 529 530 530 530 530 513 513 513 513 513 513 513 513 528 528 528 528 529 529 529 529 530 529 529 530 529 529 529 529 529 529 528 529 529 529 529 529 859 529 528 528 528
530 530 529 529 529 699 699 699 699 700 700 700 700 700 700 700 700 701 701 701 701 529 529 529 529 530 529 529 530 529 529 529 529 529 529 528 529 529 529 529 529 529 529 528 528 528
530 530 529 529 529 707 707 707 707 708 708 708 708 708 708 708 708 709 709 709 709 529 529 529 529 530 529 529 530 529 529 529 529 529 529 528 529 529 529 529 529 529 529 528 528 528
530 530 539 537 537 538 530 530 530 513 513 513 513 513 513 513 513 528 528 528 536 537 516 537 537 538 539 516 538 529 529 529 529 529 529 536 516 537 540 529 529 529 529 528 528 528
530 530 530 539 537 537 538 530 547 521 521 521 522 513 513 513 513 528 528 528 529 529 529 529 529 529 530 539 537 523 524 525 516 537 537 537 537 540 528 529 529 529 529 528 528 528
530 530 530 547 521 521 521 547 521 561 521 546 530 513 513 520 521 547 528 528 529 529 529 529 529 529 530 530 539 531 532 533 516 537 537 537 540 528 528 529 529 529 529 528 528 528
530 530 530 529 529 529 529 529 529 530 529 530 530 513 858 528 544 521 547 528 529 529 529 529 529 529 530 530 530 513 513 513 513 513 513 513 528 528 528 529 529 529 529 528 528 528
530 530 530 529 529 529 539 537 516 538 529 530 530 513 513 528 528 544 521 547 544 521 521 521 521 546 530 530 530 513 513 513 513 513 513 513 528 528 528 529 529 529 529 528 528 528
530 530 530 529 529 529 530 529 529 529 529 530 547 521 521 547 528 528 544 521 547 529 529 529 529 530 530 530 530 513 513 513 513 513 513 513 528 528 528 529 529 529 529 528 528 528
530 530 530 529 529 529 530 529 529 529 529 547 521 521 521 521 547 528 528 529 529 529 529 529 529 530 530 530 530 513 513 513 513 513 519 513 528 528 528 529 529 529 529 528 528 528
530 530 530 529 529 529 530 529 529 529 529 529 529 529 529 529 529 528 528 544 521 521 521 521 546 530 530 530 547 521 521 521 521 600 601 602 547 528 528 529 529 529 529 528 528 528
530 530 530 529 529 529 521 521 521 521 521 521 521 521 521 521 521 547 528 528 529 529 529 529 530 530 530 547 521 521 521 521 521 521 521 521 521 547 528 529 529 529 529 528 528 528
530 530 530 529 529 529 529 529 529 529 529 529 529 529 529 529 529 529 528 528 529 529 529 529 530 547 547 521 521 521 521 521 521 521 561 521 521 521 547 529 529 529 529 528 528 528
530 530 530 529 529 529 529 529 529 529 529 529 529 529 572 529 529 529 528 528 529 529 529 529 547 521 521 521 521 521 521 521 521 546 530 529 529 529 529 529 572 529 529 528 528 528
530 530 547 521 521 521 521 521 521 521 521 521 521 600 601 602 521 521 547 528 529 529 529 529 529 529 529 529 529 529 529 529 529 530 547 521 521 521 521 600 601 602 521 547 528 528
530 547 521 521 521 521 521 521 521 521 521 546 529 529 529 529 529 529 529 528 529 529 529 529 529 529 529 529 529 529 529 529 529 547 521 521 521 546 529 529 529 529 529 529 528 528
547 521 521 521 521 521 521 546 529 529 529 547 521 521 521 521 521 521 521 547 529 529 529 529 529 529 529 529 529 529 529 529 529 529 529 529 529 547 521 521 521 521 521 521 547 528
529 529 529 529 529 529 529 547 521 521 521 521 521 521 521 521 521 521 521 521 521 521 521 521 521 521 521 521 521 521 521 521 521 521 521 521 521 521 521 521 521 521 521 521 521 547