ShoalCave_HighTideInnerRoom_Layout (46x38)
529 529 529 529 529 539 537 537 537 537 537 537 537 537 537 537 537 537 537 537 537 537 537 537 537 537 537 537 537 537 537 537 537 537 537 537 537 537 537 537 540 529 529 529 529 529
529 529 529 529 529 530 539 537 537 537 537 537 537 537 537 537 537 537 537 537 537 537 537 537 537 537 537 537 537 537 537 537 537 537 537 537 537 537 537 540 528 529 529 529 529 529
539 537 537 537 537 538 530 539 537 537 537 537 537 537 537 537 537 537 537 537 537 537 537 537 537 537 537 537 537 537 537 537 537 537 537 537 540 529 529 528 528 529 529 529 529 529
530 539 537 537 537 537 538 530 539 684 684 684 684 684 684 684 684 684 684 684 684 684 684 684 684 684 684 684 684 684 684 684 684 684 684 540 528 529 529 528 536 537 537 537 537 540
530 530 529 529 529 529 529 530 677 420 446 446 446 446 446 446 446 446 446 446 446 446 446 446 446 446 446 446 446 446 446 446 446 446 419 675 528 529 529 528 529 529 517 529 529 528
530 530 529 529 529 529 529 699 699 915 917 917 917 917 917 917 917 917 917 917 917 917 917 917 917 917 917 917 917 917 917 917 917 917 916 701 701 529 529 528 529 529 529 529 529 528
530 530 529 529 529 529 529 707 707 923 925 925 925 925 925 925 925 925 925 925 925 925 925 925 925 925 925 925 925 925 925 925 925 925 924 709 709 529 529 536 537 537 516 537 540 528
530 530 529 529 529 529 529 530 677 439 368 368 368 368 368 368 368 368 368 368 368 368 368 368 368 368 368 368 368 368 368 368 368 368 437 675 528 529 529 529 529 529 529 529 528 528
530 530 529 529 529 539 537 538 677 439 368 368 368 368 368 368 368 368 368 368 368 368 368 368 368 368 368 368 368 368 368 368 368 368 437 675 528 529 529 529 529 529 529 529 528 528
530 530 529 529 529 530 859 529 677 439 368 368 368 368 368 368 368 368 368 368 368 368 368 368 368 368 368 368 368 368 368 368 368 368 437 675 536 537 537 537 537 537 537 540 528 528
530 530 529 529 529 530 529 529 677 439 368 368 368 429 430 430 430 430 430 430 430 430 430 430 430 430 430 430 430 430 430 430 430 430 411 675 529 529 529 529 529 859 529 528 528 528
530 530 529 529 529 530 529 529 677 439 368 368 368 437 414 414 414 414 414 414 414 414 414 414 414 414 414 414 414 414 414 414 414 414 414 675 529 529 529 529 529 529 529 528 528 528
530 530 529 529 529 530 529 529 677 439 368 368 368 437 621 622 622 622 622 622 622 622 622 622 622 622 623 414 414 414 414 414 414 414 414 683 684 516 684 684 684 684 540 528 528 528
530 530 529 529 529 530 539 516 685 439 368 368 368 437 675 529 859 544 521 521 521 521 521 521 521 546 547 521 623 414 414 420 446 446 446 446 446 446 446 446 446 419 675 528 528 528
530 530 529 529 529 530 677 420 446 447 368 368 368 437 675 529 529 528 529 517 529 529 529 529 529 530 529 529 677 414 414 439 368 368 368 368 368 368 368 368 368 437 675 528 528 528
530 530 529 529 529 530 677 439 368 368 368 368 368 437 675 529 529 528 529 529 529 529 529 529 529 530 529 529 677 414 414 439 368 368 368 368 368 368 368 368 368 437 675 528 528 528
530 530 529 529 529 530 677 439 368 368 368 368 368 437 675 529 529 536 537 537 540 529 529 529 529 530 529 529 677 414 414 439 368 368 368 368 368 368 368 368 368 437 675 528 528 528
530 530 529 529 529 530 677 439 368 368 368 368 368 437 683 684 516 684 684 540 528 529 529 529 529 530 529 529 677 414 414 412 430 430 430 430 430 430 430 430 430 411 675 528 528 528
530 530 529 529 529 530 677 439 368 368 368 368 368 445 446 419 414 414 414 675 528 529 529 529 529 530 529 529 677 414 414 414 414 414 414 414 414 414 414 414 414 414 675 528 528 528
530 530 529 529 529 530 677 439 368 368 368 368 368 368 368 445 446 446 419 675 528 529 529 529 529 530 529 529 677 414 414 414 414 414 414 621 622 622 622 622 622 622 547 528 528 528
530 530 529 529 529 530 677 439 368 368 368 368 368 368 368 368 368 368 437 675 528 529 529 529 529 530 529 529 677 414 414 414 414 414 414 675 529 529 529 529 529 859 529 528 528 528
530 530 529 529 529 699 699 915 917 917 917 917 917 917 917 917 917 917 916 701 701 529 529 529 529 530 529 529 677 414 414 414 414 414 414 675 529 529 529 529 529 529 529 528 528 528
530 530 529 529 529 707 707 923 925 925 925 925 925 925 925 925 925 925 924 709 709 529 529 529 529 530 529 529 677 414 414 414 414 414 414 675 529 529 529 529 529 529 529 528 528 528
530 530 539 537 537 538 677 439 368 368 368 368 368 368 368 368 368 368 437 675 536 537 516 537 537 538 539 516 685 414 414 414 414 414 414 683 516 684 540 529 529 529 529 528 528 528
530 530 530 539 684 684 685 412 430 430 431 368 368 368 368 368 368 368 437 675 529 529 529 529 529 529 677 420 446 446 446 446 446 419 414 414 414 414 675 529 529 529 529 528 528 528
530 530 530 547 622 622 622 622 622 623 439 368 368 368 368 368 368 368 437 675 529 529 529 529 529 529 677 439 368 368 368 368 368 445 446 446 446 419 675 529 529 529 529 528 528 528
530 530 530 529 529 529 529 529 529 677 439 368 368 368 368 368 429 430 411 675 529 529 529 529 529 529 677 439 368 368 368 368 368 368 368 368 368 437 675 529 529 529 529 528 528 528
530 530 530 529 529 529 539 537 516 685 439 368 368 368 368 368 437 621 622 547 544 521 521 521 521 546 677 439 368 368 368 368 368 368 368 368 368 437 675 529 529 529 529 528 528 528
530 530 530 529 529 529 677 414 414 414 412 430 430 430 430 430 411 675 544 521 521 529 529 529 529 530 677 439 368 368 368 368 368 368 368 368 368 437 675 529 529 529 529 528 528 528
530 530 530 529 529 529 677 414 414 414 414 414 414 414 414 414 414 675 528 529 529 529 529 529 529 530 677 439 368 368 368 368 368 368 368 368 368 437 675 529 529 529 529 528 528 528
530 530 530 529 529 529 677 414 414 414 414 414 414 414 414 414 414 675 528 544 521 521 521 521 546 530 677 412 430 430 430 430 430 430 430 430 430 411 675 529 529 529 529 528 528 528
530 530 530 529 529 529 547 622 622 622 622 622 622 622 622 622 622 547 528 528 529 529 529 529 530 530 677 414 414 414 414 414 414 414 414 414 414 414 675 529 529 529 529 528 528 528
530 530 530 529 529 529 529 529 529 529 529 529 529 529 529 529 529 529 528 528 529 529 529 529 530 547 547 622 622 622 622 622 622 622 622 622 622 561 547 529 529 529 529 528 528 528
530 530 530 529 529 529 529 529 529 529 529 529 529 529 572 529 529 529 528 528 529 529 529 529 547 521 521 521 521 521 521 521 521 546 529 529 529 530 529 529 572 529 529 528 528 528
530 530 547 521 521 521 521 521 521 521 521 521 521 600 601 602 521 521 547 528 529 529 529 529 529 529 529 529 529 529 529 529 529 530 529 529 529 547 521 600 601 602 521 547 528 528
530 547 521 521 521 521 521 521 521 521 521 546 529 529 529 529 529 529 529 528 529 529 529 529 529 529 529 529 529 529 529 529 529 547 521 521 521 546 529 529 529 529 529 529 528 528
547 521 521 521 521 521 521 546 529 529 529 547 521 521 521 521 521 521 521 547 529 529 529 529 529 529 529 529 529 529 529 529 529 529 529 529 529 547 521 521 521 521 521 521 547 528
529 529 529 529 529 529 529 547 521 521 521 521 521 521 521 521 521 521 521 521 521 521 521 521 521 521 521 521 521 521 521 521 521 521 521 521 521 521 521 521 521 521 521 521 521 547