ShoalCave_LowTideStairsRoom_Layout (21x15)
529 529 529 529 539 537 537 537 537 537 537 537 537 537 537 537 537 537 537 537 537
529 529 529 539 538 544 521 521 521 521 521 521 521 521 521 521 521 521 561 521 521
529 529 539 538 544 528 514 529 529 529 529 529 529 514 529 529 529 529 530 513 513
529 539 538 544 528 536 537 527 537 537 537 537 537 537 537 537 537 537 538 513 513
539 538 544 528 528 514 513 535 513 513 513 513 514 513 539 537 537 537 537 537 537
530 544 528 528 536 537 537 537 537 537 537 516 537 537 538 513 513 514 513 513 513
530 528 528 528 515 513 515 513 513 513 513 513 539 537 537 537 537 537 537 537 537
530 528 528 536 537 537 537 516 537 537 537 537 538 513 514 513 515 513 513 513 513
530 528 528 513 513 513 513 513 514 513 539 537 537 537 537 537 537 537 537 537 537
530 528 536 537 516 537 537 537 537 537 538 514 513 513 513 513 513 513 513 513 513
530 528 513 515 513 513 513 513 539 537 537 537 537 537 540 513 513 513 513 513 513
530 536 537 527 537 537 537 516 538 513 513 858 513 513 528 513 513 513 513 513 513
530 513 513 535 513 513 513 513 513 513 513 513 513 513 528 513 515 513 513 513 513
530 515 513 513 513 513 513 513 513 513 513 513 513 513 536 537 537 537 537 537 537
547 521 521 521 521 521 521 521 521 521 521 521 521 521 521 521 521 521 521 521 521