ShoalCave_LowTideEntranceRoom_Layout (35x35)
539 537 537 537 537 537 537 537 537 537 537 537 537 537 537 537 537 537 537 537 537 537 537 537 537 537 537 537 537 537 537 537 537 537 540
530 539 537 537 537 523 524 525 537 537 537 537 537 537 537 537 537 537 537 537 537 537 537 537 537 537 523 524 525 537 537 537 537 540 528
530 530 539 537 537 531 532 533 537 537 537 537 537 537 537 537 537 537 537 537 537 537 537 537 537 537 531 532 533 537 537 537 540 528 528
530 530 530 664 665 665 665 665 665 665 665 665 665 665 666 539 537 537 537 537 537 537 537 540 529 529 568 513 513 513 513 513 528 528 528
530 530 530 672 673 673 673 673 673 673 673 673 673 673 674 530 539 537 523 524 525 537 540 528 529 529 568 513 513 513 513 513 528 528 528
530 530 530 672 673 673 673 681 681 681 681 681 681 681 682 530 530 539 531 532 533 540 528 528 529 529 576 593 593 593 593 593 528 528 528
530 530 530 672 673 673 674 539 537 537 537 537 516 537 537 538 530 530 513 513 513 528 528 528 529 529 529 529 529 529 529 529 528 528 528
530 530 530 672 673 673 674 530 539 537 537 537 537 537 537 537 538 530 664 666 513 528 528 528 529 529 529 529 529 529 529 529 528 528 528
530 530 530 672 673 673 674 530 530 529 529 529 529 529 539 537 537 617 673 673 666 528 528 536 537 516 537 537 537 540 529 529 528 528 528
530 530 530 680 681 681 682 530 530 529 529 529 529 529 530 513 513 680 673 673 674 528 536 537 537 537 537 537 540 528 529 529 528 528 528
530 530 530 539 537 537 537 538 530 529 529 529 529 529 530 513 513 513 680 681 682 536 537 537 537 537 537 540 528 528 529 529 528 528 528
530 530 530 530 539 537 537 537 538 529 529 529 529 529 530 513 513 513 513 513 513 513 680 673 673 673 666 528 528 528 529 529 528 528 528
530 530 530 530 530 529 529 529 529 529 529 539 516 537 538 513 513 513 513 513 513 513 513 680 681 681 682 528 528 528 529 529 528 528 528
530 530 530 530 530 529 529 529 529 529 529 530 513 513 513 513 520 521 521 521 521 521 521 521 521 521 521 521 528 528 529 529 528 528 528
530 530 530 530 547 521 521 521 521 521 522 530 513 664 665 666 528 544 667 668 668 668 668 668 668 668 668 668 669 528 529 529 528 528 528
530 530 530 547 521 521 521 521 521 522 530 530 664 673 673 674 528 528 672 673 673 673 673 673 673 673 673 673 674 528 529 529 528 528 528
530 530 530 529 529 529 529 529 529 530 530 530 672 673 673 674 528 528 680 681 681 681 681 673 673 673 673 673 624 547 529 529 528 528 528
530 530 530 529 529 529 529 529 529 530 530 530 672 673 673 674 528 536 516 537 537 537 540 672 673 673 673 674 528 529 529 529 528 528 528
530 530 530 529 529 529 539 537 516 538 530 530 680 673 673 673 616 537 516 537 537 540 528 672 673 673 673 674 528 544 521 521 547 528 528
530 530 530 529 529 529 530 539 537 537 538 530 513 680 673 673 673 673 673 682 513 528 528 672 673 673 673 674 528 528 529 529 529 528 528
530 530 530 529 529 529 530 530 539 537 537 538 513 513 680 681 681 681 682 513 513 528 528 672 673 673 624 521 547 528 529 529 544 547 528
530 530 530 529 529 529 530 530 530 513 513 513 513 513 513 513 513 513 513 513 513 528 528 672 673 674 528 529 529 528 529 529 528 529 528
530 530 530 529 529 529 530 530 547 521 521 521 521 521 521 521 521 521 521 521 521 547 528 672 673 674 528 529 529 528 529 529 528 529 528
530 530 530 529 529 529 530 547 521 667 668 668 668 668 668 668 668 668 668 668 668 668 668 670 673 674 528 529 544 547 529 529 528 529 528
530 530 530 529 529 529 530 529 529 672 673 673 673 673 673 673 673 673 673 673 673 673 673 673 673 673 528 529 528 529 544 521 547 529 528
530 530 530 529 529 529 530 529 664 673 673 673 673 673 673 673 673 673 673 673 673 673 673 673 673 673 528 529 528 529 528 529 529 529 528
530 530 530 529 529 529 530 529 672 673 673 673 673 673 673 673 673 673 398 422 422 397 673 673 673 674 528 529 528 529 528 529 529 529 528
530 530 530 529 529 529 547 521 521 521 521 521 521 625 673 673 673 398 423 414 414 421 397 673 673 674 528 529 528 529 528 529 529 529 528
530 530 530 529 529 529 529 529 529 529 529 529 529 530 673 673 673 415 414 414 414 414 413 673 673 674 528 529 528 529 528 529 529 529 528
530 530 547 521 521 521 521 521 521 521 521 521 546 530 673 673 398 423 414 414 414 414 421 397 673 674 528 529 528 529 528 529 529 529 528
530 530 529 529 529 529 529 529 529 529 529 529 530 530 673 673 415 414 414 414 629 414 414 413 673 674 528 529 528 529 528 529 529 529 528
530 547 521 521 521 521 521 521 521 546 529 529 530 547 521 521 521 521 521 600 601 602 521 521 521 521 547 529 528 529 528 529 529 529 528
547 521 546 529 529 529 529 529 529 530 529 529 547 521 521 521 521 521 521 521 521 521 521 521 521 521 521 521 547 529 528 529 529 529 528
529 529 530 529 529 529 529 529 529 547 521 521 521 521 521 521 521 521 521 521 521 521 521 521 521 521 521 521 521 521 547 529 529 529 528
529 529 547 521 521 521 521 521 521 521 521 521 521 521 521 521 521 521 521 521 521 521 521 521 521 521 521 521 521 521 521 521 521 521 547