ShoalCave_LowTideIceRoom_Layout (20x30)
891 905 905 905 905 905 905 905 905 905 905 905 905 905 905 905 892 897 897 897
898 891 905 905 905 905 905 905 905 905 905 905 905 905 892 897 896 897 897 897
898 898 909 909 909 909 894 909 909 894 909 909 909 909 896 897 896 897 897 897
898 898 909 893 909 909 909 909 909 909 909 909 909 893 896 897 896 897 897 897
898 898 909 909 909 909 909 909 909 909 909 893 909 894 896 897 896 897 897 897
898 898 909 909 909 909 655 909 909 909 909 909 909 909 904 892 896 897 897 897
898 898 909 909 909 909 909 894 909 909 909 909 909 909 909 896 896 897 897 897
898 898 909 909 910 911 888 889 889 889 890 911 911 894 893 896 896 897 897 897
898 898 909 909 910 888 899 897 897 897 898 901 901 901 901 896 904 905 905 892
898 898 909 911 901 896 897 897 897 897 898 631 647 647 639 904 905 887 892 896
898 898 909 888 889 899 897 897 897 897 898 901 903 903 901 901 901 895 896 896
898 898 909 896 897 897 897 897 897 897 898 908 909 909 910 901 901 901 896 896
898 898 909 896 897 897 897 894 897 897 898 908 909 909 903 903 903 903 896 896
898 898 909 904 867 905 892 897 897 897 898 908 909 909 909 909 909 909 896 896
898 898 909 655 909 909 896 897 897 897 898 908 909 909 894 909 909 909 896 896
898 898 909 909 909 893 896 897 897 897 899 890 911 911 911 911 911 911 896 896
898 898 893 909 909 909 896 897 897 897 897 899 889 890 901 901 901 901 896 896
898 898 911 911 894 911 896 897 897 894 897 897 893 898 901 901 901 901 896 896
899 899 890 911 901 901 896 897 893 897 897 897 897 899 890 901 901 901 896 896
897 897 898 890 901 901 904 905 892 897 897 897 897 897 898 909 909 909 896 896
897 897 898 898 903 903 903 903 896 897 897 897 897 897 898 909 909 909 896 896
897 897 898 898 909 909 909 909 904 905 892 897 897 897 898 909 909 909 896 896
891 905 906 898 909 893 909 893 908 909 896 897 897 897 898 909 909 909 896 896
898 891 905 906 893 909 909 910 903 909 904 905 905 905 906 911 911 911 896 896
898 898 909 909 909 909 909 909 909 909 909 909 909 910 901 901 901 901 896 896
898 898 909 909 909 909 909 909 655 909 909 909 909 910 901 901 901 901 896 896
898 898 909 909 894 655 909 909 909 909 893 909 655 909 910 901 901 901 896 896
899 899 889 889 890 909 909 894 909 909 909 909 909 909 909 910 901 901 896 896
897 897 897 897 899 889 889 889 889 889 890 909 909 909 909 910 901 901 896 896
897 897 897 897 897 897 897 897 897 897 899 889 889 889 889 889 889 889 899 899