ShoalCave_LowTideLowerRoom_Layout (31x14)
529 529 529 529 539 537 537 537 537 537 537 537 537 537 537 537 537 537 537 537 537 540 529 529 529 529 529 529 529 529 529
529 529 529 529 530 539 537 527 537 537 537 537 537 537 537 537 537 537 537 537 540 536 537 537 537 537 537 537 537 537 540
529 529 529 529 530 530 513 535 513 513 513 513 513 513 513 513 513 513 858 513 536 537 537 537 537 537 537 537 537 540 528
529 529 529 529 530 530 513 513 513 513 513 513 513 513 513 513 513 513 513 513 513 513 513 513 513 513 513 513 513 528 528
539 537 537 537 538 530 513 513 513 513 513 513 513 513 584 593 593 593 593 593 520 521 521 521 521 521 522 513 513 528 528
530 539 537 537 537 538 513 513 513 513 513 513 513 513 569 513 513 513 513 513 528 520 521 521 521 522 530 513 513 528 528
530 530 519 513 513 513 513 513 513 513 513 513 513 513 569 513 513 513 513 513 528 528 529 529 529 530 530 513 513 528 528
530 600 601 602 521 521 521 521 521 521 521 521 521 521 521 521 521 521 522 513 528 528 529 529 529 530 530 513 513 528 528
547 521 521 521 521 521 521 521 521 521 521 521 521 521 521 521 521 546 530 513 528 528 529 529 529 530 530 513 513 528 528
529 529 529 529 529 529 529 529 529 529 529 529 529 529 529 529 529 530 530 513 528 528 529 529 529 530 530 513 513 528 528
529 529 529 529 529 529 529 529 529 529 529 529 529 529 529 529 529 530 530 513 528 528 529 529 529 530 530 513 513 528 528
529 529 529 529 529 529 529 529 529 529 529 529 529 529 529 529 529 530 530 519 528 528 529 529 529 530 530 513 517 528 528
529 529 529 529 529 529 529 529 529 529 529 529 529 529 529 529 529 530 600 601 602 528 529 529 529 530 547 521 521 547 528
529 529 529 529 529 529 529 529 529 529 529 529 529 529 529 529 529 547 521 521 521 547 529 529 529 547 521 521 521 521 547