SkyPillar_Entrance_Layout (18x18)
529 529 539 537 537 537 537 537 537 537 537 537 537 537 537 537 537 540
529 529 530 529 539 537 537 537 537 537 537 537 537 537 537 540 529 528
529 529 530 529 530 513 513 513 513 513 513 513 513 513 513 528 529 528
529 539 538 539 538 513 513 513 513 513 513 513 513 513 513 536 540 528
529 530 529 530 513 513 513 513 513 513 513 513 513 513 519 513 528 528
529 530 529 530 513 513 513 513 513 513 520 521 547 651 652 644 547 528
529 530 529 530 539 537 516 537 540 513 528 529 529 529 544 521 521 547
529 530 539 538 530 513 513 513 536 540 528 544 521 521 547 529 529 529
529 530 530 529 530 513 513 513 513 528 528 528 529 529 529 529 529 529
529 530 530 529 530 513 513 513 513 528 528 528 529 529 529 529 529 529
529 530 530 539 538 513 513 513 513 528 528 528 529 529 529 529 529 529
529 530 530 530 539 537 516 537 540 528 528 528 529 529 529 529 529 529
529 530 530 530 530 513 513 513 528 528 528 528 529 529 529 529 529 529
529 530 530 530 530 513 513 513 528 528 528 528 529 529 529 529 529 529
529 530 530 530 530 513 513 513 528 528 528 528 529 529 529 529 529 529
529 530 530 530 530 513 513 513 528 528 528 528 529 529 529 529 529 529
529 530 530 530 530 513 519 513 528 528 528 528 529 529 529 529 529 529
529 547 547 547 547 651 652 644 547 547 547 547 529 529 529 529 529 529