SkyPillar_4F_Layout (14x14)
551 551 571 572 573 551 571 572 573 551 571 572 573 551
559 559 579 580 581 559 579 588 581 559 579 588 581 559
565 565 565 565 565 565 565 565 519 565 565 565 565 565
566 566 527 543 543 543 527 543 543 527 564 564 564 527
535 543 564 564 566 564 566 566 564 566 527 564 564 564
564 527 564 564 568 569 569 569 569 570 564 566 566 566
564 564 564 564 576 577 577 577 577 578 564 566 566 566
564 566 543 566 577 577 577 577 577 577 564 566 527 564
564 566 527 566 577 577 577 577 577 577 564 564 564 527
543 566 527 566 577 577 577 577 577 577 564 564 564 564
543 566 564 564 585 589 589 589 589 586 564 564 564 564
564 564 564 566 564 527 564 566 564 527 566 566 564 564
564 564 527 564 566 564 566 564 566 564 566 566 564 564
564 564 564 566 564 566 564 527 564 566 566 566 564 564