SkyPillar_Outside_Layout (28x23)
368 368 368 368 368 368 368 368 368 368 370 695 672 673 674 675 676 695 695 695 372 368 368 368 368 368 368 368
368 368 368 368 368 368 368 368 370 695 695 289 672 674 674 674 676 699 226 289 695 695 695 372 368 368 368 368
368 368 368 368 368 368 370 695 695 289 289 289 672 673 674 675 676 698 699 289 289 289 289 117 371 372 368 368
368 368 368 368 368 370 115 289 289 289 226 289 672 674 674 674 676 698 698 699 289 226 289 117 113 117 372 368
368 368 368 368 370 115 115 289 289 289 289 289 680 681 682 683 684 698 698 700 699 289 289 117 113 117 117 377
368 368 368 376 115 115 115 289 289 289 226 226 688 689 690 691 692 700 698 698 698 699 289 117 113 117 117 400
368 368 368 402 115 115 123 137 289 226 292 292 678 697 698 698 698 698 700 700 698 698 699 117 113 117 117 400
368 368 368 402 115 115 113 115 226 292 292 292 292 678 697 698 698 698 698 698 700 698 698 117 116 125 117 400
368 368 368 402 115 123 137 115 292 292 292 292 292 292 678 697 698 698 698 698 698 700 116 125 117 113 117 400
368 368 368 402 123 137 115 115 292 292 292 292 292 292 292 678 693 677 677 696 700 698 117 113 117 113 117 400
368 368 368 410 385 115 115 123 137 292 292 292 292 292 292 128 190 113 113 117 696 698 117 113 117 113 117 400
368 368 368 368 402 115 115 113 115 292 292 292 292 292 128 115 113 113 113 117 138 698 117 113 117 116 125 400
368 368 368 368 402 115 123 137 123 137 292 292 292 292 136 123 124 100 124 125 138 698 117 116 125 117 113 400
368 368 336 337 402 123 137 123 137 123 137 292 292 292 144 169 169 167 169 169 146 116 125 117 116 125 384 408
368 368 344 345 410 385 123 137 123 137 123 137 292 292 292 292 292 292 226 292 292 117 116 125 117 384 408 368
368 368 368 368 368 410 385 123 137 123 137 115 292 292 292 292 292 292 292 292 116 125 117 116 125 400 368 368
336 337 368 368 368 368 410 385 115 113 115 123 137 292 292 292 226 292 116 124 125 113 117 117 384 408 368 368
344 345 368 368 368 368 336 357 115 113 123 137 123 137 226 292 292 116 125 113 116 124 125 117 400 368 336 337
368 368 368 368 368 368 344 365 123 137 113 123 137 123 124 124 124 125 113 116 125 116 124 125 400 368 344 345
368 368 368 368 336 337 368 410 385 123 137 113 123 169 169 159 169 169 124 125 113 117 384 393 408 368 368 368
368 368 368 368 344 345 368 368 410 385 123 124 169 169 169 167 169 169 169 169 124 125 400 368 368 368 368 368
368 368 368 368 368 336 337 368 368 410 393 393 385 292 292 292 292 292 384 393 346 347 408 368 368 368 368 368
368 368 368 368 368 344 345 368 368 368 368 368 402 292 292 292 292 292 400 368 344 345 373 379 379 379 372 368