SkyPillar_2F_Layout (14x14)
551 551 571 572 573 551 551 551 551 571 572 573 551 551
559 559 579 580 581 559 559 559 559 579 588 581 559 559
565 565 565 565 565 565 565 565 535 565 565 565 565 565
564 564 564 564 564 543 564 527 527 564 564 564 564 564
564 564 564 564 564 564 527 564 564 564 543 564 564 564
564 564 564 564 568 569 569 569 569 570 566 566 566 566
543 543 564 564 576 577 577 577 577 578 566 566 566 566
564 564 566 566 577 577 577 577 577 577 564 564 564 543
566 566 566 566 577 577 577 577 577 577 564 564 564 564
566 566 566 566 577 577 577 577 577 577 564 564 564 564
566 566 564 564 585 589 589 589 589 586 566 566 564 564
566 564 564 543 566 566 564 564 564 543 566 566 566 566
564 564 543 564 566 566 564 564 564 564 566 566 566 566
564 564 564 566 566 566 564 564 564 564 564 564 564 543