SkyPillar_3F_Layout (14x14)
551 551 571 572 573 551 571 572 573 551 571 572 573 551
559 559 579 588 581 559 579 580 581 559 579 580 581 559
702 702 702 702 535 702 702 702 702 702 535 702 702 702
701 701 701 701 701 543 701 701 701 527 701 701 701 701
701 543 701 701 701 527 701 701 543 701 701 701 701 701
543 701 701 701 568 569 569 569 569 570 701 701 701 701
701 701 701 527 576 577 577 577 577 578 543 701 701 701
701 701 543 701 577 577 577 577 577 577 701 701 701 701
701 701 543 701 577 577 577 577 577 577 701 701 701 527
701 701 701 701 577 577 577 577 577 577 527 701 701 701
701 701 701 701 585 589 589 589 589 586 701 543 701 701
527 701 701 701 701 543 701 701 701 543 701 701 701 701
701 527 701 701 701 701 701 701 701 701 701 701 701 701
701 701 701 701 701 701 701 543 701 701 701 701 527 701