SkyPillar_Top_Layout (27x24)
209 209 209 209 209 209 209 209 209 209 209 209 209 209 209 209 209 209 209 209 209 209 209 209 209 209 209
209 209 209 209 209 209 209 209 209 209 209 209 209 209 209 209 209 209 209 209 209 209 209 209 209 209 209
209 209 209 209 209 209 209 209 209 209 209 209 209 209 209 209 209 209 209 209 209 209 209 209 209 209 209
612 612 612 612 612 612 612 612 612 612 612 685 612 612 612 612 612 686 612 686 612 612 612 612 612 612 612
564 564 564 564 564 564 543 564 567 543 527 564 564 564 564 564 564 527 543 564 564 564 527 564 564 564 564
564 564 564 564 564 564 564 564 543 564 564 564 564 564 564 564 564 564 564 543 564 564 564 564 564 564 564
564 564 564 564 527 564 564 527 564 564 564 564 564 564 564 564 564 564 564 564 527 564 543 564 564 564 564
564 564 564 564 564 564 543 564 543 564 564 564 564 564 564 564 564 564 564 527 564 564 564 564 564 564 564
564 564 564 564 564 564 527 564 564 564 543 564 564 564 564 564 564 564 543 564 527 564 567 564 564 564 564
564 564 564 527 564 564 564 543 564 564 564 564 564 564 564 564 564 564 564 564 543 564 564 543 564 564 564
564 564 564 564 564 564 527 567 543 564 564 564 564 564 564 564 543 564 564 543 564 564 564 564 564 564 564
564 564 564 564 564 564 564 543 564 543 564 564 564 564 564 564 564 564 527 564 567 564 564 564 564 564 564
564 564 564 564 564 543 564 564 567 527 564 564 564 564 564 564 564 543 564 567 564 564 564 564 564 564 564
551 551 551 551 551 551 551 551 551 551 621 669 670 622 551 571 572 573 551 551 551 551 551 551 551 551 551
559 559 559 559 559 559 559 559 559 559 618 669 670 619 559 579 588 581 559 559 559 559 559 559 559 559 559
565 565 565 565 565 565 565 535 565 565 565 565 565 565 565 565 565 565 519 565 565 535 565 565 565 565 565
564 564 543 564 564 564 543 564 564 564 564 564 564 564 564 564 564 564 564 527 564 564 564 564 543 564 564
564 564 564 564 543 564 564 527 564 564 564 564 564 564 564 564 564 527 543 564 564 543 564 564 564 564 564
603 603 603 603 603 603 603 603 603 603 603 603 603 603 603 603 603 603 603 603 603 603 603 603 603 603 603
674 674 674 674 674 674 674 674 674 674 674 674 674 674 674 674 674 674 674 674 674 674 674 674 674 674 674
674 674 674 674 674 674 674 674 674 674 674 674 674 674 674 674 674 674 674 674 674 674 674 674 674 674 674
674 674 674 674 674 674 674 674 674 674 674 674 674 674 674 674 674 674 674 674 674 674 674 674 674 674 674
674 674 674 674 674 674 674 674 674 674 674 674 674 674 674 674 674 674 674 674 674 674 674 674 674 674 674
674 674 674 674 674 674 674 674 674 674 674 674 674 674 674 674 674 674 674 674 674 674 674 674 674 674 674