SlateportCity_Layout (40x60)
199 198 198 198 198 198 198 198 198 198 198 198 198 198 199 14 1 1 1 1 199 199 199 199 199 199 199 199 199 199 199 199 199 199 199 199 400 368 368 368
198 198 198 198 198 198 198 198 198 198 198 198 198 198 198 198 1 1 1 1 22 199 199 199 199 199 199 199 199 199 199 199 199 199 199 199 400 368 368 368
199 198 198 198 198 198 198 198 198 198 198 198 198 198 198 22 1 1 1 1 1 22 198 199 199 199 199 199 199 199 199 199 199 199 199 199 400 368 368 368
22 198 198 198 198 198 198 198 198 198 198 198 198 198 198 321 1 1 1 1 1 313 199 199 199 199 199 199 199 199 199 199 199 199 199 199 400 368 368 368
394 198 198 198 198 198 198 198 198 198 198 198 198 198 198 322 1 1 1 1 1 320 199 199 199 199 199 199 199 199 199 199 199 199 199 199 400 368 368 368
402 198 198 198 198 198 198 198 198 198 198 198 198 198 22 322 1 1 1 1 1 320 22 198 199 199 199 199 199 199 199 199 199 199 199 199 400 368 336 337
402 198 198 198 198 198 198 198 198 198 198 198 198 22 1 322 1 1 1 1 1 320 1 22 199 199 199 199 199 199 199 199 199 199 199 199 356 337 344 345
402 198 198 22 22 22 22 22 22 22 22 22 22 1 1 322 624 625 625 625 626 320 1 1 22 661 662 662 662 662 662 663 199 199 199 199 364 345 368 368
402 198 198 321 329 329 329 329 773 774 774 774 775 329 329 330 632 633 633 633 634 328 329 329 329 669 670 670 670 670 670 671 22 22 22 22 400 368 368 368
402 22 198 322 1 1 1 1 781 782 782 782 783 1 1 1 611 1 1 1 612 1 1 1 1 669 670 670 670 670 670 671 393 393 393 393 408 368 368 368
410 394 198 322 1 1 1 579 789 790 790 790 791 579 1 1 1 520 521 522 1 1 1 1 1 677 678 678 678 678 678 679 368 368 368 368 368 368 368 368
368 402 198 322 1 1 1 579 797 798 467 799 764 579 1 1 1 528 529 530 1 1 1 1 1 685 616 701 702 703 617 687 368 368 368 368 368 368 368 368
368 402 22 322 1 1 1 579 805 806 475 807 772 579 1 1 1 528 529 530 1 1 1 1 3 693 694 709 710 727 694 695 2 377 368 368 368 368 368 368
368 410 394 322 1 1 1 3 520 521 521 521 521 521 521 521 521 562 529 563 521 521 521 521 521 521 521 521 521 522 1 1 1 2 2 2 2 2 377 368
368 368 402 322 1 1 1 1 528 562 529 563 529 529 529 529 529 529 529 529 529 529 529 529 529 529 529 529 529 530 1 1 1 1 1 1 1 1 400 368
368 368 402 322 1 1 1 1 536 570 529 571 537 537 537 537 537 537 537 537 537 537 537 537 537 537 537 537 537 538 1 1 1 1 1 1 1 1 356 337
368 368 402 322 704 705 705 706 1 528 529 530 1 1 1 1 1 1 72 73 74 75 1 1 1 1 1 1 1 1 1 1 78 78 78 78 78 78 364 345
368 368 402 322 712 713 713 714 1 528 529 530 1 1 1 1 1 1 80 81 82 83 1 1 1 1 1 1 1 1 1 1 392 393 393 346 347 393 408 368
368 376 211 322 720 724 721 722 1 528 529 530 1 1 1 1 1 1 88 89 90 91 313 1 1 392 393 393 393 393 393 393 408 336 337 344 345 368 368 368
368 402 1 322 32 732 19 34 3 528 529 530 1 1 1 1 1 1 96 97 98 99 320 392 393 408 368 368 368 368 368 368 368 344 345 368 368 368 368 368
368 402 1 322 1 520 521 521 521 562 529 563 521 521 521 521 521 521 521 522 1 1 320 400 368 368 368 368 368 368 368 368 368 368 336 337 368 368 368 368
376 321 329 330 1 536 537 537 537 570 529 571 537 537 537 537 537 570 529 530 1 1 320 400 368 368 368 368 368 368 368 368 368 368 344 345 368 368 368 368
402 322 608 609 609 609 610 1 1 528 529 530 1 1 1 1 3 528 529 530 1 1 320 400 368 376 597 581 776 777 778 778 779 780 581 589 377 368 368 368
402 322 576 577 577 577 578 1 1 528 529 530 40 41 41 43 1 528 529 530 1 1 320 400 376 597 734 844 784 785 786 763 787 788 844 733 589 377 368 368
402 322 584 585 585 585 586 1 1 528 529 530 48 49 50 51 1 528 529 530 1 1 320 400 402 564 845 1 792 793 794 771 795 796 1 843 572 400 368 368
402 322 592 593 594 595 596 1 1 528 529 530 56 57 58 59 1 528 529 530 1 1 320 400 402 711 1 579 800 801 802 802 803 804 579 1 719 400 368 368
402 322 600 601 602 603 604 1 3 528 529 530 96 65 66 67 1 528 529 563 521 521 581 581 581 837 3 579 808 809 810 810 811 812 579 1 719 400 368 368
402 322 1 580 587 588 521 521 521 562 529 563 521 521 521 521 521 562 529 529 529 529 514 514 514 837 1 1 816 817 818 818 819 820 1 1 719 400 368 368
402 322 1 536 537 537 537 537 537 570 529 571 537 537 537 537 537 570 529 529 529 529 514 514 514 514 829 1 1 1 1 1 1 1 1 827 572 400 368 368
402 322 1 1 1 1 1 1 1 528 529 530 1 1 1 1 1 528 529 571 537 537 605 605 605 514 726 828 828 828 828 828 828 828 828 725 572 400 368 368
402 322 1 1 1 1 1 1 624 534 534 534 626 1 1 1 1 528 529 530 1 1 320 392 393 766 605 605 605 605 605 605 605 605 605 605 767 400 368 368
402 322 4 1 4 1 4 1 632 542 542 542 634 1 4 1 1 528 529 530 1 1 320 400 368 393 393 393 393 393 393 393 393 393 393 393 393 408 368 368
402 322 329 329 329 329 329 329 611 646 645 647 612 329 314 4 1 528 529 530 1 1 320 400 656 659 657 657 657 657 659 658 368 368 368 368 368 368 368 368
402 322 520 521 521 521 521 521 521 562 529 563 521 522 322 1 1 528 529 530 1 1 320 2 664 667 665 665 665 665 667 666 2 2 2 2 212 377 368 368
402 322 528 529 529 529 529 529 529 529 529 529 529 530 322 4 1 528 529 530 1 1 328 329 768 769 769 769 769 769 769 770 691 691 329 329 313 400 368 368
402 322 528 529 529 540 524 529 529 529 529 529 529 530 322 1 1 528 529 530 1 544 545 546 768 769 769 769 769 769 769 770 676 676 1 1 320 400 368 368
402 322 528 539 524 539 531 523 529 529 529 531 539 530 322 4 1 528 529 530 1 552 553 554 672 673 673 673 683 673 683 674 1 1 1 1 320 400 368 368
402 322 528 540 539 555 523 529 529 529 529 532 539 530 322 1 1 528 529 530 1 1 1 1 680 681 684 681 681 681 681 682 668 668 1 1 320 212 377 368
402 322 528 529 547 524 529 529 529 529 529 531 555 530 322 4 1 528 529 530 1 1 1 3 688 689 692 689 689 689 689 690 676 676 1 1 320 1 400 368
402 322 528 529 524 524 529 529 529 529 529 529 523 530 322 1 1 528 529 530 1 1 1 1 1 1 1 1 1 1 1 1 1 1 1 1 320 1 400 368
402 322 528 529 529 529 529 529 529 529 529 571 529 530 322 4 1 528 529 530 1 1 1 1 1 1 1 1 1 1 1 1 1 613 614 615 320 1 400 368
402 322 517 525 526 527 551 529 529 529 549 525 527 519 322 1 1 528 529 530 704 705 705 706 704 705 705 705 705 706 1 1 1 621 622 623 320 1 400 368
402 322 565 760 761 762 559 529 529 529 557 760 762 567 322 4 1 528 529 530 712 713 713 714 712 713 713 713 713 714 1 1 1 1 1 1 320 1 400 368
402 322 573 539 539 645 620 529 529 529 619 654 654 575 322 1 1 528 529 530 720 724 721 722 720 721 715 721 715 722 1 1 544 545 546 1 320 392 408 368
402 322 528 524 529 529 529 529 529 529 529 529 524 530 322 4 1 528 529 530 32 732 19 34 32 19 20 19 20 34 1 1 552 553 554 1 320 400 368 368
402 322 517 525 526 527 551 529 529 529 549 525 527 519 322 1 1 528 529 563 521 521 521 522 1 1 1 1 1 1 1 1 312 329 329 329 306 400 368 368
402 322 565 760 761 762 559 529 529 529 557 760 762 567 322 4 1 528 529 571 537 537 537 538 1 1 1 1 1 1 1 1 320 392 393 393 393 408 368 368
402 322 573 653 645 645 620 529 529 529 619 645 523 575 322 1 1 528 529 530 329 329 329 329 329 329 329 329 329 329 329 329 306 400 368 368 368 368 368 368
402 322 528 529 529 529 529 529 529 529 529 529 529 530 322 4 1 528 529 530 69 392 393 393 393 393 393 393 393 393 393 393 393 408 368 368 368 368 368 368
402 322 517 525 526 527 551 529 529 529 549 525 527 519 322 1 1 528 529 530 69 400 368 368 368 368 368 368 368 368 368 368 368 368 368 368 368 368 368 368
402 322 565 760 761 762 559 529 529 529 557 760 762 567 307 4 1 528 529 530 69 400 368 368 368 368 368 376 597 581 581 581 581 581 581 581 581 589 377 368
402 322 573 653 653 645 620 529 529 529 619 645 540 620 3 521 521 562 529 631 581 581 581 581 581 581 581 581 514 514 734 844 582 583 844 733 514 572 377 368
402 322 528 539 529 529 529 529 529 529 529 529 529 529 529 529 529 529 529 631 514 514 514 514 514 514 514 514 514 514 837 1 590 591 1 835 514 572 377 368
402 322 528 555 539 529 529 529 529 529 529 529 529 529 571 537 537 570 529 631 514 514 514 514 514 514 514 514 514 514 837 1 598 599 1 835 514 572 377 368
402 322 528 529 529 529 529 529 523 540 532 529 529 529 530 1 1 528 529 530 71 696 697 697 697 697 697 698 564 514 837 1 606 607 1 835 514 572 639 285
402 307 536 537 537 537 537 537 537 555 555 539 529 540 530 1 1 528 529 530 71 708 292 292 292 292 292 700 564 514 726 828 828 828 828 725 514 572 708 293
637 699 638 697 697 697 697 698 69 536 537 537 537 537 538 1 1 528 529 530 71 708 292 292 292 292 292 629 697 697 698 564 514 514 572 696 697 697 630 293
368 368 299 338 339 325 292 629 697 697 697 697 697 697 697 698 69 528 529 530 71 708 292 292 292 292 292 292 292 292 700 564 514 514 572 708 326 338 339 301
368 336 337 344 345 299 300 325 292 292 292 292 292 292 292 629 697 175 207 207 697 630 292 292 292 292 292 292 292 292 629 697 175 207 697 630 293 344 345 368
368 344 345 368 368 368 368 291 292 292 292 292 292 292 292 292 292 292 292 292 292 292 292 292 292 292 292 292 292 292 292 292 292 292 292 292 293 368 336 337