SlateportCity_PokemonFanClub_Layout (14x11)
529 529 532 529 530 529 530 529 530 529 529 532 529 529
576 577 540 580 541 541 537 538 541 541 581 540 578 579
584 585 548 588 546 545 546 545 546 545 589 549 586 587
516 518 514 513 514 513 514 513 514 513 514 513 517 518
516 513 552 553 553 592 593 593 594 595 553 554 514 513
516 513 560 561 561 600 601 601 602 603 561 562 514 513
516 513 560 558 567 608 609 609 610 564 557 575 514 513
516 513 560 566 564 604 605 606 607 564 565 571 514 513
516 513 568 574 572 612 613 614 615 572 573 570 514 513
582 513 514 513 514 513 514 513 514 513 514 513 514 583
590 513 514 513 514 513 6 7 514 513 514 513 514 591