SlateportCity_OceanicMuseum_2F_Layout (20x9)
516 516 516 516 516 609 519 611 520 521 549 516 534 535 516 520 521 516 520 521
524 524 524 524 524 610 527 612 528 529 549 524 542 543 524 528 529 524 528 529
514 514 589 590 590 591 514 514 536 537 557 514 514 514 514 536 537 514 536 537
579 513 568 569 576 556 579 513 513 513 565 579 595 596 513 595 596 513 544 513
579 513 562 563 563 564 579 513 513 513 515 587 603 604 513 603 604 513 552 579
579 513 581 582 582 583 587 513 513 513 513 513 515 515 513 515 515 513 515 587
579 513 554 560 561 556 579 513 513 513 513 513 513 593 594 513 513 513 544 513
579 513 562 563 563 564 579 513 513 513 513 513 513 601 602 579 513 513 552 579
579 513 515 515 515 515 587 513 513 513 513 513 513 515 515 587 513 513 515 587