SlateportCity_OceanicMuseum_1F_Layout (20x9)
516 516 530 531 517 605 518 599 516 550 551 516 550 551 516 516 532 533 516 516
524 524 538 539 525 606 526 607 524 558 559 524 558 559 524 524 540 541 524 524
514 514 514 514 514 514 514 514 514 566 567 514 566 567 514 514 514 514 514 514
514 513 544 513 513 513 513 513 513 513 513 513 513 513 513 545 513 513 545 513
514 513 552 579 513 513 513 513 513 513 513 513 513 513 513 553 579 513 553 579
514 513 515 587 513 546 547 547 548 513 513 546 547 547 548 515 587 513 515 587
514 513 544 513 513 597 584 585 598 579 513 597 585 563 598 579 513 513 545 513
514 513 552 579 513 574 580 515 574 579 513 574 580 515 574 579 513 513 553 579
514 513 515 587 513 608 579 513 608 522 523 608 579 513 608 579 513 513 515 587