SlateportCity_SternsShipyard_2F_Layout (17x15)
537 537 707 708 709 537 540 539 537 536 537 537 540 537 536 537 537
545 545 715 716 717 545 548 547 545 544 545 545 548 545 544 545 545
516 516 694 516 695 516 516 516 516 530 516 516 516 516 530 516 516
514 514 514 514 514 514 514 514 514 524 525 541 514 524 525 541 514
576 578 577 578 514 514 514 514 541 532 533 514 541 532 533 514 514
584 586 585 586 514 514 514 514 592 593 593 593 593 593 593 594 514
514 541 514 541 514 514 514 541 608 611 612 571 572 573 574 653 514
577 578 576 578 514 514 514 541 608 619 620 579 580 581 582 653 514
585 586 584 586 514 514 514 514 608 553 553 587 588 589 590 653 514
541 514 514 541 514 514 514 541 608 553 821 553 597 598 553 653 514
577 578 576 578 514 514 514 514 608 552 599 552 554 554 821 653 514
585 586 584 586 514 514 514 517 608 552 599 552 552 552 599 653 514
514 541 514 541 514 514 514 514 616 617 663 617 617 617 663 618 514
514 514 514 514 514 514 514 514 516 516 516 549 549 516 516 516 514
514 514 514 514 514 514 514 514 514 514 514 514 514 514 514 514 514