SlateportCity_SternsShipyard_1F_Layout (21x15)
537 537 691 692 693 537 529 537 537 537 537 537 536 539 537 540 537 538 537 537 538
526 527 699 700 701 545 522 545 560 561 562 545 544 547 545 548 545 546 545 545 546
534 535 694 516 695 516 522 553 568 569 570 553 531 553 553 553 553 553 553 553 553
516 516 514 514 514 514 521 523 523 523 523 523 523 523 523 550 553 553 553 553 543
577 578 514 514 514 514 529 575 725 726 727 720 721 722 723 528 553 553 553 543 551
585 586 514 514 514 541 522 583 548 603 604 563 564 565 566 544 553 553 553 551 551
514 541 514 514 524 525 521 591 553 611 612 571 572 573 574 531 553 553 553 559 567
577 578 514 514 532 533 528 553 553 619 620 579 580 581 582 553 553 553 553 553 553
585 586 514 514 541 514 544 553 553 553 553 587 588 589 590 553 553 553 553 553 553
541 514 514 514 514 514 530 553 553 553 821 553 597 598 553 553 553 553 553 553 553
577 578 514 514 514 514 520 553 553 552 607 552 554 554 821 553 553 553 553 553 543
585 586 514 514 514 514 529 543 553 552 607 552 552 552 607 553 553 553 543 543 551
514 541 514 514 514 514 522 551 543 552 599 552 552 552 599 553 553 553 551 551 551
514 514 514 514 514 514 522 559 551 543 552 552 552 552 552 553 553 553 559 559 567
514 514 518 519 514 514 522 567 567 559 553 553 553 553 553 553 553 553 553 553 553