SootopolisCity_House8_Layout (8x7)
712 713 600 517 517 600 517 517
686 687 608 1016 1016 608 660 660
728 729 1023 1023 1023 1023 668 668
1023 1022 1022 1011 1012 1022 1022 1022
1023 1022 733 1019 1020 734 1022 1022
1023 1022 1022 1022 1022 1022 1022 1022
1023 1022 1022 520 521 1022 1022 1022