SootopolisCity_House2_Layout (8x7)
1008 712 713 1008 1008 1010 1008 1008
660 630 631 717 1016 1018 1016 660
668 728 729 725 1023 1023 1023 668
1023 1022 1022 733 1011 1012 734 1022
1023 1022 1022 1022 1019 1020 734 1022
1023 1022 1022 1022 1022 1022 1022 1022
1023 1022 1022 520 521 1022 1022 1022