SootopolisCity_Layout (60x60)
729 729 729 729 729 729 729 730 729 729 723 737 737 737 738 730 729 730 729 729 729 729 729 729 729 723 737 737 569 737 737 737 737 737 724 736 724 736 724 729 729 729 729 729 736 737 737 737 737 737 737 737 569 737 724 729 729 729 729 729
729 729 729 729 723 737 737 738 729 729 730 729 723 737 737 738 723 738 729 729 723 737 737 569 737 738 723 520 528 536 587 588 589 724 736 724 736 724 736 737 737 737 737 737 737 737 737 737 737 737 737 520 528 515 736 569 737 737 724 729
729 723 737 737 738 729 723 737 737 569 738 729 730 729 729 729 730 729 729 729 730 723 520 528 536 737 738 521 522 523 525 526 527 728 729 736 724 736 737 737 737 737 724 729 729 729 729 729 729 729 729 521 522 523 520 528 536 724 728 729
737 738 729 729 723 737 738 729 513 514 536 737 738 723 737 737 738 729 729 729 730 730 521 522 523 729 729 529 530 531 549 567 551 728 729 729 736 724 729 729 729 729 736 737 587 588 589 729 729 729 729 529 530 531 521 522 523 728 736 737
729 729 723 737 738 729 723 737 521 522 523 597 729 730 723 737 737 737 737 737 738 730 529 516 531 729 729 537 538 539 557 575 559 736 724 729 729 736 724 576 577 577 577 578 525 526 602 724 729 729 729 537 538 539 529 516 531 736 737 724
737 737 738 729 729 723 738 729 547 532 548 607 723 738 730 729 729 729 729 729 729 730 537 524 539 729 729 729 729 729 729 729 729 729 736 737 724 729 736 737 724 729 729 729 533 534 535 736 724 729 729 729 729 729 537 524 539 729 729 728
729 723 587 588 589 738 729 729 555 540 556 607 730 723 738 729 729 723 737 580 581 738 729 729 729 729 729 729 729 729 729 729 729 729 729 729 728 729 729 729 728 729 729 729 541 542 543 729 728 576 577 577 577 577 577 577 577 578 729 736
723 738 525 526 527 576 577 577 582 729 583 604 730 730 729 729 729 730 729 729 729 729 729 729 729 729 576 577 582 729 729 583 577 577 577 578 736 724 729 729 736 737 737 737 737 580 737 724 736 737 737 737 737 737 737 737 737 724 729 729
738 729 549 566 551 729 723 737 610 580 611 737 738 730 729 729 729 730 729 729 729 729 729 729 729 729 723 737 610 580 581 611 737 737 737 737 724 736 737 737 737 737 724 729 729 729 729 736 737 737 737 737 737 569 737 737 724 728 729 729
729 729 557 574 559 729 730 729 723 580 737 737 737 738 729 729 729 730 723 737 737 737 737 737 737 737 738 729 729 729 729 729 729 729 729 729 736 737 737 737 724 729 736 737 737 580 737 737 737 737 737 737 520 528 536 724 728 736 737 724
577 577 577 577 577 578 730 729 730 729 729 729 729 729 729 729 729 730 730 729 729 723 737 737 737 737 737 737 737 737 737 737 737 737 580 581 737 737 737 724 736 724 729 729 723 580 737 737 737 737 737 724 521 522 523 728 736 737 724 736
737 737 737 737 737 737 738 723 738 723 737 737 737 737 737 580 581 738 730 723 737 738 723 737 737 737 737 737 737 737 737 737 737 737 580 581 737 737 724 728 729 728 729 729 730 729 729 729 729 729 729 728 529 516 531 728 729 729 728 729
729 729 723 737 737 737 737 738 723 738 729 729 729 729 729 729 729 723 738 730 723 737 738 729 723 737 737 737 737 737 737 737 737 737 580 581 724 729 728 736 724 736 737 737 738 729 729 729 729 729 729 728 537 524 539 728 729 729 736 737
737 737 738 729 723 737 737 737 738 568 729 723 737 737 737 580 581 738 729 730 730 723 737 737 738 729 729 729 729 729 729 729 729 729 729 729 736 724 736 724 736 737 737 737 569 737 737 724 729 729 729 736 724 729 729 736 737 724 729 729
729 729 729 729 730 729 723 737 520 528 536 738 729 729 729 729 729 729 723 738 730 730 576 577 582 729 729 583 577 577 577 577 577 577 577 577 578 736 724 736 737 737 737 520 528 536 724 728 729 729 729 729 728 729 729 729 729 736 737 724
729 723 737 737 738 729 730 596 521 522 523 578 729 729 729 729 729 729 730 729 730 730 729 723 610 580 581 611 737 593 594 603 594 595 737 724 729 729 736 737 724 596 577 521 522 523 728 728 729 729 729 729 728 729 568 729 729 729 729 736
729 571 729 729 729 729 730 606 547 532 548 729 729 729 723 737 580 581 738 729 730 730 729 730 729 729 729 729 723 544 737 545 737 546 724 736 737 737 724 729 728 606 729 547 532 548 728 728 729 729 729 729 736 520 528 536 737 737 737 724
520 528 515 729 729 729 730 606 555 540 556 729 729 729 730 723 580 581 737 737 738 730 729 730 729 729 729 729 730 552 553 553 553 554 755 729 729 729 736 724 728 606 729 555 540 556 728 736 724 729 729 729 729 521 522 523 517 518 519 736
521 522 523 723 587 588 589 606 729 729 729 729 729 729 730 730 729 729 729 729 729 730 723 738 622 729 729 623 730 560 113 113 113 562 755 729 729 729 729 728 728 606 729 729 729 729 728 729 736 580 581 737 724 529 530 531 525 526 527 729
529 530 531 730 525 526 527 606 729 729 729 729 729 729 730 730 729 729 729 729 729 730 730 723 610 580 581 611 765 113 640 113 640 113 763 737 724 729 729 728 728 606 729 729 729 729 736 737 737 580 581 724 728 537 538 539 549 567 551 729
537 538 539 730 549 567 551 605 577 577 577 578 729 729 730 730 729 729 723 737 580 738 730 730 113 113 113 113 113 113 640 113 640 113 113 113 763 737 724 728 728 606 729 729 729 729 729 729 729 729 729 728 736 737 737 724 557 575 559 729
577 577 578 730 557 575 559 729 723 737 737 737 580 581 738 730 729 729 730 723 580 737 738 730 113 113 113 113 113 113 113 113 113 113 113 113 113 113 718 728 728 605 577 578 729 729 729 729 729 729 729 728 729 729 729 736 737 737 737 724
737 737 737 738 723 737 737 737 738 729 729 729 729 729 729 730 729 729 730 730 729 729 729 730 113 113 113 113 113 113 113 113 113 113 113 113 113 113 718 728 736 737 737 737 580 581 737 587 588 589 724 736 737 737 724 729 729 729 729 736
729 729 723 737 738 729 723 737 587 588 589 737 580 581 737 738 723 737 738 730 729 729 729 730 113 113 116 124 124 124 124 124 124 124 124 124 124 137 718 736 737 724 596 578 729 729 729 525 526 527 728 729 729 729 736 724 729 729 729 729
737 587 588 519 729 729 730 596 601 526 602 578 729 729 723 737 738 723 737 738 723 580 581 717 116 121 125 195 177 177 177 177 177 177 177 177 196 115 726 737 724 728 606 729 729 729 729 533 534 535 728 729 729 729 729 728 729 729 729 729
729 525 526 527 729 729 730 606 533 534 535 729 729 729 730 723 737 738 729 729 730 113 113 116 125 195 177 192 633 633 633 633 633 633 633 633 186 123 121 137 755 728 606 729 729 729 729 541 542 543 728 729 517 518 519 736 724 729 729 729
729 549 566 551 729 729 730 606 541 542 543 729 729 729 730 730 619 620 620 621 730 113 113 117 195 192 633 633 633 633 633 633 633 633 633 633 194 177 196 115 755 728 606 729 729 729 729 729 729 729 736 724 525 526 527 729 728 729 729 729
729 557 574 559 729 729 730 606 729 729 729 729 729 729 730 730 48 49 50 51 730 113 113 117 184 633 633 633 633 633 633 633 633 633 633 633 633 633 186 115 755 728 605 577 577 578 729 729 729 729 729 728 533 534 535 729 736 724 729 729
577 577 577 577 578 723 738 605 577 577 577 577 578 723 738 730 56 57 58 59 730 113 113 117 184 633 633 633 642 643 643 643 643 644 633 633 633 633 186 115 755 736 635 636 637 638 724 729 729 729 729 728 541 542 543 729 729 728 729 729
729 729 723 737 737 738 723 737 737 737 737 737 737 738 723 738 639 65 66 631 730 113 113 117 184 633 633 203 650 651 651 651 651 652 204 633 633 633 186 115 755 596 80 81 82 83 728 729 729 729 729 736 737 580 724 729 729 736 724 729
729 723 738 729 723 737 738 729 729 729 723 737 737 737 738 729 729 729 729 729 730 113 113 117 184 633 633 186 440 441 442 435 443 444 184 633 633 633 186 115 755 606 88 89 90 91 728 729 729 729 729 729 729 729 728 729 729 729 728 729
729 730 729 729 730 729 729 729 729 729 730 729 729 729 729 729 729 729 729 723 765 113 113 117 184 633 633 186 448 449 450 453 451 452 184 633 633 633 186 115 755 606 639 97 98 630 736 737 580 581 724 729 729 729 736 737 737 724 736 724
723 738 729 729 730 723 737 587 588 589 738 729 729 729 729 729 723 580 581 765 113 113 113 117 184 633 203 211 456 457 458 461 459 460 212 204 633 633 186 115 755 606 729 729 729 729 729 729 729 729 728 729 729 729 585 737 724 728 729 728
738 729 729 723 738 730 596 601 526 602 578 729 729 729 729 723 765 113 113 113 113 113 113 117 184 633 186 1 1 1 1 1 304 1 1 184 633 633 186 115 755 606 729 729 729 729 729 729 729 729 736 737 737 520 528 515 728 728 729 728
729 729 729 730 729 730 606 533 534 535 729 729 729 729 723 765 113 113 113 113 113 113 116 125 184 633 186 1 1 1 1 1 305 1 1 184 633 633 186 115 755 605 578 729 729 576 577 582 729 729 517 518 519 521 522 523 728 728 729 728
729 723 737 738 723 738 606 541 542 543 729 729 729 729 730 113 116 734 735 580 581 121 122 195 192 633 186 1 1 1 1 1 1 1 1 184 633 633 186 115 763 737 737 580 581 737 724 590 729 729 525 526 527 529 530 531 728 728 729 728
723 738 729 729 730 729 606 729 729 729 729 729 729 729 730 113 114 470 471 1 1 1 1 184 633 633 186 1 1 1 1 1 1 1 1 184 633 633 186 123 121 121 121 580 581 137 755 590 729 729 549 567 551 537 538 539 728 736 724 728
738 723 737 737 738 729 605 578 729 729 729 729 723 737 765 113 114 486 487 1 1 1 1 184 633 633 194 177 177 177 177 177 177 177 177 192 633 633 194 178 1 3 1 1 1 112 755 590 729 729 557 575 559 729 729 729 728 729 728 728
729 730 729 729 723 737 737 737 737 737 737 737 765 116 121 121 122 1 176 177 177 177 177 192 633 633 633 633 633 633 633 633 633 633 633 633 633 633 633 186 1 1 1 1 1 112 755 598 576 577 577 577 577 577 577 578 736 724 728 736
723 738 729 723 765 113 116 121 734 735 734 735 121 122 1 1 1 1 184 633 633 633 633 633 633 633 633 633 633 633 633 633 633 633 633 633 633 633 633 186 1 1 1 1 1 112 763 737 737 737 737 737 737 737 724 729 729 728 736 724
730 729 729 730 113 113 114 1 470 471 470 471 1 1 1 1 1 1 184 633 633 633 633 633 633 633 633 633 633 633 633 633 633 633 633 633 633 633 633 194 177 178 1 1 1 120 121 121 121 121 137 113 113 113 755 729 729 728 729 728
730 729 729 730 113 113 114 1 486 485 476 477 1 1 1 1 1 1 184 633 633 633 633 633 633 633 633 633 633 633 633 633 633 633 633 633 633 633 633 633 633 186 1 1 1 1 1 1 1 1 120 734 735 137 763 724 729 736 724 728
730 729 729 730 113 113 114 1 1 1 468 469 1 1 1 1 1 1 184 633 633 633 633 633 633 633 633 633 633 633 633 633 633 633 633 633 633 633 633 633 633 186 1 1 1 1 1 1 1 1 1 470 471 112 113 755 729 729 728 728
730 729 729 730 113 113 114 1 1 1 486 487 1 1 1 1 1 1 184 633 633 633 633 633 633 633 633 633 633 633 633 633 633 633 633 633 633 633 633 633 633 194 177 177 178 1 1 1 1 462 463 476 477 112 113 763 724 729 728 728
730 729 729 730 113 113 114 1 1 1 1 1 1 1 462 463 1 1 184 633 633 633 633 633 633 633 633 633 633 633 633 633 633 633 633 633 633 633 633 633 633 633 633 633 186 1 1 1 1 470 469 468 469 112 113 113 755 729 728 728
732 722 729 748 749 113 114 1 1 1 1 1 1 1 470 471 1 1 184 633 633 633 633 633 633 633 633 633 633 633 633 633 633 633 633 633 633 633 633 633 633 633 633 633 186 1 1 1 1 476 477 476 477 112 113 113 755 729 728 728
729 730 729 729 732 749 191 105 105 105 106 1 1 1 476 477 176 177 192 633 633 633 633 633 633 633 633 633 633 633 633 633 633 633 633 633 633 633 633 633 633 633 633 633 194 177 177 177 178 468 469 468 469 112 113 113 755 729 728 728
729 732 721 721 722 732 748 748 748 749 191 105 106 1 468 469 184 633 633 633 633 633 633 633 633 633 633 633 633 633 633 633 633 633 633 633 633 633 633 633 633 633 633 633 633 633 633 633 186 486 485 484 487 112 747 748 731 729 728 728
729 729 729 729 732 721 721 722 729 732 748 749 114 1 486 487 184 633 633 633 633 633 633 633 633 633 633 633 633 633 633 633 633 633 633 633 633 633 633 633 633 633 633 633 633 633 633 152 608 617 105 105 105 190 755 729 720 721 731 731
729 729 729 729 729 729 729 732 721 722 729 730 191 105 105 106 184 633 633 633 633 633 633 633 633 633 633 633 633 633 633 633 633 633 633 633 633 633 633 633 633 633 633 633 633 633 633 160 113 113 113 113 747 748 731 720 728 729 729 729
721 721 721 722 729 729 729 729 729 730 729 732 748 749 113 114 184 633 633 633 633 633 633 633 633 633 633 633 633 633 633 633 633 633 633 633 633 633 633 633 633 152 617 617 617 617 617 617 113 747 748 748 731 729 729 728 728 729 729 729
729 729 729 732 721 722 729 729 729 732 721 721 722 732 749 114 184 633 633 633 633 633 633 633 633 633 633 633 633 633 633 633 633 633 633 633 633 633 633 633 633 160 113 113 113 113 113 113 113 755 729 729 729 720 721 731 728 729 729 729
729 729 729 729 729 730 729 729 729 729 729 729 730 729 730 114 184 633 633 633 633 633 633 633 633 633 645 646 646 646 647 633 633 633 633 633 633 152 617 617 617 617 113 113 113 113 747 748 748 731 729 729 729 728 729 729 728 729 729 729
729 729 729 729 729 732 721 722 729 729 729 729 732 722 730 114 184 633 633 633 633 633 633 633 645 646 653 654 654 654 655 646 647 633 633 633 633 160 113 113 113 113 113 113 113 747 731 720 721 721 721 721 721 731 720 721 731 729 729 729
729 729 729 729 729 729 729 730 729 729 729 729 729 730 730 114 184 633 633 633 633 633 633 645 653 654 654 654 654 654 654 654 655 647 633 633 633 160 113 113 113 113 113 747 748 731 729 728 729 729 729 729 720 721 731 729 729 729 729 729
729 729 729 729 729 729 729 732 721 722 729 729 729 730 730 617 617 617 617 154 633 633 645 653 654 654 654 654 654 654 654 654 654 655 647 152 617 617 113 113 747 748 748 731 729 729 729 728 720 721 721 721 731 729 729 729 729 729 729 729
729 729 729 729 729 729 729 729 729 730 729 729 729 730 730 113 113 113 113 617 617 617 617 617 617 617 617 617 617 617 617 617 617 617 617 617 113 113 113 113 755 729 720 721 721 721 721 731 728 729 729 729 729 729 729 729 729 729 729 729
729 729 729 729 729 729 729 729 729 732 721 722 729 730 732 749 113 113 113 113 113 113 113 113 113 113 113 113 113 113 113 113 113 113 113 113 113 747 748 748 731 729 728 720 721 721 721 721 731 729 729 729 729 729 729 729 729 729 729 729
729 729 729 729 729 729 729 729 729 729 729 730 729 730 729 732 748 748 748 748 748 748 748 748 748 748 748 748 748 748 748 748 748 748 748 748 748 731 729 720 721 721 731 728 729 729 729 729 729 729 729 729 729 729 729 729 729 729 729 729
729 729 729 729 729 729 729 729 729 729 729 730 729 732 721 721 721 721 721 721 721 721 721 721 721 721 721 721 721 721 721 721 721 721 721 721 721 721 721 731 729 729 729 728 729 729 729 729 729 729 729 729 729 729 729 729 729 729 729 729