SootopolisCity_House3_Layout (8x7)
1008 1008 1008 1010 1010 1008 1008 1008
701 699 700 1018 1018 1016 658 659
709 707 708 1023 1023 1023 666 667
1023 1022 1022 1022 1022 1022 1022 1022
989 990 734 1022 1022 1022 1022 1022
997 991 1022 1022 1022 1022 1022 1022
1023 1022 1022 520 521 1022 1022 1022