SootopolisCity_Gym_1F_Layout (17x26)
520 572 586 586 522 523 545 586 586 586 545 522 523 586 586 569 520
520 580 581 594 530 531 553 594 594 594 553 530 531 594 576 577 520
586 588 589 582 538 539 561 554 555 556 561 538 539 583 584 585 586
594 594 597 575 574 574 574 562 563 564 574 574 574 574 592 594 594
528 600 601 602 586 586 586 570 527 571 586 586 586 586 608 610 544
536 580 581 594 594 594 594 578 527 579 594 594 594 594 576 577 520
536 580 589 533 533 533 533 533 525 533 533 533 533 533 584 577 520
536 580 589 525 525 525 525 525 515 525 525 525 515 525 584 577 520
536 580 589 525 525 525 525 525 525 525 525 525 525 525 584 577 520
590 588 589 515 525 525 525 525 525 525 525 515 525 525 584 585 586
598 594 597 572 586 586 586 570 527 571 586 586 586 569 592 594 594
528 544 544 580 581 594 594 578 527 579 594 594 576 577 544 544 544
536 520 520 580 589 533 533 533 525 533 533 533 584 577 520 520 520
536 520 520 580 589 525 515 525 525 525 525 525 584 577 520 520 520
590 586 586 588 589 525 525 525 525 515 525 525 584 585 586 586 586
598 594 594 594 597 572 586 570 527 571 586 569 592 594 594 594 594
528 544 544 544 544 580 581 578 527 579 576 577 544 544 544 544 544
536 520 520 520 520 580 589 533 525 534 584 577 520 520 520 520 520
590 586 586 586 586 588 589 525 525 525 584 585 586 586 586 586 586
598 594 594 594 594 594 597 515 525 525 592 594 594 594 594 594 594
528 544 544 600 601 601 603 570 519 571 608 609 609 610 544 544 544
536 520 520 580 581 594 594 578 519 579 594 594 576 577 520 520 520
536 520 520 580 589 582 583 583 583 583 583 540 584 577 520 520 520
536 520 520 580 589 575 535 574 574 574 535 574 584 577 520 520 520
536 520 520 580 589 575 543 574 574 574 543 574 584 577 520 520 520
536 520 520 580 589 575 583 574 516 517 583 574 584 577 520 520 520