SootopolisCity_House1_Layout (8x7)
1008 1008 1009 1008 1008 1009 1008 560
717 1016 1017 1016 1016 1017 1016 2
725 1023 1023 1023 1023 1023 1023 693
1023 1022 733 1011 1012 734 1022 1022
1023 1022 733 1019 1020 734 1022 1022
1023 1022 1022 1022 1022 1022 1022 1022
1023 1022 1022 520 521 1022 1022 1022