SootopolisCity_Gym_B1F_Layout (17x26)
513 513 513 513 513 513 513 513 513 513 513 513 513 513 513 513 513
513 513 513 513 513 513 513 513 513 513 513 513 513 513 513 513 513
513 513 513 513 513 513 513 513 513 513 513 513 513 513 513 513 513
513 513 513 513 513 513 513 513 513 513 513 513 513 513 513 513 513
513 549 550 550 550 550 550 550 550 550 550 550 550 550 550 551 513
513 557 549 521 521 521 521 521 521 521 521 521 521 521 551 559 513
513 557 557 529 529 529 529 529 529 529 529 529 529 529 559 559 513
513 557 557 529 529 529 529 529 529 529 529 529 529 529 559 559 513
513 557 557 529 529 529 529 529 529 529 529 529 529 529 559 559 513
550 565 557 529 529 529 529 529 529 529 529 529 529 529 559 567 550
550 550 565 541 537 537 537 537 527 537 537 537 537 542 567 550 550
558 558 558 557 549 521 521 521 527 521 521 521 551 559 558 558 558
513 513 513 557 557 529 529 529 529 529 529 529 559 559 513 513 513
513 513 513 557 557 529 529 529 529 529 529 529 559 559 513 513 513
550 550 550 565 557 529 529 529 529 529 529 529 559 567 550 550 550
550 550 550 550 565 541 537 537 527 537 537 542 567 550 550 550 550
558 558 558 558 558 557 549 521 527 521 551 559 558 558 558 558 558
513 513 513 513 513 557 557 529 529 529 559 559 513 513 513 513 513
550 550 550 550 550 565 557 529 529 529 559 567 550 550 550 550 550
550 550 550 550 550 550 565 529 529 529 567 550 550 550 550 550 550
558 558 558 549 550 550 550 537 527 537 550 550 550 551 558 558 558
513 513 513 557 549 521 521 521 527 521 521 524 551 559 513 513 513
513 513 513 557 557 529 529 529 529 529 529 532 559 559 513 513 513
513 513 513 557 557 529 529 529 529 529 529 529 559 559 513 513 513
513 513 513 557 557 529 529 529 529 529 529 529 559 559 513 513 513
513 513 513 557 557 529 529 529 529 529 529 529 559 559 513 513 513