SouthernIsland_Exterior_Layout (33x30)
113 115 115 198 198 198 198 198 198 198 198 198 198 198 198 198 198 198 198 198 198 198 198 198 198 198 198 1 117 117 117 117 400
113 115 115 198 198 198 198 198 198 198 198 198 198 198 198 198 198 198 198 198 198 198 198 198 198 198 198 116 125 117 117 117 400
113 115 115 198 198 198 198 198 198 198 198 198 198 198 198 198 198 198 198 198 198 198 198 198 198 198 198 117 113 117 117 117 400
113 115 115 198 198 198 198 198 198 198 198 198 198 198 198 198 198 198 198 198 198 198 198 198 198 198 198 117 113 117 117 117 400
113 115 115 198 198 198 198 198 198 198 198 198 198 198 775 775 198 198 198 198 198 198 198 198 198 198 198 117 116 125 117 117 400
113 115 115 22 198 198 198 198 198 198 198 198 198 198 783 783 198 198 198 198 198 198 198 198 198 198 22 117 117 113 117 117 400
137 115 115 1 22 198 198 198 198 198 198 198 198 22 791 791 22 198 198 198 198 198 198 198 198 198 116 125 117 116 125 117 400
115 115 123 124 137 198 198 198 198 198 198 198 198 1 1 1 3 198 198 22 22 22 22 22 22 198 117 113 117 117 116 125 400
115 123 137 113 115 198 198 198 198 198 198 198 198 1 1 1 1 22 22 1 14 14 14 1 1 22 117 116 125 117 117 384 408
123 137 115 113 115 22 198 198 198 198 198 198 198 14 1 1 1 1 1 14 198 198 198 14 1 1 117 117 113 117 117 400 368
137 115 123 137 115 1 22 22 198 198 198 198 198 198 14 1 1 1 14 198 198 198 198 22 1 1 117 117 113 117 117 400 368
115 123 137 115 123 704 206 137 22 198 198 198 198 198 198 14 14 14 22 22 22 22 22 116 175 207 122 117 113 117 117 400 368
123 137 115 123 137 22 22 112 1 22 22 198 198 198 198 198 198 22 116 704 704 704 704 122 1 1 1 117 116 125 117 400 368
385 115 115 113 123 124 137 123 124 124 137 22 22 22 22 22 22 116 122 22 22 22 22 116 175 207 121 122 117 113 117 400 368
402 115 115 113 113 113 123 206 206 137 123 704 704 704 124 124 124 125 116 121 121 121 121 122 1 1 1 1 117 116 125 400 368
402 115 123 124 124 124 137 22 22 120 137 22 22 22 116 145 145 145 122 1 1 1 1 1 1 1 116 124 125 117 384 408 368
402 115 113 113 113 113 123 124 124 137 120 121 121 121 122 1 1 1 1 1 1 1 1 1 1 116 125 113 116 125 400 368 368
402 123 124 124 137 113 113 113 113 115 1 1 1 1 1 1 1 1 1 1 116 124 124 124 124 125 116 124 125 384 408 368 368
410 393 393 385 123 124 124 137 113 123 124 124 124 124 124 175 207 124 124 124 125 116 169 169 169 169 125 384 393 408 368 368 368
368 368 368 410 393 393 385 123 124 169 169 169 169 169 93 94 94 95 169 169 169 125 384 393 393 393 393 408 368 368 368 368 368
368 368 368 368 368 368 410 393 393 393 393 393 393 393 93 94 94 95 671 393 393 393 408 368 368 368 368 368 368 368 368 368 368
368 368 368 368 368 368 368 368 368 368 85 86 86 86 645 94 94 95 369 368 368 368 368 368 368 368 368 368 368 368 368 368 368
368 368 368 368 368 368 368 368 368 368 93 94 94 94 94 94 94 95 369 368 368 368 368 368 368 368 368 368 368 368 368 368 368
368 368 368 368 368 368 368 368 368 368 851 852 852 854 855 852 852 853 369 368 368 368 368 368 368 368 368 368 368 368 368 368 368
368 368 368 368 368 368 368 368 368 368 859 860 860 860 860 860 860 861 369 368 368 368 368 368 368 368 368 368 368 368 368 368 368
368 368 368 368 368 368 368 368 368 368 369 369 369 369 369 369 369 369 369 368 368 368 368 368 368 368 368 368 368 368 368 368 368
368 368 368 368 368 368 368 368 368 368 368 368 368 368 368 368 368 368 368 368 368 368 368 368 368 368 368 368 368 368 368 368 368
368 368 368 368 368 368 368 368 368 368 368 368 368 368 368 368 368 368 368 368 368 368 368 368 368 368 368 368 368 368 368 368 368
368 368 368 368 368 368 368 368 368 368 368 368 368 368 368 368 368 368 368 368 368 368 368 368 368 368 368 368 368 368 368 368 368
368 368 368 368 368 368 368 368 368 368 368 368 368 368 368 368 368 368 368 368 368 368 368 368 368 368 368 368 368 368 368 368 368