SouthernIsland_Interior_Layout (27x24)
476 477 468 469 476 477 468 469 468 469 468 469 468 469 468 469 468 469 468 469 468 469 476 477 468 469 476
468 469 476 477 468 469 476 477 476 477 476 477 476 477 476 477 476 477 476 477 476 477 468 469 476 477 468
486 485 468 469 476 477 468 469 468 469 468 469 468 469 468 469 468 469 468 469 468 469 476 477 468 469 484
462 463 486 485 468 469 476 477 476 477 476 477 476 477 476 477 476 477 476 477 476 477 468 469 484 498 463
468 471 462 463 486 485 468 469 468 469 468 469 468 469 468 469 468 469 468 469 468 469 484 498 463 468 469
476 477 468 471 462 463 486 485 476 477 484 485 484 485 484 485 484 498 499 487 484 498 463 468 469 476 477
468 469 476 477 468 471 462 463 468 469 1 4 1 1 1 4 1 468 469 462 463 468 469 476 477 468 469
476 477 468 469 476 477 468 469 484 487 1 1 1 1 1 1 1 486 485 468 469 476 477 468 469 476 477
468 469 476 477 468 469 476 477 4 1 1 1 1 1 1 1 1 1 4 476 477 468 469 476 477 468 469
476 477 468 469 476 477 468 469 1 1 200 201 202 1 200 201 202 1 1 468 469 476 477 468 469 476 477
468 469 476 477 468 469 476 477 1 1 208 209 218 1 216 209 210 1 1 476 477 468 469 476 477 468 469
476 477 468 469 476 477 468 469 1 1 208 210 1 705 1 208 210 1 1 468 469 476 477 468 469 476 477
468 469 476 477 468 469 476 477 1 1 208 210 1 1 1 208 210 1 1 476 477 468 469 476 477 468 469
476 477 468 469 476 477 468 469 1 1 208 209 201 201 201 209 210 1 1 468 469 476 477 468 469 476 477
468 469 476 477 468 469 476 477 4 1 216 209 209 209 209 209 218 1 4 476 477 468 469 476 477 468 469
476 477 468 469 476 477 468 469 462 463 1 216 217 217 217 218 1 462 463 468 469 476 477 468 469 476 477
468 469 476 477 468 469 484 485 468 471 4 1 1 1 1 1 4 470 469 484 485 468 469 476 477 468 469
476 477 468 469 484 498 463 462 499 498 463 462 463 1 1 462 463 476 477 462 463 486 485 468 469 476 477
468 469 484 498 463 468 469 468 469 468 469 468 471 516 516 470 469 468 469 468 471 462 463 486 485 468 469
484 498 463 468 469 476 477 476 477 476 477 476 477 464 466 476 477 476 477 476 477 468 471 462 463 486 485
463 468 469 476 477 470 469 468 469 468 469 468 469 472 474 468 469 468 469 468 469 476 477 468 471 462 463
469 476 477 470 469 476 477 476 477 476 477 476 477 472 474 476 477 476 477 476 477 468 469 476 477 468 471
477 470 469 476 477 470 469 468 469 468 469 468 469 472 474 468 469 468 469 468 469 476 477 468 469 476 477
469 476 477 470 469 476 477 476 477 476 477 476 477 472 474 476 477 476 477 476 477 468 469 476 477 468 469