SSTidalCorridor_Layout (18x13)
513 697 696 697 696 697 696 697 696 697 696 697 696 697 696 697 696 697
513 705 704 705 704 705 704 705 704 705 704 705 704 705 704 705 704 705
513 699 699 699 699 699 699 699 699 699 699 699 699 699 699 699 692 523
513 700 698 706 708 709 707 708 709 707 708 709 707 708 710 698 698 711
513 700 698 560 561 561 561 561 561 561 561 561 561 561 562 700 698 698
513 700 698 560 561 561 561 561 561 561 561 561 561 561 562 700 698 698
513 700 698 560 561 561 561 561 561 561 561 561 561 561 562 700 698 698
513 700 698 560 561 561 561 561 561 561 561 561 561 561 562 700 698 698
513 700 698 549 547 548 546 547 548 546 547 548 546 547 550 700 698 698
513 700 698 557 555 635 554 555 635 554 555 635 554 555 763 700 698 698
513 700 698 701 702 702 702 702 702 702 702 702 702 702 702 703 698 698
524 693 698 698 698 698 698 698 698 698 698 698 698 698 698 698 698 698
532 513 513 513 513 513 513 513 513 513 513 513 513 513 513 513 513 513