SSTidalRooms_Layout (36x18)
566 576 619 661 611 662 621 581 513 513 576 619 661 611 662 621 581 513 513 576 619 661 611 662 551 551 513 513 576 619 661 611 662 621 581 567
574 584 627 669 663 670 629 589 513 513 584 627 669 663 670 629 589 513 513 584 627 669 663 670 559 559 513 513 559 559 669 663 670 629 589 575
574 592 593 570 571 571 596 597 513 513 592 593 570 571 571 596 597 513 513 592 593 570 571 571 571 571 513 513 665 666 571 571 571 596 597 575
574 600 601 573 568 568 604 605 513 513 600 601 573 568 568 604 605 513 513 600 601 573 568 568 568 568 513 513 673 674 568 568 568 604 605 575
574 570 571 572 568 568 571 571 513 513 570 571 572 568 568 571 571 513 513 570 571 572 568 568 568 568 513 513 631 568 568 568 568 571 571 575
574 573 568 568 568 568 568 568 513 513 631 568 568 598 599 568 568 513 513 573 568 608 598 599 609 568 513 513 573 568 568 568 568 568 609 575
574 573 568 568 568 598 599 568 513 513 573 568 608 606 607 609 568 513 513 573 568 608 606 607 609 568 513 513 573 568 568 568 568 598 599 575
574 573 568 568 608 606 607 610 513 513 573 568 568 568 568 568 568 513 513 573 568 568 568 610 568 568 513 513 573 568 568 568 608 606 607 575
513 513 513 513 513 513 513 513 513 513 513 513 513 513 513 513 513 513 513 513 513 513 513 513 513 513 513 513 513 513 513 513 513 513 513 513
566 576 619 620 630 620 621 581 513 513 620 630 620 620 579 580 581 513 513 576 620 630 620 630 621 581 513 513 576 619 630 551 630 621 581 567
574 584 627 628 638 628 629 589 513 513 628 638 628 628 587 617 618 513 513 559 628 638 628 638 629 589 513 513 584 627 638 559 638 559 559 575
574 592 593 570 571 571 596 597 513 513 570 571 571 571 571 625 626 513 513 665 666 571 571 571 596 597 513 513 592 593 570 571 571 571 636 575
574 600 601 573 568 568 604 605 513 513 573 598 599 568 568 633 634 513 513 673 674 568 568 568 604 605 513 513 600 601 573 598 624 624 599 575
574 570 571 572 568 568 571 636 513 513 573 606 607 609 568 571 565 513 513 573 568 568 568 568 571 571 513 513 616 571 572 606 632 632 607 575
574 573 568 568 568 568 568 568 513 513 573 568 568 568 568 568 568 513 513 573 568 568 568 568 568 568 513 513 573 568 568 608 568 568 568 575
574 573 568 568 568 568 568 568 513 513 573 568 568 568 568 568 568 513 513 573 568 568 568 568 568 568 513 513 573 568 568 568 568 568 568 575
574 573 568 568 612 613 568 568 513 513 573 568 568 612 613 568 568 513 513 573 568 568 612 613 568 568 513 513 573 568 568 612 613 568 568 575
513 513 513 513 513 513 513 513 513 513 513 513 513 513 513 513 513 513 513 513 513 513 513 513 513 513 513 513 513 513 513 513 513 513 513 513