SSTidalLowerDeck_Layout (17x13)
681 681 520 681 681 681 681 681 681 681 681 681 681 681 681 681 520
689 689 744 746 689 689 736 746 689 689 747 748 749 689 689 689 526
639 541 744 746 541 541 744 746 541 639 747 748 749 541 541 533 534
541 525 752 754 750 525 752 754 750 525 755 756 757 750 525 525 525
541 525 743 743 758 525 743 743 758 525 743 743 743 758 525 525 525
541 736 737 738 736 737 738 525 739 741 525 739 740 741 525 525 525
541 747 748 749 744 745 746 750 744 746 750 747 748 749 750 525 525
541 755 756 757 752 753 754 750 752 754 750 755 756 757 750 525 525
541 743 743 743 743 743 743 758 743 743 758 743 743 743 758 525 525
541 525 525 525 525 525 525 525 525 525 525 525 525 525 525 736 738
541 736 737 738 736 737 738 525 736 738 525 739 741 525 525 744 746
541 744 745 746 744 745 746 750 752 754 750 755 757 750 525 739 741
639 752 753 754 752 753 754 750 743 743 758 743 743 758 525 755 757