TradeCenter_Layout (12x9)
560 561 567 564 565 536 536 566 567 564 562 563
568 569 575 572 573 544 544 574 575 572 570 571
576 577 583 580 581 552 552 582 583 580 578 579
584 585 558 514 515 516 517 518 519 558 586 587
592 528 520 522 523 524 525 526 527 520 529 595
592 593 555 530 531 532 533 534 535 555 594 595
592 528 520 538 539 540 541 542 543 520 529 595
600 601 520 520 547 548 549 550 520 520 602 603
513 513 513 513 513 556 557 513 513 513 513 513