Underwater2_Layout (80x80)
531 531 531 531 531 531 531 531 531 531 531 531 531 531 531 531 531 531 531 531 531 531 531 518 542 542 542 542 542 519 531 531 531 531 531 531 531 531 531 531 531 531 531 531 531 531 531 531 531 531 531 531 531 531 531 531 531 531 531 531 531 531 531 531 531 531 531 531 531 531 531 531 531 531 531 531 531 531 531 531
531 531 531 531 531 531 531 531 531 518 542 542 519 531 531 531 518 542 542 542 542 542 542 646 681 650 534 534 648 654 531 531 531 531 531 531 531 531 531 531 531 531 531 531 531 531 531 531 531 531 531 531 531 531 531 531 531 531 531 531 531 531 531 531 531 531 531 531 531 531 531 531 531 531 531 531 531 531 531 531
531 531 531 531 531 531 531 531 518 646 649 649 645 542 542 542 646 641 641 641 641 641 641 681 642 534 534 534 534 654 531 531 531 531 531 531 531 531 531 531 531 531 531 531 531 531 531 531 531 531 531 531 531 531 531 531 531 531 531 531 531 531 531 531 531 531 531 531 531 531 531 531 531 531 531 531 531 531 531 531
531 531 531 531 531 531 531 531 653 642 534 534 640 681 681 681 641 641 641 641 641 641 641 681 642 534 534 534 534 654 531 531 531 531 531 531 531 531 531 531 531 531 531 531 531 531 531 531 531 531 531 531 531 531 531 531 531 531 531 531 531 531 531 531 531 531 531 531 531 531 531 531 531 531 531 531 531 531 531 531
531 531 531 531 531 531 531 531 653 642 534 534 640 681 681 681 681 641 641 641 641 641 641 681 681 634 534 534 632 654 531 531 531 531 531 531 531 531 531 531 531 531 531 531 531 531 531 531 531 531 531 531 531 531 531 531 531 531 531 531 531 531 531 531 531 531 531 531 531 531 531 531 531 531 531 531 531 531 531 531
531 531 531 531 531 531 531 531 547 638 633 633 681 681 637 636 636 636 636 636 636 636 636 636 636 636 636 636 636 547 531 531 531 531 531 531 531 531 531 531 531 531 531 531 531 531 531 531 531 531 531 531 531 531 531 531 531 531 531 531 531 531 531 531 531 531 531 531 531 531 531 531 531 531 531 531 531 531 531 531
531 531 531 531 531 531 531 531 531 547 636 636 636 636 547 531 531 531 531 531 531 531 531 531 531 531 531 531 531 531 531 531 531 531 531 531 531 531 531 531 531 531 531 531 531 531 531 531 531 531 531 531 531 531 531 531 531 531 531 531 531 531 531 531 531 531 531 531 531 531 531 531 531 531 531 531 531 531 531 531
531 531 531 531 531 531 531 531 531 531 531 531 531 531 531 531 531 531 531 531 531 531 531 531 531 531 531 531 531 531 518 542 542 542 542 542 542 542 542 542 542 542 542 519 531 531 531 531 531 531 531 531 531 531 531 531 531 531 531 531 531 531 531 531 531 531 531 531 531 531 531 531 531 531 531 531 531 531 531 531
531 531 531 531 531 531 531 531 531 531 531 531 531 531 531 531 531 531 531 531 531 531 531 531 531 531 531 518 542 542 543 518 539 539 539 539 539 539 539 539 539 539 519 541 542 542 542 542 519 531 531 531 531 531 531 531 531 531 531 531 531 531 531 531 531 531 531 531 531 531 531 531 531 531 531 531 531 531 531 531
531 531 531 531 531 531 531 531 531 531 531 531 531 531 531 531 531 531 531 531 531 531 531 531 531 531 518 543 531 518 539 540 534 534 534 534 534 534 534 534 534 534 538 539 539 519 531 531 541 542 519 531 531 531 531 531 531 531 531 531 531 531 531 531 531 531 531 531 531 531 531 531 531 531 531 531 531 531 531 531
531 531 531 531 531 531 531 531 531 531 531 531 531 531 531 531 531 531 531 531 531 531 531 531 531 531 535 531 518 540 534 534 534 534 534 534 534 534 534 534 534 534 534 534 534 538 539 519 531 531 541 542 542 542 542 519 531 531 531 531 531 531 531 531 531 531 531 531 531 531 531 531 531 531 531 531 531 531 531 531
531 531 531 531 531 531 531 531 531 531 531 531 531 531 531 531 531 531 531 531 531 531 531 518 542 542 543 531 547 523 523 523 523 523 523 524 513 534 534 534 534 534 534 534 534 534 534 538 539 539 539 539 519 531 531 541 542 542 519 531 531 531 531 531 531 531 531 531 531 531 531 531 531 531 531 531 531 531 531 531
531 531 531 531 531 531 531 531 531 531 531 531 531 531 531 531 531 531 518 542 542 542 542 543 531 531 531 531 531 531 559 531 531 531 531 547 524 513 534 513 513 513 513 534 534 534 534 534 534 534 534 534 538 539 519 531 531 531 541 519 531 531 531 531 531 531 531 531 531 531 531 531 531 531 531 531 531 531 531 531
531 531 531 531 531 531 531 531 531 531 531 531 531 531 531 531 531 518 543 518 539 539 539 539 539 539 539 539 539 519 531 531 531 531 531 531 532 513 513 513 522 523 523 523 524 534 534 534 534 534 534 534 513 513 538 519 531 531 531 541 542 542 519 531 531 531 531 531 531 531 531 531 531 531 531 531 531 531 531 531
531 531 531 531 531 531 531 531 531 531 531 531 531 531 531 531 518 543 518 540 534 534 534 534 534 534 534 534 534 538 539 519 531 531 531 531 532 513 513 513 530 531 531 531 547 523 524 534 534 534 534 534 534 513 513 538 539 519 531 531 531 531 541 542 519 531 531 531 531 531 531 531 531 531 531 531 531 531 531 531
531 531 531 531 531 531 531 531 531 531 531 531 531 531 531 531 535 518 540 534 534 534 534 534 534 534 534 534 534 534 534 538 519 531 531 531 532 513 513 513 530 531 531 531 531 531 547 524 534 534 534 534 534 534 513 513 513 538 539 539 539 519 531 531 541 519 531 531 531 531 531 531 531 531 531 531 531 531 531 531
531 531 531 531 531 531 531 531 531 531 531 531 531 531 531 531 535 535 534 534 534 534 534 534 534 534 534 534 534 534 534 534 530 531 531 531 532 513 513 513 538 539 539 519 531 531 531 547 524 534 534 534 534 534 534 513 513 513 513 534 534 538 519 531 531 541 542 519 531 531 531 531 531 531 531 531 531 531 531 531
531 531 531 531 531 531 531 531 531 531 531 531 531 531 531 531 535 535 534 534 534 534 534 534 534 534 534 534 534 534 688 534 530 531 531 531 532 513 513 513 513 513 534 538 519 531 531 531 532 534 534 534 534 534 534 534 513 513 513 513 534 534 538 539 539 539 519 541 519 531 531 531 531 531 531 531 531 531 531 531
531 531 531 531 531 531 531 531 531 531 531 531 531 531 531 531 535 535 534 534 534 534 522 523 523 523 524 534 534 534 534 534 530 531 531 531 532 513 513 513 513 534 534 534 530 531 531 531 532 534 534 534 534 534 534 513 513 513 513 513 534 534 534 534 534 534 538 519 541 519 531 531 531 531 531 531 531 531 531 531
531 531 531 531 531 531 531 531 531 531 531 531 531 531 531 531 535 535 534 534 534 522 546 525 526 527 547 523 524 534 534 534 530 531 531 559 532 513 513 534 534 688 534 534 530 525 526 527 532 534 534 534 534 534 513 513 513 513 513 513 513 513 534 688 534 534 534 530 531 533 531 531 531 531 531 531 531 531 531 531
531 531 531 531 531 531 531 531 531 531 531 531 531 531 531 531 535 653 689 689 689 654 525 546 531 547 527 559 547 523 523 523 546 531 531 531 547 524 534 534 534 534 534 522 546 533 531 535 532 534 534 534 534 513 513 513 513 513 513 513 513 513 513 534 534 534 534 538 519 533 531 531 531 531 531 531 531 531 531 531
531 531 531 531 531 531 531 531 531 531 531 531 531 531 531 531 535 653 681 681 681 654 533 531 531 531 547 526 527 531 531 531 531 531 531 531 531 547 523 523 523 523 523 546 525 546 531 535 532 534 534 534 513 513 513 513 513 513 513 513 513 513 513 513 534 534 534 513 530 533 531 531 531 531 531 531 531 531 531 531
531 531 531 531 531 531 531 531 531 531 531 531 531 531 531 531 535 653 681 681 681 654 533 531 531 531 531 531 535 531 531 531 531 531 531 531 559 525 526 526 526 526 526 526 546 531 518 543 532 534 534 534 513 513 513 522 523 524 513 513 513 513 513 513 513 513 513 513 530 533 531 531 531 531 531 531 531 531 531 531
531 531 531 531 531 531 531 531 531 531 531 531 531 531 531 531 535 653 681 681 681 654 533 531 531 531 531 531 535 531 531 531 531 531 531 531 531 541 519 531 531 531 531 531 518 542 543 518 540 534 534 513 513 513 522 526 531 526 523 524 513 513 513 513 513 513 513 513 530 533 531 531 531 531 531 531 531 531 531 531
531 531 531 531 531 531 531 531 531 531 531 531 531 531 531 531 535 653 680 680 680 654 533 531 531 531 531 531 535 531 518 539 539 539 539 539 519 531 541 542 519 531 518 542 543 518 539 540 534 534 534 513 513 513 530 531 531 559 531 523 524 513 513 513 513 513 513 513 530 533 531 531 531 531 531 531 531 531 531 531
531 531 531 531 531 531 531 531 531 531 531 531 531 531 531 531 535 653 534 534 534 530 533 531 531 531 531 518 543 559 532 534 534 534 534 534 538 539 519 531 541 542 543 518 539 540 534 534 534 534 534 513 513 513 538 519 531 531 531 559 547 523 524 513 513 513 513 513 530 533 531 531 531 531 531 531 531 531 531 531
531 531 531 531 531 531 531 531 531 531 531 531 531 531 531 531 535 547 524 534 534 530 541 542 519 531 531 535 531 518 540 534 534 534 534 534 534 534 538 539 539 539 539 540 534 534 534 534 534 534 534 513 513 513 513 538 539 539 519 531 531 518 540 513 513 513 513 522 546 533 531 531 531 531 531 531 531 531 531 531
531 531 531 531 531 531 531 531 518 542 542 542 519 531 531 531 547 527 535 534 534 530 531 559 541 542 542 543 518 540 534 534 534 534 534 534 534 534 534 534 534 534 534 534 534 534 534 534 534 534 534 534 534 513 513 513 513 513 538 539 539 540 513 513 513 513 513 530 531 533 531 531 531 531 531 531 531 531 531 531
531 531 531 531 531 531 531 518 543 531 531 531 533 531 531 531 531 535 535 534 534 538 539 519 531 531 531 518 540 534 534 534 534 534 534 534 534 534 534 534 534 534 534 534 534 534 534 534 534 534 534 534 534 513 513 513 513 513 513 513 513 513 513 513 513 513 513 530 531 533 531 531 531 531 531 531 531 531 531 531
531 531 531 531 531 531 531 535 531 518 539 519 541 519 531 531 531 535 535 534 534 534 534 538 539 539 539 540 534 534 534 534 534 534 534 534 534 534 534 534 534 534 534 534 534 534 534 534 534 534 534 534 534 534 534 513 513 513 513 513 513 513 513 513 513 513 522 546 531 533 531 531 531 531 531 531 531 531 531 531
531 531 531 531 531 531 531 535 531 532 513 530 531 541 519 531 518 543 535 513 534 534 534 534 534 534 534 534 534 534 534 534 534 534 534 534 534 534 534 534 534 534 534 534 534 534 534 534 534 534 534 534 534 534 534 534 534 534 513 513 513 513 513 513 513 513 530 531 531 533 531 531 531 531 531 531 531 531 531 531
531 531 531 531 531 531 531 535 531 532 513 538 519 531 533 531 535 531 547 524 513 534 534 534 534 534 534 534 534 534 534 534 534 534 534 534 534 522 523 523 524 534 534 534 534 534 534 534 534 534 534 534 534 534 534 534 534 534 534 534 534 534 513 513 513 513 530 531 531 533 531 531 531 531 531 531 531 531 531 531
531 531 531 531 531 531 518 543 518 540 513 513 538 519 541 542 543 531 531 535 513 534 534 534 534 534 534 534 534 534 534 534 534 522 523 523 523 546 531 531 547 523 523 523 523 524 534 534 534 534 534 534 534 534 534 534 534 534 534 534 534 534 534 534 513 513 538 519 531 533 531 531 531 531 531 531 531 531 531 531
531 531 531 531 531 531 535 531 532 513 513 513 513 530 531 531 531 531 531 535 513 534 534 534 534 534 534 534 534 534 534 522 523 546 531 531 531 525 526 526 526 526 526 527 559 547 523 523 523 523 523 523 523 523 523 523 524 534 534 534 534 534 534 534 513 513 513 530 531 533 531 531 531 531 531 531 531 531 531 531
531 531 531 531 531 531 535 531 532 513 513 534 513 538 519 531 559 531 531 532 513 513 534 534 534 534 534 513 513 513 522 546 531 559 525 526 526 546 525 526 526 526 527 547 526 526 526 526 526 526 526 527 559 531 531 531 547 523 524 534 534 534 534 534 534 513 513 530 531 533 531 531 531 531 531 531 531 531 531 531
531 531 531 531 531 531 535 559 532 513 513 534 688 513 530 531 531 531 518 540 513 513 513 534 534 513 513 513 522 523 546 525 526 526 546 525 526 526 546 531 531 531 547 526 526 523 527 559 531 531 531 547 526 526 527 559 531 531 547 524 534 534 534 534 534 513 513 538 519 533 531 531 531 531 531 531 531 531 531 531
531 531 531 531 531 531 535 531 532 513 688 534 534 513 530 531 531 518 540 513 513 513 513 513 513 513 522 523 546 525 526 546 559 525 526 546 531 531 531 531 531 531 531 531 531 531 547 526 526 526 527 559 531 531 547 526 527 559 531 547 524 534 534 534 534 534 513 513 530 541 519 531 531 531 531 531 531 531 531 531
531 531 531 531 531 531 535 531 532 513 534 534 513 513 530 531 531 532 513 513 513 513 513 513 513 522 546 525 526 546 559 525 526 546 531 531 531 531 531 531 531 531 531 531 531 531 531 531 531 531 547 526 526 526 527 559 547 526 527 531 547 524 534 534 534 534 534 513 530 531 541 519 531 531 531 531 531 531 531 531
531 531 531 531 531 531 535 531 532 513 513 534 513 522 546 531 518 540 513 513 513 513 513 513 522 546 525 546 531 525 526 546 531 531 531 531 531 531 531 531 531 531 531 531 531 531 531 531 531 531 531 531 531 531 547 526 527 559 547 527 559 547 524 534 534 534 534 513 538 519 531 533 531 531 531 531 531 531 531 531
531 531 531 531 531 531 535 531 547 524 513 688 513 530 531 559 532 513 513 513 513 513 513 513 530 525 546 559 525 546 531 531 531 531 531 531 531 531 531 531 531 531 531 531 531 531 531 531 531 531 531 531 531 531 531 531 547 526 527 547 527 531 547 524 534 534 534 534 534 530 531 541 519 531 531 531 531 531 531 531
531 531 531 531 531 531 547 527 559 532 513 534 513 530 531 531 532 513 513 513 513 513 513 522 546 533 531 525 546 531 531 531 531 531 531 531 531 531 531 531 531 531 531 531 531 531 531 531 531 531 531 531 531 531 531 531 531 531 547 527 547 527 531 532 534 534 534 534 534 530 531 531 533 531 531 531 531 531 531 531
531 531 531 531 531 531 531 535 531 532 513 513 513 530 531 531 532 513 513 513 513 513 513 530 525 546 525 546 531 531 531 531 531 531 531 531 531 531 531 531 531 531 531 531 531 531 531 531 531 531 531 531 531 531 531 531 531 531 531 547 527 535 559 547 524 534 534 534 534 538 519 531 533 531 531 531 531 531 531 531
531 531 531 531 531 531 531 535 531 532 513 513 513 530 531 531 532 513 513 513 513 513 513 530 533 531 533 531 531 531 531 531 531 531 531 531 531 531 531 531 531 531 531 531 531 531 531 531 531 531 531 531 531 531 531 531 531 531 531 531 535 547 527 531 547 524 534 534 534 534 530 531 541 519 531 531 531 531 531 531
531 531 531 531 531 531 531 547 527 547 524 513 522 546 531 518 540 513 534 534 513 513 522 523 533 525 546 531 531 531 531 531 531 531 531 531 531 531 531 531 531 531 531 531 531 531 531 531 531 531 531 531 531 531 531 531 531 531 531 531 535 531 535 559 531 532 534 534 534 534 530 531 559 533 531 531 531 531 531 531
531 531 531 531 531 531 531 531 535 531 547 523 546 559 531 532 513 513 534 534 534 513 530 525 546 533 531 531 531 531 531 531 531 531 531 531 531 531 531 531 531 531 531 531 531 531 531 531 531 531 531 531 531 531 531 531 531 531 531 531 547 527 547 527 531 532 513 534 534 534 538 519 531 533 531 531 531 531 531 531
531 531 531 531 531 531 531 531 547 527 531 531 531 531 518 540 513 534 534 534 534 513 530 533 531 533 531 531 531 531 531 531 531 531 531 531 531 531 531 531 531 531 531 531 531 531 531 531 531 531 531 531 531 531 531 531 531 531 531 531 531 535 531 535 531 532 513 534 534 534 534 530 531 541 519 531 531 531 531 531
531 531 531 531 531 531 531 531 531 547 527 531 531 531 532 534 534 534 534 534 534 513 530 533 559 533 531 531 531 531 531 531 531 531 531 531 531 531 531 531 531 531 531 531 531 531 531 531 531 531 531 531 531 531 531 531 531 531 531 531 531 547 527 547 527 547 524 513 534 534 534 538 519 531 533 531 531 531 531 531
531 531 531 531 531 531 531 531 531 531 535 531 559 531 532 534 534 534 534 534 534 513 530 533 531 533 531 531 531 531 531 531 531 531 531 531 531 531 531 531 531 531 531 531 531 531 531 531 531 531 531 531 531 531 531 531 531 531 531 531 531 531 535 559 535 559 532 513 534 534 534 534 530 559 533 531 531 531 531 531
531 531 531 531 531 531 531 531 531 531 535 531 531 531 532 534 534 534 534 534 534 522 523 533 531 533 531 531 531 531 531 531 531 531 531 531 531 531 531 531 531 531 531 531 531 531 531 531 531 531 531 531 531 531 531 531 531 531 531 531 531 531 535 531 535 531 532 513 534 534 534 534 530 531 533 531 531 531 531 531
531 531 531 531 531 531 531 531 531 531 535 531 531 531 532 534 534 534 534 534 534 530 559 533 531 533 531 531 531 531 531 531 531 531 531 531 531 531 531 531 531 531 531 531 531 531 531 531 531 531 531 531 531 531 531 531 531 531 531 531 531 518 543 518 543 518 540 513 534 534 534 534 530 531 533 531 531 531 531 531
531 531 531 531 531 531 531 531 531 531 547 527 531 531 532 534 534 534 534 534 513 530 531 533 531 533 531 531 531 531 531 531 531 531 531 531 531 531 531 531 531 531 531 531 531 531 531 531 531 531 531 531 531 531 531 531 531 531 531 531 531 535 559 535 531 532 513 513 534 534 534 534 530 531 533 531 531 531 531 531
531 531 531 531 531 531 531 531 531 531 531 535 531 531 532 534 534 534 534 534 513 530 559 533 531 541 519 531 531 531 531 531 531 531 531 531 531 531 531 531 531 531 531 531 531 531 531 531 531 531 531 531 531 531 531 531 531 531 531 531 518 543 518 543 518 540 513 513 513 534 534 534 530 531 541 519 531 531 531 531
531 531 531 531 531 531 531 531 531 531 531 547 527 531 532 513 534 534 534 534 513 538 519 541 519 531 533 531 531 531 531 531 531 531 531 531 531 531 531 531 531 531 531 531 531 531 531 531 531 531 531 531 531 531 531 531 531 531 531 531 535 531 535 531 532 513 513 513 513 534 534 534 530 531 559 533 531 531 531 531
531 531 531 531 531 531 531 531 531 531 531 531 535 559 532 513 534 534 534 534 513 513 530 531 533 531 541 519 531 531 531 531 531 531 531 531 531 531 531 531 531 531 531 531 531 531 531 531 531 531 531 531 531 531 531 531 531 531 531 531 535 518 543 531 532 513 513 513 513 534 534 522 546 531 531 533 531 531 531 531
531 531 531 531 531 531 531 531 531 531 531 531 535 531 532 513 513 534 534 534 534 513 530 531 541 519 531 541 519 531 531 531 531 531 531 531 531 531 531 531 531 531 531 531 531 531 531 531 531 531 531 531 531 531 531 531 531 531 531 518 543 535 531 518 540 513 513 513 513 513 513 530 531 531 531 533 531 531 531 531
531 531 531 531 531 531 531 531 531 531 531 531 535 531 532 513 513 513 534 534 513 513 538 519 531 541 519 531 541 519 531 531 531 531 531 531 531 531 531 531 531 531 531 531 531 531 531 531 531 531 531 531 531 531 531 531 531 531 531 535 559 535 559 532 513 513 513 513 513 513 513 530 531 531 531 533 531 531 531 531
531 531 531 531 531 531 531 531 531 531 531 531 535 559 547 524 513 513 513 513 513 513 513 530 531 531 533 531 559 541 519 531 531 531 531 531 531 531 531 531 531 531 531 531 531 531 531 531 531 531 531 531 531 531 531 531 531 531 518 543 518 543 518 540 513 513 513 513 513 513 513 530 531 559 525 546 531 531 531 531
531 531 531 531 531 531 531 531 531 531 531 531 535 531 531 532 513 513 513 513 513 513 513 538 519 559 541 519 531 531 533 531 531 531 531 531 531 531 531 531 531 531 531 531 531 531 531 531 531 531 531 531 531 531 531 531 531 531 535 531 535 531 532 513 513 513 513 513 513 513 522 546 531 531 533 531 531 531 531 531
531 531 531 531 531 531 531 531 531 531 531 531 547 527 531 547 524 513 513 513 513 513 513 513 538 519 531 541 542 519 541 519 531 531 531 531 531 531 531 531 531 531 531 531 531 531 531 531 531 531 531 531 531 531 531 531 531 531 535 518 543 559 532 513 513 513 513 513 513 522 546 531 531 525 546 531 531 531 531 531
531 531 531 531 531 531 531 531 531 531 531 531 531 535 531 531 532 513 513 513 513 513 513 513 513 538 519 531 531 533 531 541 542 542 542 519 531 531 531 531 531 531 531 531 531 531 531 531 531 531 531 531 531 531 531 531 531 518 543 535 531 518 540 513 513 534 513 513 513 530 531 531 531 533 531 531 531 531 531 531
531 531 531 531 531 531 531 531 531 531 531 531 531 535 559 531 532 513 513 513 513 534 534 534 513 513 538 519 531 541 542 542 519 531 559 541 519 531 531 531 531 531 531 531 531 531 531 531 531 531 531 531 531 531 531 531 518 543 518 543 531 532 513 513 534 688 534 513 522 546 531 559 525 546 531 531 531 531 531 531
531 531 531 531 531 531 531 531 531 531 531 531 531 535 531 531 547 524 513 513 534 534 534 534 534 534 534 538 539 519 531 559 541 542 542 519 541 542 542 519 531 531 531 531 531 531 531 531 531 531 531 531 531 518 542 542 543 518 543 531 518 540 513 513 513 534 513 513 530 531 531 531 533 531 531 531 531 531 531 531
531 531 531 531 531 531 531 531 531 531 531 531 531 535 531 531 531 532 513 534 534 534 534 534 534 534 534 513 513 538 519 531 531 531 559 541 542 519 559 541 542 542 519 531 531 531 531 531 518 542 542 542 542 543 518 542 542 543 531 518 543 513 513 513 513 513 513 513 530 531 525 526 546 531 531 531 531 531 531 531
531 531 531 531 531 531 531 531 531 531 531 531 531 535 531 531 531 532 513 534 534 534 534 534 534 534 534 534 513 513 538 539 539 519 531 559 531 541 542 542 542 519 541 542 542 542 542 542 543 559 518 542 542 542 543 531 518 539 539 540 513 513 513 513 513 513 513 522 546 531 533 531 531 531 531 531 531 531 531 531
531 531 531 531 531 531 531 531 531 531 531 531 531 547 527 559 531 547 524 513 534 534 534 534 534 534 534 534 534 534 513 513 513 538 539 539 539 539 539 539 519 541 542 542 613 614 615 542 542 542 543 518 539 539 539 539 540 513 513 513 513 513 513 513 513 513 513 530 559 525 546 531 531 531 531 531 531 531 531 531
531 531 531 531 531 531 531 518 644 644 644 644 519 531 547 527 531 531 547 523 523 524 534 534 534 534 534 534 534 534 534 513 513 513 513 513 513 513 513 513 538 539 539 539 621 622 623 539 539 539 539 540 513 513 513 513 513 513 513 513 513 513 513 513 513 513 513 530 531 533 531 531 531 531 531 531 531 531 531 531
531 531 531 531 531 531 518 646 681 649 649 681 645 519 531 523 526 527 531 531 531 547 523 524 513 513 513 534 534 534 513 513 513 513 513 513 513 513 513 513 513 513 534 534 534 534 534 534 513 513 513 513 513 513 534 534 534 513 513 513 513 513 513 513 513 513 522 546 525 546 531 531 531 531 531 531 531 531 531 531
531 531 531 531 531 518 646 681 650 534 534 648 681 654 531 531 531 523 526 526 527 559 531 547 523 524 513 513 513 513 513 513 513 513 513 534 534 534 513 513 534 534 534 534 534 534 534 534 534 534 513 513 513 513 534 534 534 534 534 534 513 513 513 513 513 522 546 531 533 531 531 531 531 531 531 531 531 531 531 531
531 531 531 518 644 646 681 642 534 534 534 534 640 654 531 531 531 531 531 531 547 526 526 527 531 547 523 523 523 524 513 513 513 513 513 513 513 534 534 534 534 534 534 534 534 534 534 534 534 534 534 534 534 534 534 534 534 534 534 513 513 513 522 523 523 546 531 525 546 531 531 531 531 531 531 531 531 531 531 531
531 531 531 653 681 681 681 642 534 534 534 534 640 654 531 531 531 531 531 531 531 531 531 535 531 559 531 531 531 547 524 513 513 513 513 513 513 513 513 534 534 534 534 534 534 534 534 534 534 534 534 534 534 534 534 534 513 513 513 513 513 522 546 531 531 559 531 533 531 531 531 531 531 531 531 531 531 531 531 531
531 531 531 653 641 681 681 681 634 534 534 632 681 654 531 531 531 531 531 531 531 531 531 547 526 526 526 526 526 527 547 523 524 513 513 513 513 513 513 513 534 534 534 534 534 534 534 534 534 534 534 534 513 513 513 513 513 513 522 523 523 546 531 531 525 526 526 546 531 531 531 531 531 531 531 531 531 531 531 531
531 531 531 653 641 641 637 638 681 633 633 681 637 523 531 531 531 531 531 531 531 531 531 531 531 531 531 531 531 535 531 531 547 523 523 524 513 513 513 513 513 534 534 534 534 534 534 534 534 534 513 513 513 513 513 513 522 523 546 531 531 531 531 531 533 531 531 531 531 531 531 531 531 531 531 531 531 531 531 531
531 531 531 653 641 641 654 523 636 636 636 636 523 531 531 531 531 531 531 531 531 531 531 531 531 531 531 531 531 547 526 526 526 527 531 547 523 523 524 513 513 513 513 513 513 513 513 513 513 513 513 513 513 513 522 523 546 531 531 559 531 525 526 526 546 531 531 531 531 531 531 531 531 531 531 531 531 531 531 531
531 531 531 653 641 641 654 531 531 531 531 531 531 531 531 531 531 531 531 531 531 531 531 531 531 531 531 531 531 531 531 531 531 535 531 559 531 531 547 523 524 513 513 513 513 513 513 513 522 523 523 523 523 523 546 531 531 531 531 531 531 533 531 531 531 531 531 531 531 531 531 531 531 531 531 531 531 531 531 531
531 531 531 653 641 641 645 644 519 531 531 531 531 531 531 531 531 531 531 531 531 531 531 531 531 531 531 531 531 531 531 531 531 547 526 526 526 526 526 527 547 523 523 523 523 523 523 523 546 531 531 531 531 531 559 531 531 525 526 526 526 546 531 531 531 531 531 531 531 531 531 531 531 531 531 531 531 531 531 531
531 531 531 653 641 641 641 641 645 644 519 531 531 531 531 531 531 531 531 531 531 531 531 531 531 531 531 531 531 531 531 531 531 531 531 531 531 531 531 535 531 559 531 531 531 531 531 531 531 559 531 525 526 526 526 526 526 546 531 531 531 531 531 531 531 531 531 531 531 531 531 531 531 531 531 531 531 531 531 531
531 531 531 653 641 641 641 641 641 641 654 531 531 531 531 531 531 531 531 531 531 531 531 531 531 531 531 531 531 531 531 531 531 531 531 531 531 531 531 547 526 526 526 526 526 526 526 526 526 526 526 546 531 531 531 531 531 531 531 531 531 531 531 531 531 531 531 531 531 531 531 531 531 531 531 531 531 531 531 531
531 531 531 653 641 641 641 641 641 681 654 531 531 531 531 531 531 531 531 531 531 531 531 531 531 531 531 531 531 531 531 531 531 531 531 531 531 531 531 531 531 531 531 531 531 531 531 531 531 531 531 531 531 531 531 531 531 531 531 531 531 531 531 531 531 531 531 531 531 531 531 531 531 531 531 531 531 531 531 531
531 531 531 636 638 641 641 641 641 641 654 531 531 531 531 531 531 531 531 531 531 531 531 531 531 531 531 531 531 531 531 531 531 531 531 531 531 531 531 531 531 531 531 531 531 531 531 531 531 531 531 531 531 531 531 531 531 531 531 531 531 531 531 531 531 531 531 531 531 531 531 531 531 531 531 531 531 531 531 531
531 531 531 531 523 636 636 636 636 523 523 531 531 531 531 531 531 531 531 531 531 531 531 531 531 531 531 531 531 531 531 531 531 531 531 531 531 531 531 531 531 531 531 531 531 531 531 531 531 531 531 531 531 531 531 531 531 531 531 531 531 531 531 531 531 531 531 531 531 531 531 531 531 531 531 531 531 531 531 531