Underwater1_Layout (80x80)
531 531 531 531 531 531 531 531 531 531 531 531 531 531 531 531 531 531 531 531 531 531 531 531 531 531 531 531 531 531 531 531 531 531 531 531 531 531 531 531 531 531 531 531 531 531 531 531 531 531 531 531 531 531 531 531 531 531 531 531 531 531 531 531 531 531 531 531 531 531 531 531 531 531 531 531 531 531 531 531
531 531 531 531 531 531 531 531 531 531 531 531 531 531 531 531 531 531 531 531 531 531 531 531 531 531 531 531 531 531 531 531 531 531 531 531 531 531 531 531 531 531 531 531 531 531 531 531 531 531 531 531 531 531 531 531 531 531 531 531 531 531 531 531 531 531 531 531 531 531 531 531 531 531 531 531 531 531 531 531
531 531 531 531 531 531 531 531 531 518 539 539 519 531 531 531 531 531 531 531 531 531 531 531 531 531 531 531 531 531 531 531 531 531 531 531 531 531 531 531 531 531 531 531 531 531 531 531 531 531 531 531 531 531 531 531 531 531 531 531 531 531 531 531 531 531 531 531 531 531 531 531 531 531 531 531 531 531 531 531
531 531 531 531 531 531 531 531 518 540 534 534 538 644 644 644 644 644 644 644 644 644 644 644 644 644 644 644 644 644 644 644 644 644 644 519 531 531 531 531 531 518 539 539 519 531 531 531 531 531 531 531 531 531 531 531 531 531 531 531 531 531 531 531 531 531 531 531 531 531 531 531 531 531 531 531 531 531 531 531
531 531 531 531 531 531 531 531 532 534 534 534 534 640 681 681 641 681 681 641 641 641 641 641 641 641 641 641 681 681 641 641 641 681 681 645 644 644 644 644 644 540 534 534 538 644 644 644 644 519 531 531 531 531 531 531 531 531 531 531 531 531 531 531 531 531 531 531 531 531 531 531 531 531 531 531 531 531 531 531
531 531 531 531 531 531 531 531 532 534 534 534 534 640 681 641 641 641 641 641 681 681 641 641 681 681 681 641 641 641 641 641 681 681 681 681 641 641 641 641 642 534 688 534 534 640 681 681 681 645 519 531 531 531 531 531 531 531 531 531 531 531 531 531 531 531 531 531 531 531 531 531 531 531 531 531 531 531 531 531
531 531 531 531 531 531 531 531 547 524 534 534 522 546 547 547 638 641 641 641 641 641 641 641 641 681 681 641 641 641 641 641 681 681 681 641 641 641 641 641 642 534 534 534 534 640 681 681 681 681 654 531 531 531 531 531 531 531 531 531 531 531 531 531 531 531 531 531 531 531 531 531 531 531 531 531 531 531 531 531
531 531 531 531 531 531 531 531 531 547 523 523 546 531 531 531 547 547 547 547 547 638 641 641 641 641 641 641 641 681 681 681 681 637 547 547 547 547 547 547 547 524 534 534 522 636 636 638 681 641 654 531 531 531 531 531 531 531 531 531 531 531 531 531 531 531 531 531 531 531 531 531 531 531 531 531 531 531 531 531
531 531 531 531 531 531 531 531 531 531 531 531 531 531 531 531 531 531 531 531 531 547 547 547 638 641 641 681 681 681 681 681 681 654 531 531 531 531 531 531 531 547 523 523 546 531 531 653 641 641 654 531 531 531 531 531 531 531 531 531 531 531 531 531 531 531 531 518 539 539 519 531 531 531 531 531 531 531 531 531
531 531 531 531 531 531 531 531 531 531 531 531 531 531 531 531 531 531 531 531 531 531 531 531 547 547 547 547 547 547 638 681 681 654 531 531 531 531 531 531 531 531 531 531 531 531 531 653 641 641 654 531 531 531 531 531 531 518 644 644 644 644 644 644 644 644 644 540 534 534 538 519 531 531 531 531 531 531 531 531
531 531 531 531 531 531 531 531 531 531 531 531 531 531 531 531 531 531 531 531 531 531 531 531 531 531 531 531 531 531 653 681 681 654 531 531 531 531 531 531 531 531 531 531 531 531 531 653 641 641 645 519 531 531 531 531 531 653 641 641 681 681 681 681 681 681 642 534 534 534 534 530 531 531 531 531 531 531 531 531
531 531 531 531 531 531 531 531 531 531 531 531 531 531 531 531 531 531 531 531 531 531 531 531 531 531 531 531 531 531 653 681 681 645 519 531 531 531 531 531 531 531 531 531 531 531 531 653 641 641 641 654 531 531 531 531 518 646 641 641 641 681 681 681 681 681 642 534 534 534 534 530 531 531 531 531 531 531 531 531
531 531 531 531 531 531 531 531 531 531 531 531 531 531 531 531 531 531 531 531 531 531 531 531 531 531 531 531 531 531 653 641 681 681 654 531 531 531 531 531 531 531 531 531 531 531 531 653 641 641 641 654 531 531 531 531 653 641 641 641 641 641 637 636 636 636 636 524 534 534 522 546 531 531 531 531 531 531 531 531
531 531 531 531 531 531 531 531 531 531 531 531 531 531 531 531 531 531 531 531 531 531 531 531 531 531 531 531 531 531 653 641 681 681 645 519 531 531 531 531 531 531 531 531 531 531 531 653 641 641 641 654 531 531 531 531 653 641 641 641 641 641 654 531 531 531 531 547 523 523 546 531 531 531 531 531 531 531 531 531
531 531 531 531 531 531 531 531 531 531 531 531 531 531 531 531 531 531 531 531 531 531 531 531 531 531 531 531 531 531 653 641 641 681 681 645 519 531 531 531 531 531 531 531 531 531 531 653 681 641 641 654 531 531 531 531 653 641 641 641 641 641 654 531 531 531 531 531 531 531 531 531 531 531 531 531 531 531 531 531
531 531 531 531 531 531 531 531 531 531 531 531 531 531 531 531 531 531 531 531 531 531 531 531 531 531 531 531 531 531 653 641 641 641 681 681 645 644 644 644 644 644 644 644 644 644 644 646 681 681 641 654 531 531 531 531 653 641 641 641 641 641 654 531 531 531 531 531 531 531 531 531 531 531 531 531 531 531 531 531
531 531 531 531 531 531 531 531 531 531 531 531 531 531 531 531 531 531 531 531 531 531 531 531 531 531 531 531 531 531 653 641 641 641 681 681 681 681 681 681 681 641 641 641 641 641 641 681 681 681 681 654 531 531 531 531 653 641 641 641 641 641 654 531 531 531 531 531 531 531 531 531 531 531 531 531 531 531 531 531
531 531 531 531 531 531 531 531 531 531 531 531 531 531 531 531 531 531 531 531 531 531 531 531 531 531 531 531 531 531 547 636 638 641 641 681 641 641 641 681 681 681 641 641 641 641 681 681 681 681 681 654 531 531 531 531 547 638 641 641 641 681 654 531 531 531 531 531 531 531 531 531 531 531 531 531 531 531 531 531
531 531 531 531 531 531 531 531 531 531 531 531 531 531 531 531 531 531 531 531 531 531 531 531 531 531 531 531 531 531 531 531 547 636 636 638 641 641 641 641 641 681 681 681 681 681 681 681 681 681 681 654 531 531 531 531 531 653 641 681 681 681 654 531 518 539 539 519 531 531 531 531 531 531 531 531 531 531 531 531
531 531 531 531 531 531 531 531 531 531 531 531 531 531 531 531 531 531 531 531 531 531 531 531 531 531 531 531 531 531 531 531 531 531 531 547 636 636 636 636 636 636 636 636 636 636 636 638 681 681 681 654 531 531 531 531 531 547 638 681 681 681 645 644 540 534 534 538 519 531 531 531 531 531 531 531 531 531 531 531
531 531 531 531 531 531 531 531 531 531 531 531 531 531 531 531 531 531 531 531 531 531 531 531 531 531 531 531 531 531 531 531 531 531 531 531 531 531 531 531 531 531 531 531 531 531 531 547 638 681 681 654 531 531 531 531 531 531 653 681 681 681 681 642 534 534 534 534 530 531 531 531 531 531 531 531 531 531 531 531
531 531 531 531 531 531 531 531 531 531 531 531 531 531 531 531 531 531 531 531 531 531 531 531 531 531 531 531 531 531 531 531 531 531 531 531 531 531 531 531 531 531 531 531 531 531 531 531 653 681 681 654 531 531 531 531 531 531 547 638 681 681 681 642 534 534 534 534 530 531 531 531 531 531 531 531 531 531 531 531
531 531 531 531 531 531 531 531 531 531 531 531 531 531 531 531 531 531 531 531 531 531 531 531 531 531 531 531 531 531 531 531 531 531 531 531 531 531 531 531 531 531 531 531 531 531 531 531 653 681 641 654 531 531 531 531 531 531 531 547 636 636 636 547 524 534 534 522 546 531 531 531 531 531 531 531 531 531 531 531
531 531 531 531 531 531 531 531 531 531 531 531 531 531 531 531 531 531 531 531 531 531 531 531 531 531 531 531 531 531 531 531 531 531 531 531 531 531 531 531 531 531 531 531 531 531 531 531 653 681 641 654 531 531 531 531 531 531 531 531 531 531 531 531 547 523 523 546 531 531 531 531 531 531 531 531 531 531 531 531
531 531 531 531 531 531 531 531 531 531 518 644 644 644 644 644 644 644 644 519 531 531 531 531 531 531 531 531 531 531 531 531 531 531 531 531 531 531 531 531 531 531 531 531 531 531 531 531 653 641 641 654 531 531 531 531 531 531 531 531 531 531 531 531 531 531 531 531 531 531 531 531 531 531 531 531 531 531 531 531
531 531 531 531 531 531 531 531 531 531 653 641 641 641 641 641 641 641 641 654 531 531 531 531 531 531 531 531 531 531 531 531 531 531 531 531 531 531 531 531 531 531 531 531 531 531 531 531 653 641 641 654 531 531 531 531 531 531 531 531 531 531 531 531 531 531 531 531 531 531 531 531 531 531 531 531 531 531 531 531
531 531 531 531 531 531 531 531 531 518 646 641 641 641 641 641 641 641 641 645 519 531 531 531 531 531 531 531 531 531 531 531 531 531 531 531 531 531 531 531 531 531 531 531 531 531 531 531 653 641 641 654 531 531 531 531 531 531 531 531 531 531 531 531 531 531 531 531 531 531 531 531 531 531 531 531 531 531 531 531
531 531 531 531 531 531 531 531 518 646 641 641 641 641 641 641 641 641 641 641 645 644 519 531 531 531 531 531 531 531 531 531 531 531 531 531 531 531 531 531 531 531 531 531 531 531 531 531 653 641 641 654 531 531 531 531 531 531 531 531 531 531 531 531 531 531 531 531 531 531 531 531 531 531 531 531 531 531 531 531
531 531 531 531 531 531 531 531 653 641 641 641 641 681 681 681 641 641 641 641 641 641 654 531 531 531 531 531 531 531 531 531 531 531 531 531 531 531 531 531 531 531 531 531 531 531 531 531 653 681 641 654 531 531 531 531 531 531 531 531 531 531 531 531 531 531 531 531 531 531 531 531 531 531 531 531 531 531 531 531
531 531 531 531 531 531 531 518 646 641 641 641 641 681 681 681 681 641 641 641 641 641 654 531 531 531 531 531 531 518 539 539 519 531 531 531 531 531 531 531 531 531 531 531 531 531 531 518 646 681 641 654 531 531 531 531 531 531 531 531 531 531 531 531 531 531 531 531 531 531 531 531 531 531 531 531 531 531 531 531
531 531 531 531 531 531 531 653 641 641 641 641 641 641 641 681 681 681 641 641 641 641 645 519 531 531 531 531 518 540 534 534 538 519 531 531 531 531 531 531 531 531 531 531 531 531 531 653 641 681 681 654 531 531 531 531 531 531 531 531 531 531 531 531 531 531 531 531 531 531 531 531 531 531 531 531 531 531 531 531
531 531 531 531 531 531 531 653 641 641 641 641 641 641 641 641 641 681 641 641 641 641 641 654 531 531 531 531 532 534 534 534 534 530 531 531 531 531 531 531 531 531 531 531 531 531 531 653 641 681 681 654 531 531 531 531 531 531 531 531 531 531 531 531 518 539 539 519 531 531 531 531 531 531 531 531 531 531 531 531
531 531 531 531 531 531 531 653 641 641 641 641 641 649 649 641 641 681 681 641 641 641 641 654 531 531 531 531 532 534 534 534 534 530 531 531 531 531 531 531 531 531 531 531 531 531 531 653 641 681 681 654 531 531 531 531 531 531 531 531 531 531 531 518 540 534 534 538 519 531 531 531 531 531 531 531 531 531 531 531
531 531 531 531 531 531 531 653 641 641 641 641 642 534 534 640 681 681 681 681 681 641 641 654 531 531 531 531 547 524 534 534 522 546 531 531 531 531 531 531 531 531 531 531 531 531 531 653 681 681 637 546 531 531 531 531 531 531 531 531 531 531 531 532 534 534 534 534 530 531 531 531 531 531 531 531 531 531 531 531
531 531 531 531 531 531 531 653 641 641 641 641 642 534 534 640 681 641 641 681 681 641 641 654 531 531 531 531 531 653 633 633 654 531 531 531 531 531 531 531 531 531 531 518 539 539 519 653 681 681 654 531 531 531 531 531 531 531 531 531 531 531 531 532 534 534 688 534 530 531 531 531 531 531 531 531 531 531 531 531
531 531 531 531 531 531 531 653 641 641 641 641 641 633 633 681 641 641 641 681 681 641 641 654 531 531 531 531 531 653 681 681 654 531 531 531 531 531 531 531 531 531 518 540 534 534 538 646 681 681 654 531 531 531 531 531 531 531 531 531 531 531 531 547 524 534 534 522 546 531 531 531 531 531 531 531 531 531 531 531
531 531 531 531 531 531 531 546 638 641 641 641 641 641 641 641 641 641 641 681 641 641 641 654 531 531 531 531 531 653 681 681 654 531 531 531 531 531 531 531 531 531 532 534 534 688 534 640 681 681 654 531 531 531 531 531 531 531 531 531 531 531 531 531 547 523 523 546 518 539 539 519 531 531 531 531 531 531 531 531
531 531 531 531 531 531 531 531 653 641 641 641 641 641 641 641 641 641 641 641 641 637 636 546 531 531 531 531 518 646 641 681 654 531 531 531 531 531 531 531 531 531 532 534 534 534 534 640 681 681 654 531 531 531 531 531 531 531 531 531 531 531 531 531 531 531 531 518 540 534 534 538 519 531 531 531 531 531 531 531
531 531 531 531 531 531 531 531 653 641 641 641 641 641 641 641 641 641 641 641 641 654 531 531 531 531 531 531 653 641 641 641 654 531 531 531 531 531 531 531 531 531 547 524 534 534 522 636 636 636 546 531 531 531 531 531 531 531 531 531 531 531 531 531 531 531 531 532 534 534 534 534 530 531 531 531 531 531 531 531
531 531 531 531 531 531 531 531 653 641 641 641 641 641 641 641 641 641 641 641 641 654 531 531 531 531 531 531 653 641 641 641 654 531 531 531 531 531 531 531 531 531 531 547 523 523 546 531 531 531 531 531 531 531 531 531 531 531 531 531 531 531 531 531 531 531 531 532 534 534 534 534 530 531 531 531 531 531 531 531
531 531 531 531 531 531 531 531 546 638 641 641 641 641 681 641 641 641 641 637 636 546 531 531 531 531 531 531 653 641 641 641 654 531 531 531 531 531 531 531 531 531 531 531 531 531 531 531 531 531 531 531 531 531 531 531 531 531 531 531 531 531 531 531 531 531 531 547 524 534 534 522 546 531 531 531 531 531 531 531
531 531 531 531 531 531 531 531 531 546 636 638 641 641 641 641 641 637 636 546 531 531 531 531 531 531 531 531 653 641 641 637 636 531 531 531 531 531 531 531 531 531 531 531 531 531 531 531 531 531 531 531 531 531 531 531 531 531 531 531 531 531 531 531 531 531 531 531 547 523 523 546 531 531 531 531 531 531 531 531
531 531 531 531 531 531 531 531 531 531 531 546 636 636 636 636 636 546 531 531 531 531 531 531 531 531 531 531 653 681 681 654 531 531 531 531 531 531 531 531 531 531 531 531 531 531 531 531 531 531 531 531 531 531 531 531 531 531 531 531 531 531 531 531 531 531 531 531 531 531 531 531 531 531 531 531 531 531 531 531
531 531 531 531 531 531 531 531 531 531 531 531 531 531 531 531 531 531 531 531 531 531 531 531 531 531 531 531 653 681 681 654 531 531 531 531 531 531 531 531 531 531 531 531 531 531 531 531 531 531 531 531 531 531 531 531 531 531 531 531 531 531 531 531 531 531 531 531 531 531 531 531 531 531 531 531 531 531 531 531
531 531 531 531 531 531 531 531 531 531 531 531 531 531 531 531 531 531 531 531 531 531 531 531 531 531 531 531 653 681 681 654 531 531 531 531 531 531 531 531 531 531 531 531 531 531 531 531 531 531 531 531 531 531 531 531 531 531 531 531 531 531 531 531 531 531 531 531 531 531 531 531 531 531 531 531 531 531 531 531
531 531 531 531 531 531 531 531 531 531 531 531 531 531 531 531 531 531 531 531 531 531 531 531 531 531 531 531 653 681 681 645 519 531 531 531 531 531 531 531 531 531 531 531 531 531 531 531 531 531 531 531 531 531 531 531 531 531 531 531 531 531 531 531 531 531 531 531 531 531 531 531 531 531 531 531 531 531 531 531
531 531 531 531 531 531 531 531 531 531 531 531 531 531 531 531 531 531 531 531 531 531 531 531 531 531 531 531 653 681 681 681 645 644 644 644 644 644 644 644 644 644 519 531 531 531 531 531 531 531 531 518 539 539 519 531 531 531 531 531 531 531 531 531 531 531 531 531 531 531 531 531 531 531 531 531 531 531 531 531
531 531 531 531 531 531 531 531 531 531 531 531 531 531 531 531 531 531 531 531 531 531 531 531 531 531 531 531 653 681 681 681 681 681 681 681 681 681 641 641 641 641 645 644 519 531 531 531 531 531 518 540 534 534 538 519 531 531 531 531 531 531 531 531 531 531 531 531 531 531 531 531 531 531 531 531 531 531 531 531
531 531 531 531 531 531 531 531 531 531 531 531 531 531 531 531 531 531 531 531 531 531 531 531 531 531 531 518 646 681 681 681 681 681 681 681 681 641 641 641 641 641 641 641 645 519 531 531 531 531 532 534 534 534 534 530 531 531 531 531 531 531 531 531 531 531 531 531 531 531 531 531 531 531 531 531 531 531 531 531
531 531 531 531 531 531 531 531 531 531 531 531 531 531 531 531 531 531 531 531 531 531 531 531 531 531 531 653 681 681 681 681 681 637 636 636 638 641 641 641 641 641 641 641 641 654 531 531 531 531 532 534 534 534 534 530 531 531 531 531 531 531 531 531 531 531 531 531 531 531 531 531 531 531 531 531 531 531 531 531
531 531 531 531 531 531 531 531 531 531 531 531 531 531 531 531 531 531 531 531 531 531 531 531 531 531 531 653 681 681 681 681 637 546 531 531 653 641 641 641 641 641 641 641 641 654 531 531 531 531 547 524 534 534 522 546 531 531 531 531 531 531 518 539 539 519 531 531 531 531 531 531 531 531 531 531 531 531 531 531
531 531 531 531 531 531 531 531 531 531 531 531 531 531 531 531 531 531 531 531 531 531 531 531 531 531 518 646 681 681 681 681 654 531 531 531 546 638 641 641 641 641 681 641 641 654 531 531 531 531 531 547 523 523 546 531 531 531 531 531 531 518 540 534 534 538 519 531 531 531 531 531 531 531 531 531 531 531 531 531
531 531 531 531 531 531 531 531 531 531 531 531 531 531 531 531 531 531 531 531 531 531 531 531 531 531 653 681 681 681 681 637 546 531 531 531 531 546 636 638 641 641 641 641 637 546 531 531 531 531 531 531 531 531 531 531 531 531 531 531 531 532 534 534 534 534 530 531 531 531 531 531 531 531 531 531 531 531 531 531
531 531 531 531 531 531 531 531 531 531 531 531 531 531 531 531 531 531 531 531 531 531 531 531 531 531 653 681 681 681 637 546 531 531 531 531 531 531 531 546 636 636 636 636 636 531 531 531 531 531 531 531 531 531 531 531 531 531 531 531 531 532 534 534 534 534 530 531 531 531 531 531 531 531 531 531 531 531 531 531
531 531 531 531 531 531 531 531 531 531 531 531 531 531 531 531 531 531 531 531 531 531 531 531 531 531 653 681 681 681 654 531 531 531 531 531 531 531 531 531 531 531 531 531 531 531 531 531 531 531 531 531 531 531 531 531 531 531 531 531 531 532 534 534 688 534 530 531 531 531 531 531 531 531 531 531 531 531 531 531
531 531 531 531 531 531 531 531 531 531 531 531 531 531 531 531 531 531 531 531 531 531 531 531 531 531 653 681 681 681 645 519 531 531 531 531 531 531 531 531 531 531 531 531 531 531 531 531 531 531 531 531 531 531 531 531 531 531 531 531 531 547 524 534 534 522 546 531 531 531 531 531 531 531 531 531 531 531 531 531
531 531 531 531 531 531 531 531 531 531 531 531 531 531 531 531 531 531 531 531 531 531 531 531 531 531 653 681 681 681 681 654 531 531 531 531 531 531 531 531 531 531 531 531 531 531 531 531 531 531 531 531 531 531 518 539 539 519 531 531 531 531 547 523 523 546 531 531 531 531 531 531 531 531 531 531 531 531 531 531
531 531 531 531 531 531 531 531 531 531 531 531 531 531 531 531 531 531 531 531 531 531 531 531 531 531 653 681 681 681 681 645 519 531 531 531 531 531 531 531 531 531 531 531 531 531 531 531 531 531 531 531 531 518 540 534 534 538 519 531 531 531 531 531 531 531 531 531 531 531 531 531 531 531 531 531 531 531 531 531
531 531 531 531 531 531 531 531 531 531 531 531 531 531 531 531 531 531 531 531 531 531 531 531 531 531 546 638 681 681 681 681 654 531 531 531 531 531 531 531 531 531 531 531 531 531 531 531 531 531 531 531 531 532 534 534 534 534 530 531 531 531 531 531 531 531 531 531 531 531 531 531 531 531 531 531 531 531 531 531
531 531 531 531 531 531 531 531 531 518 539 539 519 531 531 531 531 531 531 531 531 531 531 531 531 531 531 546 638 681 681 681 654 531 531 531 531 531 531 531 531 531 531 531 531 531 531 531 531 531 531 531 531 532 534 534 534 534 530 531 531 531 531 531 531 531 531 531 531 531 531 531 531 531 531 531 531 531 531 531
531 531 531 531 531 531 531 531 518 540 534 534 538 644 644 644 644 644 644 644 519 531 531 531 531 531 531 531 546 638 681 681 654 531 531 531 531 531 531 531 531 531 531 531 531 531 531 531 531 531 531 531 531 653 634 534 534 522 546 531 531 531 531 531 531 531 531 531 531 531 531 531 531 531 531 531 531 531 531 531
531 531 531 531 531 531 531 531 532 534 534 534 534 640 681 681 641 641 641 641 645 644 644 519 531 531 531 531 531 653 681 681 654 531 531 531 531 531 531 531 531 531 531 531 531 531 531 531 531 531 531 531 531 653 681 633 633 654 531 531 531 531 531 531 531 531 531 531 531 531 531 531 531 531 531 531 531 531 531 531
531 531 531 531 531 531 531 531 532 534 534 534 534 640 681 681 641 641 641 641 641 641 641 645 644 519 531 531 531 653 681 681 654 531 531 531 531 531 531 531 531 531 531 531 531 531 531 531 531 531 531 531 531 547 638 681 681 654 531 531 531 531 531 531 531 531 531 531 531 518 539 539 519 531 531 531 531 531 531 531
531 531 531 531 531 531 531 531 547 524 534 534 522 546 636 636 636 636 638 641 641 641 641 641 641 654 531 531 531 653 649 649 654 531 531 531 531 531 531 531 531 531 531 531 531 531 531 531 531 531 531 531 531 531 653 641 681 654 531 531 531 531 531 531 531 531 531 531 518 540 534 534 538 519 531 531 531 531 531 531
531 531 531 531 531 531 531 531 531 547 523 523 546 531 531 531 531 531 547 636 638 641 641 641 641 645 644 644 644 540 534 534 538 519 531 531 531 531 531 531 531 531 531 531 531 531 531 531 531 531 531 531 531 531 653 641 641 645 519 531 531 531 531 531 531 531 531 531 532 534 688 534 534 530 531 531 531 531 531 531
531 531 531 531 531 531 531 531 531 531 531 531 531 531 531 531 531 531 531 531 653 681 681 681 681 681 681 681 642 534 534 534 534 530 531 531 531 531 531 531 531 531 531 531 531 531 531 531 531 531 531 531 531 531 653 641 641 641 654 531 531 531 531 531 531 531 531 531 532 534 534 534 534 530 531 531 531 531 531 531
531 531 531 531 531 531 531 531 531 531 531 531 531 531 531 531 531 531 531 531 547 636 638 681 681 681 681 681 642 534 534 534 534 530 531 531 531 531 531 531 531 531 531 531 531 531 531 531 531 531 531 531 531 531 653 641 641 641 654 531 531 531 531 531 531 531 531 531 547 524 534 534 522 546 531 531 531 531 531 531
531 531 531 531 531 531 531 531 531 531 531 531 531 531 531 531 531 531 531 531 531 531 636 636 636 636 636 636 547 524 534 534 522 546 531 531 531 531 531 531 531 531 531 531 531 531 531 531 531 531 531 531 531 531 653 641 641 641 654 531 531 531 531 531 531 531 531 531 531 547 523 523 546 531 531 531 531 531 531 531
531 531 531 531 531 531 531 531 531 531 531 531 531 531 531 531 531 531 531 531 531 531 531 531 531 531 531 531 531 547 523 523 546 531 531 531 531 531 531 531 531 531 531 531 531 531 531 531 531 531 531 531 531 531 653 681 641 641 654 531 531 531 531 531 531 531 531 531 531 531 531 531 531 531 531 531 531 531 531 531
531 531 531 531 531 531 531 531 531 531 531 531 531 531 531 531 531 531 531 531 531 531 531 531 531 531 531 531 531 531 531 531 531 531 531 531 531 531 531 531 531 531 531 531 531 531 531 531 531 531 531 531 531 531 653 681 681 641 654 531 531 531 531 531 531 531 531 531 531 531 531 531 531 531 531 531 531 531 531 531
531 531 531 531 531 531 531 531 531 531 531 531 531 531 531 531 531 531 531 531 531 531 531 531 531 531 531 531 531 531 531 531 531 531 531 531 531 531 531 531 531 531 531 531 531 531 531 531 531 531 531 518 539 539 646 681 681 637 546 531 531 531 531 531 531 531 531 531 531 531 531 531 531 531 531 531 531 531 531 531
531 531 531 531 531 531 531 531 531 531 531 531 531 531 531 531 531 531 531 531 531 531 531 531 531 531 531 531 531 531 531 531 531 531 531 531 531 531 531 531 531 531 531 531 531 531 531 531 531 531 518 540 534 534 648 681 681 654 531 531 531 531 531 531 531 531 531 531 531 531 531 531 531 531 531 531 531 531 531 531
531 531 531 531 531 531 531 531 531 531 531 531 531 531 531 531 531 531 531 531 531 531 531 531 531 531 531 531 531 531 531 531 531 531 531 531 531 531 531 531 531 531 531 531 531 531 531 531 531 531 532 534 534 534 534 648 649 654 531 531 531 531 531 531 531 531 531 531 531 531 531 531 531 531 531 531 531 531 531 531
531 531 531 531 531 531 531 531 531 531 531 531 531 531 531 531 531 531 531 531 531 531 531 531 531 531 531 531 531 531 531 531 531 531 531 531 531 531 531 531 531 531 531 531 531 531 531 531 531 531 532 534 534 534 534 522 523 546 531 531 531 531 531 531 531 531 531 531 531 531 531 531 531 531 531 531 531 531 531 531
531 531 531 531 531 531 531 531 531 531 531 531 531 531 531 531 531 531 531 531 531 531 531 531 531 531 531 531 531 531 531 531 531 531 531 531 531 531 531 531 531 531 531 531 531 531 531 531 531 531 547 524 534 534 522 546 531 531 531 531 531 531 531 531 531 531 531 531 531 531 531 531 531 531 531 531 531 531 531 531
531 531 531 531 531 531 531 531 531 531 531 531 531 531 531 531 531 531 531 531 531 531 531 531 531 531 531 531 531 531 531 531 531 531 531 531 531 531 531 531 531 531 531 531 531 531 531 531 531 531 531 547 523 523 546 531 531 531 531 531 531 531 531 531 531 531 531 531 531 531 531 531 531 531 531 531 531 531 531 531
531 531 531 531 531 531 531 531 531 531 531 531 531 531 531 531 531 531 531 531 531 531 531 531 531 531 531 531 531 531 531 531 531 531 531 531 531 531 531 531 531 531 531 531 531 531 531 531 531 531 531 531 531 531 531 531 531 531 531 531 531 531 531 531 531 531 531 531 531 531 531 531 531 531 531 531 531 531 531 531
531 531 531 531 531 531 531 531 531 531 531 531 531 531 531 531 531 531 531 531 531 531 531 531 531 531 531 531 531 531 531 531 531 531 531 531 531 531 531 531 531 531 531 531 531 531 531 531 531 531 531 531 531 531 531 531 531 531 531 531 531 531 531 531 531 531 531 531 531 531 531 531 531 531 531 531 531 531 531 531
531 531 531 531 531 531 531 531 531 531 531 531 531 531 531 531 531 531 531 531 531 531 531 531 531 531 531 531 531 531 531 531 531 531 531 531 531 531 531 531 531 531 531 531 531 531 531 531 531 531 531 531 531 531 531 531 531 531 531 531 531 531 531 531 531 531 531 531 531 531 531 531 531 531 531 531 531 531 531 531
531 531 531 531 531 531 531 531 531 531 531 531 531 531 531 531 531 531 531 531 531 531 531 531 531 531 531 531 531 531 531 531 531 531 531 531 531 531 531 531 531 531 531 531 531 531 531 531 531 531 531 531 531 531 531 531 531 531 531 531 531 531 531 531 531 531 531 531 531 531 531 531 531 531 531 531 531 531 531 531