Underwater4_Layout (120x40)
531 531 531 535 531 531 535 531 535 531 535 531 535 531 525 526 523 531 531 531 531 531 531 531 531 531 535 532 529 574 575 599 596 598 594 597 570 528 533 541 542 542 542 542 542 519 533 531 531 531 531 531 531 531 531 533 531 531 531 531 531 531 531 531 531 531 541 542 542 542 542 542 542 542 542 542 542 542 542 542 542 543 531 535 531 535 531 535 535 531 531 531 531 531 531 531 531 531 531 531 531 531 531 531 531 531 531 531 531 531 531 531 531 531 531 531 531 531 531 531
531 531 531 535 531 531 535 531 535 531 535 531 535 531 533 531 531 531 531 531 518 542 542 542 542 542 543 532 529 574 575 599 596 598 594 597 570 528 533 531 531 531 531 531 531 533 541 542 542 542 542 542 519 531 531 541 542 542 542 542 542 542 542 542 542 519 531 531 531 531 531 531 531 531 531 531 531 531 531 531 531 531 531 535 531 535 531 535 535 531 531 531 531 531 531 531 531 531 531 531 531 531 531 531 531 531 531 531 531 531 531 531 531 531 531 531 531 531 531 531
531 531 531 535 531 531 535 531 535 531 535 531 535 531 533 531 531 531 531 518 543 518 542 542 542 542 542 543 529 574 575 599 587 588 594 597 570 528 533 531 531 531 531 531 531 541 542 542 542 542 542 519 533 531 531 531 531 531 531 531 531 531 531 531 531 541 542 542 542 542 542 542 542 542 542 542 542 542 542 542 542 542 542 543 531 535 531 535 535 531 531 531 531 531 531 531 531 531 531 531 531 531 531 531 531 531 531 531 531 531 531 531 531 531 531 531 531 531 531 531
531 531 531 535 531 531 535 531 535 531 535 531 535 531 533 531 531 531 518 543 518 543 531 531 531 531 531 531 547 521 575 587 591 596 594 597 570 528 541 542 542 542 519 531 531 531 531 531 531 531 531 533 541 542 542 542 542 542 542 542 542 542 542 542 542 542 542 542 542 542 542 542 542 542 542 542 542 542 542 542 542 542 542 542 542 543 518 543 535 531 531 531 531 531 531 531 531 531 531 531 531 531 531 531 531 531 531 531 531 531 531 531 531 531 531 531 531 531 531 531
531 531 531 535 531 531 535 531 535 531 535 531 535 531 533 531 531 531 535 518 543 531 531 525 526 526 526 526 527 529 563 564 599 596 594 597 570 528 531 531 531 531 541 542 542 542 542 519 531 531 531 541 542 542 542 542 542 542 542 542 542 542 542 519 531 531 531 531 531 518 542 542 542 542 542 542 542 542 542 542 542 542 519 531 531 518 543 518 543 531 531 531 531 531 531 531 531 531 531 531 531 531 531 531 531 531 531 531 531 531 531 531 531 531 531 531 531 531 531 531
531 531 531 535 531 531 535 531 535 531 535 531 535 531 533 531 531 531 535 535 531 525 526 546 531 531 531 531 535 547 521 575 599 596 594 597 570 528 531 531 531 531 531 531 531 531 531 533 525 526 526 526 527 531 531 531 531 531 531 531 531 531 531 541 542 542 542 542 542 543 531 531 531 531 531 531 531 531 531 531 531 531 541 542 542 543 518 543 531 531 531 531 531 531 531 531 531 531 531 531 531 531 531 531 531 531 531 531 531 531 531 531 531 531 531 531 531 531 531 531
531 531 531 535 531 531 535 531 535 531 535 531 535 531 533 531 531 531 535 535 531 533 531 531 531 531 531 531 547 527 529 575 599 596 594 597 570 536 519 531 531 531 531 531 531 531 531 533 533 531 531 531 547 527 518 542 542 542 542 542 519 531 531 531 531 531 531 531 531 531 531 518 542 542 542 542 542 542 542 542 542 542 542 542 542 542 543 531 531 531 531 531 531 531 531 531 531 531 531 531 531 531 531 531 531 531 531 531 531 531 531 531 531 531 531 531 531 531 531 531
531 531 531 535 531 531 535 531 535 531 535 531 535 525 546 531 531 531 535 535 531 533 531 531 531 531 531 531 531 535 529 575 599 596 594 597 578 577 536 542 542 542 519 531 531 531 531 533 533 531 531 531 531 535 535 531 531 531 531 531 541 542 542 542 542 542 542 542 542 542 542 543 531 531 531 525 526 526 526 526 527 531 531 531 531 531 531 531 531 531 531 531 531 531 531 531 531 531 531 531 531 531 531 531 531 531 531 531 531 531 531 531 531 531 531 531 531 531 531 531
531 531 531 523 527 531 535 531 535 531 535 531 535 533 531 531 531 531 535 535 531 533 531 531 531 531 531 531 531 535 529 575 599 596 594 605 593 578 579 579 579 577 536 542 542 542 519 533 541 519 531 531 531 535 535 518 519 531 531 531 531 531 531 531 531 531 531 531 531 531 531 531 531 531 525 547 525 526 526 527 547 527 531 531 531 531 531 531 531 531 531 531 531 531 531 531 531 531 531 531 531 531 531 531 531 531 531 531 531 531 531 531 531 531 531 531 531 531 531 531
531 531 531 531 535 531 535 531 535 531 535 531 535 533 531 531 531 531 535 535 531 533 531 531 531 531 531 531 531 535 529 575 599 596 602 593 605 603 603 603 593 578 579 579 579 577 528 541 519 541 542 542 542 543 535 529 536 542 542 519 531 531 531 531 531 531 531 531 531 531 531 531 525 526 547 525 523 531 531 523 527 547 526 526 527 531 531 531 531 531 531 531 531 531 531 531 531 531 531 531 531 531 531 531 531 531 531 531 531 531 531 531 531 531 531 531 531 531 531 531
531 531 531 531 535 531 535 531 535 531 535 531 535 533 531 531 531 531 535 535 531 533 531 531 531 531 531 531 518 543 547 553 609 598 598 602 603 603 603 593 605 603 603 603 593 570 536 519 541 542 542 542 542 542 543 529 571 571 571 536 542 542 542 542 542 542 519 531 531 531 531 525 533 531 531 541 519 531 531 531 523 526 526 527 535 527 531 531 531 531 531 531 531 531 531 531 531 531 531 531 531 531 531 531 531 531 531 531 531 531 531 531 531 531 531 531 531 531 531 531
531 531 531 531 535 531 535 531 535 531 535 531 523 523 531 531 531 531 535 535 531 541 542 542 542 542 542 542 543 531 531 531 535 609 598 598 598 598 598 602 603 603 603 593 597 578 577 536 542 519 531 531 518 542 542 537 576 579 579 579 579 579 579 579 579 579 568 525 526 526 527 533 533 531 531 531 541 542 519 531 531 531 531 535 535 535 531 531 531 531 531 531 531 531 531 531 531 531 531 531 531 531 531 531 531 531 531 531 531 531 531 531 531 531 531 531 531 531 531 531
531 531 531 531 535 531 535 531 535 531 535 531 531 531 531 531 531 531 535 535 531 531 531 531 518 542 542 542 519 531 531 531 547 547 553 553 553 553 553 553 609 598 598 594 605 593 578 579 577 536 542 542 537 576 579 579 580 592 603 603 603 603 603 603 603 603 568 533 531 531 535 533 533 531 531 531 531 531 541 542 542 519 531 535 535 535 531 531 531 531 531 531 531 531 531 531 531 531 531 531 531 531 531 531 531 531 531 531 531 531 531 531 531 531 531 531 531 531 531 531
531 531 531 531 535 531 535 531 535 531 535 531 531 531 531 531 531 531 535 535 531 531 531 518 543 531 531 531 533 531 531 531 531 525 526 526 526 526 526 527 547 553 553 553 609 605 603 593 578 579 579 579 579 580 592 603 603 607 592 603 603 603 603 603 603 608 547 541 519 531 535 533 541 542 519 531 531 531 531 531 531 541 542 543 535 535 531 531 531 531 531 531 531 531 531 531 531 531 531 531 531 531 531 531 531 531 531 531 531 531 531 531 531 531 531 531 531 531 531 531
531 531 531 531 535 531 523 527 535 531 535 531 531 531 531 531 531 531 535 535 531 531 531 535 531 531 531 531 533 531 531 525 526 546 531 531 531 531 531 547 526 526 526 527 535 609 603 605 603 603 603 603 603 603 607 592 603 603 604 598 598 598 598 608 553 546 531 531 541 542 543 541 519 531 541 519 531 531 531 531 531 531 531 518 543 535 531 531 531 531 531 531 531 531 531 531 531 531 531 531 531 531 531 531 531 531 531 531 531 531 531 531 531 531 531 531 531 531 531 531
531 531 531 531 535 531 531 535 535 531 535 531 531 531 531 531 531 531 535 535 531 531 518 543 531 531 531 531 533 531 531 533 531 531 531 518 542 542 519 531 531 531 531 535 547 547 609 603 603 603 603 603 603 603 603 604 598 598 608 553 553 553 553 546 531 531 531 531 531 531 531 531 541 542 519 541 542 519 531 531 531 531 518 543 518 543 531 531 531 531 531 531 531 531 531 531 531 531 531 531 531 531 531 531 531 531 531 531 531 531 531 531 531 531 531 531 531 531 531 531
531 531 531 531 535 531 531 535 535 531 535 531 531 531 531 531 531 531 535 535 531 531 535 531 531 531 531 531 541 542 519 533 531 531 518 543 518 519 541 542 542 519 531 547 527 531 535 609 598 598 598 598 598 598 598 598 608 553 546 531 531 531 531 531 531 531 531 518 542 542 542 519 531 531 541 542 519 541 542 542 542 542 543 518 543 531 531 531 531 531 531 531 531 531 531 531 531 531 531 531 531 531 531 531 531 531 531 531 531 531 531 531 531 531 531 531 531 531 531 531
531 531 531 531 535 531 531 535 535 531 535 531 531 531 531 531 531 531 535 535 531 518 543 531 531 531 531 531 531 531 533 533 531 531 535 518 537 536 542 542 519 533 531 531 535 531 535 529 612 598 598 598 598 598 608 553 546 531 531 531 531 531 531 531 531 531 518 537 576 579 577 536 542 519 531 531 541 542 542 542 542 542 542 543 531 525 526 526 526 526 527 531 531 531 531 531 531 531 531 531 531 531 531 531 531 531 531 531 531 531 531 531 531 531 531 531 531 531 531 531
531 531 531 531 523 527 531 535 535 531 535 531 531 531 531 531 531 518 543 535 531 535 531 531 531 531 531 531 531 531 533 533 531 531 535 535 576 579 579 577 528 533 531 531 535 518 543 529 572 588 598 598 598 608 546 525 526 526 526 526 526 526 527 531 531 531 529 576 580 696 578 579 577 536 542 542 542 542 542 519 531 531 531 531 531 533 531 531 531 531 535 531 531 531 531 531 531 531 531 531 531 531 531 531 531 531 531 531 531 531 531 531 531 531 531 531 531 531 531 531
531 531 531 531 531 535 531 535 523 527 535 531 531 531 531 531 531 535 531 535 531 535 531 531 531 518 542 542 519 531 533 533 531 531 535 535 572 723 696 570 528 533 531 531 535 535 518 537 572 596 588 598 610 568 525 546 531 525 526 526 527 531 547 527 531 531 529 572 592 603 603 593 578 579 579 579 579 579 577 536 542 519 531 531 531 541 519 531 531 531 535 531 531 531 531 531 531 531 531 531 531 531 531 531 531 531 531 531 531 531 531 531 531 531 531 531 531 531 531 531
531 531 531 531 531 535 531 535 531 535 535 531 531 531 531 531 531 535 518 543 531 535 531 531 518 537 576 577 536 519 533 533 531 531 547 547 544 561 723 570 528 533 531 531 535 535 529 576 580 596 596 586 560 525 533 531 531 541 542 542 543 531 531 535 527 531 547 561 599 592 593 605 603 603 603 603 603 593 578 579 577 536 519 531 531 531 541 519 531 531 535 531 531 531 531 531 531 531 531 531 531 531 531 531 531 531 531 531 531 531 531 531 531 531 531 531 531 531 531 531
531 531 531 531 531 535 531 535 531 535 535 531 531 531 531 531 531 535 535 531 531 535 531 531 529 576 580 578 577 528 533 541 519 531 531 531 531 546 544 545 546 546 531 518 543 535 529 572 592 607 596 594 568 533 541 519 531 531 531 531 531 531 518 543 535 531 531 547 609 596 602 603 603 603 603 603 593 605 603 593 578 579 528 531 531 531 531 541 542 542 543 531 531 531 531 531 531 531 531 531 531 531 531 531 531 531 531 531 531 531 531 531 531 531 531 531 531 531 531 531
531 531 531 531 531 523 527 535 531 535 535 531 531 531 531 531 531 535 535 531 518 543 531 531 529 572 592 593 570 528 541 519 541 542 519 531 531 531 531 531 531 518 542 543 518 543 529 572 596 592 598 594 568 533 531 541 519 531 531 531 518 542 543 518 543 531 531 531 547 609 598 598 598 598 598 598 602 603 603 605 603 608 546 531 531 531 531 531 531 531 531 531 531 531 531 531 531 531 531 531 531 531 531 531 531 531 531 531 531 531 531 531 531 531 531 531 531 531 531 531
531 531 531 531 531 531 535 535 531 535 535 531 531 531 531 531 531 535 535 531 535 531 531 531 529 572 596 594 570 536 519 541 542 519 541 542 519 531 531 531 518 543 518 542 543 518 537 572 596 596 598 594 568 541 542 519 541 542 542 542 543 518 542 543 531 531 531 531 531 547 553 609 598 598 598 598 608 553 553 553 553 546 531 531 531 531 531 531 531 531 531 531 531 531 531 531 531 531 531 531 531 531 531 531 531 531 531 531 531 531 531 531 531 531 531 531 531 531 531 531
531 531 531 531 531 531 535 535 531 535 535 531 531 531 531 531 531 535 535 531 535 531 531 531 547 561 596 594 578 577 536 536 519 541 542 519 541 542 542 542 543 518 543 518 542 537 576 580 596 596 598 594 568 531 531 541 542 542 542 542 542 543 531 531 531 531 531 531 531 531 531 547 553 553 553 553 546 531 531 531 531 531 531 531 531 531 531 531 531 531 531 531 531 531 531 531 531 531 531 531 531 531 531 531 531 531 531 531 531 531 531 531 531 531 531 531 531 531 531 531
531 531 531 531 531 531 535 535 531 535 535 531 531 531 531 531 531 535 535 518 543 531 531 531 531 547 609 602 593 578 579 577 536 542 519 541 542 613 614 615 542 543 518 537 576 579 580 592 607 596 598 594 568 531 531 531 531 525 526 526 527 526 531 531 531 531 531 531 531 531 531 531 531 531 531 531 531 531 531 525 526 526 526 527 531 531 531 531 531 531 531 531 531 531 531 531 531 531 531 531 531 531 531 531 531 531 531 531 531 531 531 531 531 531 531 531 531 531 531 531
531 531 531 531 531 531 535 535 531 535 535 531 531 531 531 531 531 535 535 535 531 531 531 531 531 531 547 609 602 603 593 578 579 577 536 542 542 621 622 623 542 542 537 576 580 592 603 607 592 598 608 553 546 526 526 527 531 533 531 531 547 527 531 531 531 531 525 526 526 526 526 526 526 526 526 527 531 531 531 533 531 531 531 535 531 531 531 531 531 531 531 531 531 531 531 531 531 531 531 531 531 531 531 531 531 531 531 531 531 531 531 531 531 531 531 531 531 531 531 531
531 531 531 531 531 531 535 535 531 535 535 531 531 531 531 531 531 535 535 535 531 531 531 531 531 531 531 547 609 593 605 603 593 578 579 579 579 577 571 571 571 571 571 572 592 607 592 603 608 553 546 525 526 527 531 547 527 541 542 519 518 543 531 531 525 526 546 531 531 531 531 531 531 531 531 547 527 531 531 533 531 531 531 535 531 531 531 531 531 531 531 531 531 531 531 531 531 531 531 531 531 531 531 531 531 531 531 531 531 531 531 531 531 531 531 531 531 531 531 531
531 531 531 531 531 531 535 535 531 535 535 531 531 531 531 531 531 535 535 535 531 531 531 531 531 531 531 531 547 553 609 593 605 603 603 603 593 578 579 579 579 579 579 580 596 592 598 608 533 531 531 541 542 543 531 531 535 527 531 541 543 531 525 526 546 531 531 531 531 531 531 531 531 531 531 531 535 527 531 541 519 531 531 535 531 531 531 531 531 531 531 531 531 531 531 531 531 531 531 531 531 531 531 531 531 531 531 531 531 531 531 531 531 531 531 531 531 531 531 531
531 531 531 531 531 531 535 535 531 535 535 531 531 531 531 531 531 535 535 535 531 531 531 531 531 531 531 531 531 531 547 553 553 609 603 593 605 603 603 603 603 603 603 603 607 596 608 533 533 531 531 531 531 531 531 518 543 535 531 531 531 525 546 531 531 531 531 531 531 531 531 531 531 531 531 531 535 535 531 531 541 542 542 543 531 531 531 531 531 531 531 531 531 531 531 531 531 531 531 531 531 531 531 531 531 531 531 531 531 531 531 531 531 531 531 531 531 531 531 531
531 531 531 531 531 531 535 535 531 535 535 531 531 531 531 531 531 535 535 535 531 531 531 531 531 531 531 531 531 525 526 526 527 547 609 602 603 603 603 603 603 603 603 603 603 610 528 533 541 519 531 531 531 518 542 543 518 543 531 531 531 533 531 531 531 531 531 531 531 525 526 526 526 526 527 518 543 535 531 531 531 531 531 531 531 531 531 531 531 531 531 531 531 531 531 531 531 531 531 531 531 531 531 531 531 531 531 531 531 531 531 531 531 531 531 531 531 531 531 531
531 531 531 531 531 531 535 535 531 535 535 531 531 531 531 531 531 535 535 535 531 531 531 531 531 531 531 531 525 546 531 531 547 527 547 553 609 598 598 598 598 598 598 598 586 570 528 541 519 541 542 542 542 543 518 542 543 531 531 531 525 546 531 531 531 531 531 525 526 546 531 531 531 531 535 535 518 543 531 531 531 531 531 531 531 531 531 531 531 531 531 531 531 531 531 531 531 531 531 531 531 531 531 531 531 531 531 531 531 531 531 531 531 531 531 531 531 531 531 531
531 531 531 531 531 531 535 535 531 535 535 531 531 531 531 531 531 535 535 535 531 531 531 531 531 531 531 525 533 531 531 531 531 535 527 518 537 612 598 598 598 598 598 586 597 570 536 519 541 542 542 542 542 542 543 518 519 531 531 525 546 531 531 531 531 525 526 546 531 531 531 531 531 531 535 535 535 531 531 531 531 531 531 531 531 531 531 531 531 531 531 531 531 531 531 531 531 531 531 531 531 531 531 531 531 531 531 531 531 531 531 531 531 531 531 531 531 531 531 531
531 531 531 531 531 531 535 535 531 535 535 531 531 531 531 531 531 535 535 535 531 531 531 531 531 531 531 533 541 519 531 531 518 543 535 529 576 580 588 598 598 598 598 594 597 578 577 536 542 542 542 542 542 542 542 537 528 531 525 546 531 531 531 531 525 546 531 531 531 531 531 518 542 542 543 535 535 531 531 531 531 531 531 531 531 531 531 531 531 531 531 531 531 531 531 531 531 531 531 531 531 531 531 531 531 531 531 531 531 531 531 531 531 531 531 531 531 531 531 531
531 531 531 531 531 531 535 523 527 535 535 531 531 531 531 531 531 535 535 547 527 531 531 531 531 531 531 541 519 541 542 542 543 518 543 529 572 592 607 588 598 598 598 594 605 593 578 579 579 579 579 579 579 579 579 577 528 525 533 531 531 531 531 531 533 531 531 531 531 518 542 543 518 542 542 543 535 531 531 531 531 531 531 531 531 531 531 531 531 531 531 531 531 531 531 531 531 531 531 531 531 531 531 531 531 531 531 531 531 531 531 531 531 531 531 531 531 531 531 531
531 531 531 531 531 531 535 531 535 535 535 531 531 531 531 531 531 535 535 531 547 527 531 531 531 531 531 531 541 542 542 542 542 543 518 537 572 596 592 604 598 608 553 553 553 609 603 603 603 603 603 603 603 603 593 570 528 533 533 531 531 531 531 531 533 531 531 531 518 543 518 542 543 518 542 542 543 531 531 531 531 531 531 531 531 531 531 531 531 531 531 531 531 531 531 531 531 531 531 531 531 531 531 531 531 531 531 531 531 531 531 531 531 531 531 531 531 531 531 531
531 531 531 531 531 531 535 531 535 535 535 531 531 531 531 531 531 535 547 527 531 535 531 531 531 531 531 531 531 531 531 518 542 542 537 576 580 596 608 553 553 546 531 531 531 547 553 553 609 603 603 603 603 608 553 553 546 533 541 519 531 531 531 531 541 542 542 542 543 518 543 518 542 543 531 531 531 531 531 531 531 531 531 531 531 531 531 531 531 531 531 531 531 531 531 531 531 531 531 531 531 531 531 531 531 531 531 531 531 531 531 531 531 531 531 531 531 531 531 531
531 531 531 531 531 531 535 531 535 535 535 531 531 531 531 531 531 547 527 535 531 535 531 525 526 526 526 527 531 531 531 529 576 579 579 580 592 608 546 531 531 525 526 526 526 526 527 526 547 553 553 553 553 546 531 531 525 546 531 541 542 542 542 542 542 542 542 542 542 543 518 543 531 531 531 531 531 531 531 531 531 531 531 531 531 531 531 531 531 531 531 531 531 531 531 531 531 531 531 531 531 531 531 531 531 531 531 531 531 531 531 531 531 531 531 531 531 531 531 531
531 531 531 531 531 531 535 531 535 535 535 531 531 531 531 531 531 531 535 535 531 546 526 546 531 531 531 547 526 527 531 523 553 553 553 553 553 546 531 531 525 546 531 531 531 531 547 527 531 531 531 531 531 531 531 531 533 531 531 531 531 531 531 531 531 531 531 531 531 531 535 531 531 531 531 531 531 531 531 531 531 531 531 531 531 531 531 531 531 531 531 531 531 531 531 531 531 531 531 531 531 531 531 531 531 531 531 531 531 531 531 531 531 531 531 531 531 531 531 531
531 531 531 531 531 531 535 531 535 535 535 531 531 531 531 531 531 531 535 535 531 531 531 531 531 531 531 531 531 547 526 526 526 526 526 526 526 526 526 526 546 531 531 531 531 531 531 547 526 526 526 526 526 526 526 526 546 531 531 531 531 531 531 531 531 531 531 531 531 531 535 531 531 531 531 531 531 531 531 531 531 531 531 531 531 531 531 531 531 531 531 531 531 531 531 531 531 531 531 531 531 531 531 531 531 531 531 531 531 531 531 531 531 531 531 531 531 531 531 531