Underwater_SootopolisCity_Layout (20x10)
531 531 531 518 542 542 542 542 542 542 542 542 542 542 542 542 519 531 531 531
531 531 518 543 531 518 542 542 542 542 542 542 542 542 519 531 541 519 531 531
531 518 543 518 542 543 531 518 542 542 542 519 531 531 541 542 519 541 519 531
518 543 518 543 518 542 542 543 531 531 531 541 542 542 542 519 541 519 541 519
532 518 543 518 543 531 518 542 542 542 542 542 519 531 531 541 519 541 519 530
532 532 518 543 518 542 540 552 552 552 552 552 538 542 519 531 530 531 530 530
532 532 532 531 532 552 552 552 552 552 552 552 552 552 538 519 541 519 530 530
532 532 532 531 532 552 552 552 552 552 552 552 552 552 552 538 519 530 530 530
547 547 547 523 547 524 552 552 552 548 552 552 552 552 552 522 546 546 546 546
531 531 531 531 531 547 523 523 555 556 557 523 523 523 523 546 531 531 531 531