Underwater3_Layout (80x80)
531 531 531 531 531 531 531 531 531 531 531 531 531 531 535 531 531 535 531 535 531 535 531 535 531 535 533 533 533 531 531 533 531 531 531 533 531 531 531 531 531 531 535 531 535 531 535 531 535 535 533 531 533 531 533 531 533 533 531 531 531 531 531 531 531 531 531 532 531 535 531 535 531 533 531 533 533 531 531 531
531 531 531 531 531 531 531 531 531 531 531 531 531 531 535 531 531 535 531 535 531 535 531 535 531 535 533 533 533 531 531 533 531 531 531 533 531 531 531 531 531 531 535 531 535 531 535 531 535 535 533 531 533 531 533 531 533 533 531 531 531 531 531 531 531 531 531 535 531 535 531 535 531 533 531 533 533 531 531 531
531 531 531 531 531 531 531 531 531 531 531 531 531 531 535 531 531 535 531 535 531 535 531 535 531 535 533 533 541 519 531 533 531 531 531 533 531 531 531 531 531 531 535 531 535 531 535 531 535 535 533 531 533 531 533 531 533 533 531 531 531 531 531 531 531 531 518 543 531 535 531 535 531 533 531 533 533 531 531 531
531 531 531 531 531 531 531 531 531 531 531 531 531 531 535 531 518 543 531 535 531 535 531 535 531 535 533 533 531 533 531 541 519 531 531 533 531 531 531 531 531 531 535 531 535 531 535 531 535 535 533 531 533 531 533 531 533 533 531 531 531 531 531 531 531 531 535 531 518 543 518 543 531 541 519 533 541 519 531 531
531 531 531 531 531 531 531 531 531 531 531 531 531 518 543 531 535 531 531 535 531 535 531 535 518 543 533 541 519 533 531 531 533 531 531 533 531 531 531 531 531 531 535 531 535 531 535 531 535 535 541 519 533 531 533 531 533 533 531 531 531 531 531 531 531 518 543 518 543 518 543 531 531 531 533 541 519 533 531 531
531 531 531 531 531 531 531 531 531 531 531 531 531 535 531 531 535 531 531 535 518 543 531 535 535 531 533 531 533 533 531 531 533 531 531 533 531 531 531 531 531 531 535 531 535 531 535 531 535 535 531 533 533 531 533 531 533 533 531 531 531 531 531 531 531 532 531 535 518 543 518 539 539 519 541 519 533 533 531 531
531 531 531 531 531 531 531 531 518 542 542 542 542 543 518 542 543 531 531 535 535 531 518 543 535 531 541 519 533 533 531 531 533 531 531 533 531 531 531 531 531 531 535 531 535 531 535 531 535 535 531 533 533 531 533 531 533 533 531 531 531 531 531 531 531 535 518 543 535 518 537 571 571 536 519 533 533 541 519 531
531 531 531 531 531 531 531 518 543 518 542 542 542 542 543 531 531 531 531 535 535 531 535 531 535 531 531 533 533 533 531 531 533 531 531 533 531 531 531 531 531 531 535 531 535 531 535 531 535 535 531 533 533 531 533 531 533 533 531 531 531 531 531 531 518 543 535 518 543 529 571 571 571 571 528 533 533 531 533 531
531 531 531 531 531 531 531 535 531 535 518 519 531 531 531 531 531 531 518 543 535 531 535 518 543 531 531 533 533 541 519 531 541 519 531 541 519 531 531 531 531 531 535 531 535 531 535 531 535 535 531 533 541 519 533 531 533 533 531 531 531 531 531 531 535 531 535 535 531 529 576 579 579 577 528 533 541 519 533 531
531 531 531 531 531 531 518 543 531 535 535 541 519 531 531 531 531 531 535 531 535 518 543 535 531 531 531 533 541 519 533 531 531 533 531 531 533 531 531 531 531 531 535 531 535 531 535 531 535 535 531 533 531 533 533 531 533 533 531 531 531 531 531 531 535 518 543 535 531 529 572 592 593 570 528 533 531 533 541 519
531 531 531 531 531 531 535 531 518 543 535 531 533 531 531 531 531 531 535 518 543 535 531 535 531 531 531 541 519 533 533 531 531 533 531 531 533 531 531 531 531 531 535 531 535 531 535 531 535 535 531 533 531 533 541 519 533 533 531 531 531 531 531 531 535 535 518 543 531 529 572 596 594 570 528 541 519 533 531 533
531 531 531 531 531 518 543 531 535 531 535 531 541 519 531 531 531 531 535 535 518 543 518 543 531 531 531 531 533 533 541 519 531 533 531 531 533 531 531 531 531 531 535 531 535 531 535 531 535 535 531 533 531 533 531 533 533 533 531 531 531 531 531 531 535 535 535 531 518 537 572 596 594 570 528 531 533 541 519 533
531 531 531 531 531 535 531 531 535 531 535 518 519 541 519 531 531 531 535 535 535 518 543 518 539 539 519 531 533 541 519 533 531 541 519 531 533 531 531 531 531 531 535 531 535 518 543 531 535 535 531 541 519 533 531 533 533 533 531 531 531 531 531 531 535 535 535 518 537 576 583 596 594 570 536 519 533 531 533 533
531 531 531 531 531 535 531 518 543 518 543 535 541 519 541 519 531 531 535 535 535 535 518 537 576 577 536 519 541 519 533 533 531 531 533 531 533 531 531 531 531 518 543 531 535 535 531 531 535 535 531 531 533 533 531 533 533 533 531 531 531 531 531 531 535 535 535 529 576 583 592 604 594 578 577 528 541 519 533 533
531 531 531 531 531 535 531 535 531 535 531 535 531 533 531 533 531 531 535 535 535 535 529 576 580 578 577 536 519 533 533 533 531 531 533 531 541 519 531 531 531 535 531 518 543 535 531 531 535 535 531 531 533 533 531 533 533 533 531 531 531 531 531 531 535 535 535 529 572 592 604 598 602 593 570 536 519 533 533 533
531 531 531 531 531 535 531 535 531 535 518 543 531 541 519 541 519 531 535 535 535 535 529 575 592 593 578 570 528 533 533 541 519 531 541 519 531 533 531 531 531 535 531 535 531 535 531 531 535 535 531 531 533 533 531 533 533 533 531 531 531 531 531 531 535 535 535 529 572 587 588 598 598 594 578 577 528 533 533 533
531 531 531 531 531 535 531 535 518 543 535 531 531 531 533 531 533 531 535 535 535 535 529 575 599 605 593 570 528 533 541 519 533 531 531 533 531 533 531 531 531 535 531 535 531 535 531 531 535 535 531 531 533 533 531 533 533 533 531 531 531 531 531 531 535 535 535 529 563 564 596 598 598 594 595 570 528 533 533 533
531 531 531 531 531 535 531 535 535 531 535 531 531 531 541 519 533 531 535 535 535 535 529 575 599 595 597 570 528 541 519 533 541 519 531 541 519 533 531 531 531 535 531 535 531 535 531 518 543 535 531 531 533 533 531 533 533 541 519 531 531 531 531 531 535 535 535 547 521 575 587 588 598 602 593 570 528 533 533 533
531 531 531 531 531 535 531 535 535 531 535 518 519 531 531 533 533 531 535 535 535 535 529 575 599 595 597 570 536 519 533 533 531 533 531 531 533 533 531 531 531 535 531 535 531 535 531 535 531 535 531 531 533 533 531 533 533 531 533 531 531 531 531 531 535 535 535 531 529 563 564 596 598 598 594 570 528 533 533 533
531 531 531 531 518 543 531 535 535 531 535 535 533 531 531 533 541 519 535 535 535 535 529 575 601 591 597 578 577 528 533 541 519 541 519 531 533 533 531 531 531 535 531 535 531 535 531 535 518 543 531 531 533 533 531 533 533 531 533 531 531 531 531 531 535 535 547 527 547 521 575 587 587 588 594 570 528 533 533 533
531 531 531 531 535 531 518 543 535 518 543 535 541 519 531 533 531 533 535 535 535 535 529 585 564 599 597 595 570 528 541 519 533 531 533 531 533 533 531 531 531 535 531 535 531 535 531 535 535 531 531 531 533 533 531 533 533 531 533 531 531 531 531 531 535 547 527 535 531 529 563 564 696 588 594 570 528 533 533 533
531 531 531 531 535 531 535 518 543 535 531 535 531 533 531 541 519 541 543 535 535 535 523 521 575 599 605 593 570 528 531 533 533 531 533 531 533 533 531 531 531 535 531 535 531 535 531 535 535 531 531 531 533 533 531 533 533 531 533 531 531 531 531 531 547 527 535 535 531 547 521 564 723 588 594 570 528 533 533 533
531 531 531 518 543 531 535 535 531 535 531 535 531 533 531 531 533 531 531 535 535 535 531 529 575 601 591 597 570 536 519 533 533 531 533 531 533 533 531 518 539 543 531 535 531 535 531 535 535 531 531 531 533 533 531 533 533 531 533 531 531 531 531 531 531 535 535 547 526 527 529 563 564 588 594 570 528 533 533 533
531 531 531 535 531 518 543 535 518 543 531 535 531 541 519 531 541 519 531 535 535 535 531 529 585 564 599 597 578 577 528 533 541 519 533 531 533 541 543 543 531 518 539 543 531 535 518 543 535 531 531 531 533 533 531 533 533 531 533 531 531 531 531 531 531 535 547 526 527 535 547 521 564 596 594 570 528 533 533 533
531 531 531 535 531 535 531 535 535 531 518 543 531 531 533 531 531 533 531 535 535 535 531 523 521 575 599 597 595 570 528 541 519 533 533 531 533 531 518 539 539 543 531 531 518 543 535 518 543 531 531 531 533 533 531 533 533 531 533 531 531 531 531 531 531 547 526 527 535 535 531 529 564 596 594 570 528 533 533 533
531 531 531 535 531 535 518 543 535 531 535 531 531 531 533 531 531 533 531 535 535 535 531 531 529 575 599 605 593 570 536 519 533 533 533 531 541 543 543 531 531 531 531 531 535 518 543 535 531 531 531 531 533 533 531 533 533 531 533 531 531 531 531 531 531 531 531 535 535 535 531 529 564 596 594 560 523 533 533 533
531 531 531 535 531 535 535 531 535 531 535 518 519 531 533 531 531 533 531 535 535 535 531 531 529 575 599 595 597 570 571 528 533 533 541 519 531 518 539 539 539 539 519 531 535 535 518 543 531 531 531 531 533 533 531 533 533 531 533 531 531 531 531 531 531 531 531 535 535 535 531 529 564 596 594 568 531 533 533 533
531 531 531 535 531 535 535 531 535 531 535 535 533 531 533 531 531 533 531 535 535 535 531 531 529 575 601 591 597 578 577 528 533 541 519 533 518 543 518 539 539 519 533 531 535 535 535 531 518 539 519 531 533 533 531 533 541 519 533 531 531 531 531 531 531 531 531 535 535 535 531 529 564 596 594 568 525 546 533 533
531 531 531 535 531 535 535 531 535 531 535 535 533 531 533 531 531 533 531 523 523 523 527 531 529 585 564 599 597 595 570 528 533 531 533 541 543 518 543 518 519 533 541 519 535 535 535 518 537 571 536 519 533 541 519 541 519 533 533 531 531 531 531 531 531 531 531 535 535 535 531 529 564 596 594 568 533 525 546 533
531 531 531 535 531 535 535 531 535 531 535 535 533 531 533 531 531 533 531 531 531 531 535 527 523 521 575 599 605 593 570 528 541 519 533 531 531 535 518 543 533 541 519 533 535 535 535 529 576 579 577 528 533 531 533 531 533 533 533 531 531 531 531 531 531 531 531 535 547 547 527 547 545 609 608 546 533 533 525 523
531 531 531 535 531 535 535 531 535 531 535 535 533 531 533 531 531 533 531 531 531 531 535 535 527 529 575 599 595 597 570 536 519 533 533 531 518 543 535 531 533 531 533 533 535 535 535 529 575 595 570 528 541 519 541 519 533 533 533 531 531 531 531 531 531 531 531 547 526 527 535 527 523 547 546 525 546 533 533 531
531 531 531 535 531 535 535 518 543 531 535 535 541 519 541 519 531 533 531 531 531 531 535 535 535 529 575 599 595 597 578 577 528 533 541 539 543 518 543 531 541 519 533 533 535 535 535 529 575 595 570 536 519 533 531 533 533 533 533 531 531 531 531 531 531 531 531 531 531 535 535 535 531 531 531 533 531 533 533 531
531 531 531 535 531 535 535 535 531 531 535 535 531 533 531 533 531 541 519 531 531 531 535 535 535 529 575 599 595 597 595 570 528 533 531 518 539 543 531 531 531 533 533 533 535 535 535 529 575 595 578 577 528 541 519 533 533 533 533 531 531 531 531 531 531 531 531 531 531 535 535 547 527 531 531 533 525 546 533 531
531 531 518 543 531 535 535 535 531 531 535 535 531 533 531 541 519 531 533 531 531 531 535 535 535 529 575 599 595 597 595 570 528 533 531 535 518 539 539 519 531 533 533 533 535 535 535 529 563 564 595 570 536 519 533 533 533 533 533 531 531 531 531 531 531 531 531 531 531 535 535 531 535 531 525 546 533 531 533 531
531 531 535 531 531 535 535 535 531 531 535 535 531 541 519 531 533 531 533 531 531 531 535 535 535 529 575 599 595 597 595 570 528 533 531 529 529 576 577 536 519 533 533 541 543 535 535 547 521 575 595 578 577 528 533 533 533 533 533 531 531 531 531 531 531 531 531 531 531 535 535 531 547 527 533 531 533 525 546 531
531 531 535 531 518 543 535 535 531 518 543 535 531 531 533 531 541 519 533 531 531 531 535 535 535 529 575 599 595 605 593 570 528 533 531 535 529 575 578 577 528 533 541 519 531 535 535 531 529 575 595 595 570 528 533 533 533 533 541 519 531 531 531 531 531 531 531 531 531 523 523 527 531 535 533 531 533 533 531 531
531 531 535 531 535 518 543 535 518 543 518 543 531 531 541 519 531 533 541 519 531 531 535 535 535 529 575 599 592 593 597 570 528 533 531 535 529 575 595 570 528 541 519 533 531 535 535 531 529 575 696 595 570 528 533 533 533 533 531 533 531 531 531 531 531 531 531 531 531 531 531 535 527 535 533 531 533 533 531 531
531 531 535 531 535 535 518 543 535 531 535 518 539 539 519 533 531 533 531 533 531 531 535 535 535 529 575 599 596 594 597 570 528 533 518 543 529 575 595 570 536 519 533 533 531 535 535 531 529 575 595 595 570 528 533 533 533 533 531 533 531 531 531 531 531 531 531 531 531 531 531 535 535 547 546 531 533 533 531 531
531 531 535 531 535 535 535 518 543 518 543 529 576 577 528 541 519 541 519 533 531 518 543 535 535 529 575 599 596 594 597 570 528 533 535 518 537 575 595 578 577 528 533 533 531 535 535 531 529 575 595 595 570 528 533 533 533 533 531 533 531 531 531 531 531 531 531 531 531 531 531 535 547 527 531 525 546 533 531 531
531 531 535 518 543 535 535 535 518 543 518 537 572 570 536 519 533 531 533 533 531 535 518 543 535 529 575 599 596 594 597 570 528 541 543 529 576 580 592 593 570 528 533 541 519 535 535 518 537 575 595 595 570 528 533 533 533 533 531 533 531 531 531 531 531 531 531 531 531 531 531 547 527 535 531 533 525 523 531 531
531 531 535 535 531 535 535 535 535 518 537 576 708 578 577 528 541 519 533 541 519 535 535 518 543 529 575 599 596 594 597 570 528 531 531 529 575 592 607 597 570 528 541 519 533 535 535 529 576 580 595 595 570 528 533 533 533 533 531 533 531 531 531 531 531 531 531 531 531 531 531 531 535 547 526 546 533 531 531 531
531 531 535 535 531 535 535 535 535 529 576 708 723 723 570 536 519 533 541 519 533 535 535 535 531 529 575 599 596 594 597 570 536 519 531 529 575 599 595 597 570 528 531 533 541 543 535 529 575 595 595 562 563 528 533 533 533 533 531 533 531 531 531 531 531 531 531 531 531 531 531 531 547 527 531 531 533 531 531 531
531 531 535 535 531 535 535 535 535 529 572 723 696 723 578 577 528 541 519 533 533 535 535 535 518 537 575 599 596 594 597 570 571 528 531 529 575 599 595 597 570 536 519 533 531 518 543 529 575 595 595 570 520 546 533 533 533 533 531 533 531 531 531 531 531 531 531 531 531 531 531 531 531 535 531 525 546 531 531 531
531 531 535 535 531 535 535 535 535 529 572 723 720 721 595 570 528 531 533 533 533 535 535 535 529 571 575 599 596 594 597 578 577 528 531 529 575 599 595 597 570 571 528 533 531 535 518 537 575 595 595 570 528 531 533 533 533 533 531 533 531 531 531 531 531 531 531 531 531 531 531 531 531 535 531 533 531 531 531 531
531 531 535 535 531 535 535 535 535 529 585 564 596 602 593 570 536 519 533 533 541 543 535 535 529 576 583 599 596 594 597 595 570 528 531 529 575 599 595 597 578 577 528 533 531 535 529 576 580 595 595 570 528 531 533 533 533 533 531 533 531 531 531 531 531 531 531 531 531 531 531 531 531 547 526 546 531 531 531 531
531 531 535 535 531 535 535 535 535 547 521 575 601 588 594 578 577 528 533 541 519 531 535 535 529 575 595 599 596 594 605 593 570 528 531 529 575 587 591 597 595 570 528 533 531 535 529 575 595 595 595 570 528 531 533 533 533 533 531 533 531 531 531 531 531 531 531 531 531 531 531 518 644 644 519 531 531 531 531 531
531 531 535 535 531 535 535 535 535 531 529 585 564 596 602 593 570 528 541 519 533 531 535 535 529 575 592 607 596 602 593 597 570 528 531 529 563 564 596 597 595 570 528 533 531 535 529 575 595 595 562 563 528 531 533 533 533 533 531 533 531 531 531 531 531 531 531 531 531 531 518 646 681 681 645 519 531 531 531 531
531 531 535 535 531 535 535 535 523 527 547 521 575 601 588 594 570 528 531 533 533 518 543 535 529 575 599 595 596 598 594 597 570 536 519 523 521 575 596 597 562 563 528 533 518 543 529 575 595 595 570 520 546 525 523 533 533 533 531 533 531 531 531 531 531 531 531 531 531 518 646 681 649 649 681 645 519 531 531 531
531 531 535 535 531 535 535 535 531 535 531 529 585 564 596 594 570 536 519 533 541 543 531 535 529 575 599 592 604 598 594 597 570 571 528 531 529 575 596 597 570 520 523 533 535 518 537 575 595 562 563 528 531 533 525 523 533 533 531 533 531 531 531 531 531 531 531 531 531 653 681 650 534 534 648 681 654 531 531 531
531 531 535 523 527 535 535 535 531 535 531 547 521 575 596 594 578 577 528 541 519 531 518 543 529 575 599 596 598 598 594 597 578 577 528 531 529 575 596 597 570 528 531 541 543 529 576 580 595 570 520 546 531 533 533 531 533 533 531 533 531 531 531 531 531 531 531 531 518 646 642 534 534 534 534 640 654 531 531 531
531 531 535 531 535 535 535 535 531 535 531 531 529 575 596 602 593 570 528 531 533 531 535 531 529 575 599 596 598 598 594 597 595 570 528 531 529 575 596 597 570 528 531 531 518 537 575 595 595 570 528 531 525 523 533 531 533 533 531 533 531 531 531 531 531 531 531 518 646 681 642 534 534 534 534 640 654 531 531 531
531 531 535 531 535 535 535 535 531 547 527 531 529 575 601 588 594 570 536 519 533 531 535 518 537 575 599 596 598 598 594 605 593 570 528 518 537 575 596 597 570 528 531 531 529 576 580 595 562 563 528 531 533 531 533 531 533 533 531 533 531 531 531 531 531 531 531 653 681 681 681 634 534 534 632 681 654 531 531 531
531 531 535 531 535 535 535 547 527 531 535 531 529 585 564 596 594 578 577 528 533 531 535 529 574 575 596 601 588 598 602 593 597 570 536 537 574 575 596 597 570 528 531 518 537 575 595 595 570 520 546 525 523 531 533 531 533 533 525 523 531 531 531 531 531 531 531 653 681 681 681 681 633 633 681 637 547 531 531 531
531 531 535 531 535 535 535 531 535 531 535 531 547 521 575 596 594 595 570 528 533 531 535 529 574 575 601 591 596 598 598 594 597 570 574 574 576 580 596 597 570 528 531 529 576 580 595 595 570 528 531 533 531 525 523 531 533 533 533 531 531 531 531 531 531 531 518 646 649 649 681 681 681 681 681 654 531 531 531 531
531 531 535 531 535 535 535 531 535 531 535 531 531 529 575 596 602 593 570 528 533 531 535 529 574 575 595 599 601 588 598 594 597 578 577 574 572 720 607 597 570 528 531 529 575 595 595 562 563 528 531 533 531 533 531 525 523 533 533 531 531 531 531 531 531 518 646 650 534 534 648 681 681 681 637 547 531 531 531 531
531 531 535 531 535 535 547 527 547 527 535 531 531 529 575 596 598 594 570 528 533 531 535 529 574 575 595 601 591 596 598 594 605 593 578 579 580 596 589 587 570 528 531 529 575 595 595 570 520 546 525 546 531 533 531 533 525 523 533 531 531 531 531 531 531 653 642 534 534 534 534 640 681 637 547 531 531 531 531 531
531 531 535 531 535 535 531 535 531 535 535 531 531 529 575 596 598 594 570 528 533 531 535 529 574 585 564 595 599 596 598 602 593 597 595 595 720 607 597 562 563 528 531 529 575 595 562 563 528 531 533 531 531 533 525 546 533 531 533 531 531 531 531 531 531 653 642 534 534 534 534 640 681 654 531 531 531 531 531 531
531 531 535 531 535 547 527 535 531 535 547 527 531 529 575 601 588 594 570 528 533 531 535 529 574 574 575 595 599 596 598 598 594 597 595 595 596 595 597 570 520 546 531 529 575 595 570 520 546 531 533 531 531 533 533 525 523 531 533 531 531 531 531 531 531 547 638 634 534 534 632 681 637 636 531 531 531 531 531 531
531 531 535 531 535 531 535 535 531 547 527 535 531 529 585 564 596 594 570 528 533 531 535 529 574 574 575 595 599 596 598 598 594 605 606 606 607 595 597 570 528 531 531 529 575 595 570 528 531 525 546 526 526 546 546 533 531 525 523 531 531 531 531 531 531 531 653 681 633 633 681 681 654 531 531 531 531 531 531 531
531 531 535 531 547 527 535 547 527 531 535 535 531 547 521 575 596 594 570 528 533 531 535 547 521 574 585 564 599 601 588 598 602 593 595 595 595 589 587 570 528 531 531 529 575 595 560 546 525 533 525 526 526 526 526 546 531 533 531 531 531 531 531 531 531 531 547 638 681 681 637 636 547 531 531 531 531 531 531 531
531 531 535 531 531 535 535 531 535 531 535 535 531 531 529 575 596 594 560 546 533 531 523 527 529 574 574 575 601 591 596 598 598 602 593 595 589 587 595 570 528 531 531 547 545 545 546 525 533 533 533 525 526 526 526 526 526 546 531 531 531 531 531 531 531 531 531 653 681 681 654 531 531 531 531 531 531 531 531 531
531 531 535 531 531 535 535 531 535 531 535 547 527 531 547 561 596 594 568 525 546 525 527 535 529 574 574 585 564 599 601 588 598 598 594 595 597 595 562 563 528 525 526 526 526 526 526 546 533 533 533 533 531 531 531 531 531 531 531 531 531 531 531 531 531 531 531 547 638 637 636 531 531 531 531 531 531 531 531 531
531 531 535 531 531 535 535 531 535 531 535 531 535 531 531 569 596 594 568 533 525 546 535 535 529 574 574 574 575 601 591 596 598 598 594 589 587 562 563 520 546 533 525 523 526 526 526 523 546 533 533 533 531 531 531 531 531 531 531 531 531 531 531 531 531 531 531 531 653 654 531 531 531 531 531 531 531 531 531 531
531 531 535 531 531 535 535 531 547 527 547 527 547 527 531 569 596 594 568 533 533 531 535 535 547 521 574 574 575 595 599 596 598 598 594 597 595 570 574 528 525 546 533 525 526 526 526 526 526 523 533 533 531 531 531 531 531 531 531 531 531 531 531 531 531 531 531 531 547 547 531 531 531 531 531 531 531 531 531 531
531 531 535 531 531 535 535 531 531 535 531 535 531 535 531 569 596 594 568 533 533 531 535 547 527 529 574 574 585 564 599 596 598 598 594 597 595 570 520 546 533 525 546 533 525 526 526 526 526 526 523 533 531 531 531 531 531 531 531 531 531 531 531 531 531 531 531 531 531 531 531 531 531 531 531 531 531 531 531 531
531 531 535 531 531 535 535 531 531 535 531 535 531 535 531 569 596 594 568 533 533 531 535 531 535 529 574 574 574 575 599 601 588 598 594 597 595 570 528 525 546 533 525 546 533 525 526 526 526 526 526 523 531 531 531 531 531 531 531 531 531 531 531 531 531 531 531 531 531 531 531 531 531 531 531 531 531 531 531 531
531 531 535 531 531 535 547 527 531 535 531 535 531 535 531 569 596 594 568 533 533 531 547 527 535 547 521 574 574 575 601 591 596 598 594 597 562 563 528 533 525 546 533 525 546 533 531 531 531 531 531 531 531 531 531 531 531 531 531 531 531 531 531 531 531 531 531 531 531 531 531 531 531 531 531 531 531 531 531 531
531 531 535 531 531 535 531 535 531 535 531 535 531 547 527 547 553 553 523 533 533 531 531 535 547 527 547 521 574 585 564 599 596 598 594 597 570 574 528 533 533 531 533 533 525 546 531 531 531 531 531 531 531 531 531 531 531 531 531 531 531 531 531 531 531 531 531 531 531 531 531 531 531 531 531 531 531 531 531 531
531 531 535 531 531 535 531 535 531 535 531 547 527 531 535 531 531 531 525 523 533 531 531 535 531 535 531 529 574 574 575 599 596 586 587 597 570 520 546 533 533 531 533 533 533 531 531 531 531 531 531 531 531 531 531 531 531 531 531 531 531 531 531 531 531 531 531 531 531 531 531 531 531 531 531 531 531 531 531 531
531 531 535 531 531 547 527 535 531 535 531 531 535 531 547 527 531 525 546 525 546 531 531 547 527 547 527 547 521 574 575 599 596 594 595 597 570 528 525 546 533 525 523 533 533 531 531 531 531 531 531 531 531 531 531 531 531 531 531 531 531 531 531 531 531 531 531 531 531 531 531 531 531 531 531 531 531 531 531 531
531 531 535 531 531 531 535 535 531 547 527 531 535 531 531 535 525 546 531 533 531 531 531 531 535 531 535 531 529 574 575 599 596 594 595 597 570 528 533 525 546 533 531 533 533 531 531 531 531 531 531 531 531 531 531 531 531 531 531 531 531 531 531 531 531 531 531 531 531 531 531 531 531 531 531 531 531 531 531 531
531 531 535 531 531 531 535 535 531 531 535 531 535 531 531 535 533 531 525 546 531 531 531 531 547 527 547 527 529 574 575 599 596 594 595 597 570 528 533 533 525 546 525 546 541 519 531 531 531 531 531 531 531 531 531 531 531 531 531 531 531 531 531 531 531 531 531 531 531 531 531 531 531 531 531 531 531 531 531 531
531 531 547 527 531 531 535 535 531 531 535 531 535 531 531 547 546 531 533 531 531 531 531 531 531 535 531 532 529 574 575 599 596 594 696 597 570 528 533 533 533 531 533 531 531 541 542 519 531 531 531 531 531 531 531 531 531 531 531 531 531 531 531 531 531 531 531 531 531 531 531 531 531 531 531 531 531 531 531 531
531 531 531 535 531 531 535 535 531 531 535 531 535 531 531 531 531 531 533 531 531 531 531 531 531 547 527 532 529 574 575 599 596 594 595 597 570 528 533 533 533 531 533 531 531 531 531 541 542 542 519 531 531 531 531 531 531 531 531 531 531 531 531 531 531 531 531 531 531 531 531 531 531 531 531 531 531 531 531 531
531 531 531 535 531 531 535 535 531 531 535 531 535 531 531 531 531 531 533 531 531 531 531 531 531 531 535 532 529 574 575 599 596 594 595 597 570 528 533 533 533 531 541 519 531 531 531 531 531 531 541 519 531 531 531 531 531 531 531 531 531 531 531 531 531 531 531 531 531 531 531 531 531 531 531 531 531 531 531 531
531 531 531 535 531 531 535 535 531 531 535 531 535 531 531 531 531 531 533 531 531 531 531 531 531 531 535 532 529 574 575 599 596 594 595 597 570 528 533 533 533 531 531 541 542 542 519 531 531 531 531 541 542 542 542 519 531 531 531 531 531 531 531 531 531 531 531 531 531 531 531 531 531 531 531 531 531 531 531 531
531 531 531 535 531 531 535 535 531 531 535 531 535 531 531 531 531 531 533 531 531 531 531 531 531 531 535 532 529 574 575 599 596 602 721 597 570 528 533 533 533 531 531 531 531 531 541 542 542 519 531 531 531 531 531 533 531 531 531 531 531 531 531 531 531 531 531 531 531 531 531 531 531 531 531 531 531 531 531 531
531 531 531 535 531 531 535 547 527 531 535 531 535 531 531 531 525 526 546 531 531 531 531 531 531 531 535 532 529 574 575 599 596 598 594 597 570 528 533 533 541 519 531 531 531 531 531 531 531 533 531 531 531 531 531 541 542 519 531 531 531 531 531 531 531 531 531 531 531 531 531 531 531 531 531 531 531 531 531 531
531 531 531 535 531 531 535 531 535 531 535 531 535 531 531 531 533 531 531 531 531 531 531 531 531 531 535 532 529 574 575 599 596 598 594 597 570 528 533 533 531 541 542 519 531 531 531 531 531 541 542 542 519 531 531 531 531 541 542 542 542 542 542 519 531 531 531 531 531 531 531 531 531 531 531 531 531 531 531 531
531 531 531 535 531 531 535 531 535 531 535 531 535 531 531 531 533 531 531 531 531 531 531 531 531 531 535 532 529 574 575 599 596 598 594 597 570 528 533 533 531 531 531 541 542 542 519 531 531 531 531 531 541 542 542 519 531 531 531 531 531 531 531 541 542 542 519 531 531 531 531 531 531 531 531 531 531 531 531 531