Underwater_SealedChamber_Layout (22x48)
531 531 531 531 518 542 613 614 615 542 542 519 531 531 531 531 531 531 531 531 531 531
531 531 531 518 543 518 621 622 623 542 519 530 531 531 531 531 531 531 531 531 531 531
531 531 531 532 518 537 704 707 707 705 528 530 531 531 531 531 531 531 531 531 531 531
531 531 531 532 529 704 708 720 721 698 528 530 531 531 531 531 531 531 531 531 531 531
531 531 531 532 529 700 720 732 722 698 528 530 531 531 531 531 531 531 531 531 531 531
531 531 531 532 529 700 724 726 722 698 528 530 531 531 531 531 531 531 531 531 531 531
531 531 518 543 529 700 724 726 722 698 528 541 519 531 531 531 531 531 531 531 531 531
531 531 532 518 537 700 724 726 722 698 528 531 530 531 531 531 531 531 531 531 531 531
531 531 532 529 702 700 724 726 722 698 528 531 530 531 531 531 531 531 531 531 531 531
531 531 532 529 702 700 724 726 722 698 536 519 530 531 531 531 531 531 531 531 531 531
531 531 532 529 704 708 724 726 722 698 702 528 530 531 531 531 531 531 531 531 531 531
531 531 532 529 700 723 724 726 722 698 702 528 530 531 531 531 531 531 531 531 531 531
531 531 532 529 700 723 724 726 722 698 702 528 530 531 531 531 531 531 531 531 531 531
531 531 532 529 700 723 724 726 722 706 705 528 530 531 531 531 531 531 531 531 531 531
531 531 532 529 700 723 724 726 722 723 698 528 530 531 531 531 531 531 531 531 531 531
531 531 532 529 700 723 724 726 730 721 698 528 541 519 531 531 531 531 531 531 531 531
531 531 532 529 700 723 724 726 726 722 698 536 519 530 531 531 531 531 531 531 531 531
531 531 532 529 691 692 715 716 726 722 706 705 528 530 531 531 531 531 531 531 531 531
531 531 532 544 521 700 723 724 726 722 723 698 528 530 531 531 531 531 531 531 531 531
531 531 547 527 529 700 723 724 726 730 721 698 528 530 531 531 531 531 531 531 531 531
531 531 531 529 529 691 692 724 726 726 722 698 528 530 531 531 531 531 531 531 531 531
531 531 531 529 529 702 700 724 726 726 722 698 528 530 531 531 531 531 531 531 531 531
531 531 531 532 544 521 700 724 726 726 722 698 528 541 519 531 531 531 531 531 531 531
531 531 531 532 531 529 700 715 716 726 722 698 536 519 530 531 531 531 531 531 531 531
531 531 531 547 527 529 691 692 724 726 722 706 705 528 530 531 531 531 531 531 531 531
531 531 531 531 532 544 521 700 724 726 730 721 698 528 541 519 531 531 531 531 531 531
531 531 531 531 532 531 529 700 729 716 726 722 698 536 519 530 531 531 531 531 531 531
531 531 531 531 547 527 529 713 692 724 726 722 706 705 528 530 531 531 531 531 531 531
531 531 531 531 531 532 544 521 700 724 726 722 723 698 528 530 531 531 531 531 531 531
531 531 531 531 531 532 531 529 700 724 726 730 721 698 528 530 531 531 531 531 531 531
531 531 531 531 531 532 531 529 700 729 716 726 722 698 528 530 531 531 531 531 531 531
531 531 531 531 531 532 531 529 700 723 724 726 722 698 528 530 531 531 531 531 531 531
531 531 531 531 531 547 527 529 713 692 724 726 722 698 528 530 531 531 531 531 531 531
531 531 531 531 531 531 532 544 521 700 724 726 722 698 528 530 531 531 531 531 531 531
531 531 531 531 531 531 532 531 529 700 724 714 715 698 528 530 531 531 531 531 531 531
531 531 531 531 531 531 532 531 529 700 715 715 723 698 528 541 539 539 519 531 531 531
531 531 531 531 518 539 543 531 529 700 723 723 723 698 536 539 539 519 541 539 519 531
531 531 531 518 543 531 518 539 537 700 723 723 723 706 707 707 705 536 539 519 541 519
531 531 531 532 518 539 537 704 707 708 723 723 723 723 723 723 706 707 705 528 531 530
531 531 531 532 529 704 707 708 723 514 544 544 544 544 544 515 723 723 698 536 519 530
531 531 531 532 529 700 723 723 690 528 531 531 531 531 531 529 692 723 706 705 528 530
531 531 531 532 529 700 723 723 698 528 531 531 531 531 531 529 700 723 723 698 528 530
531 531 531 532 529 700 723 723 698 528 531 531 531 531 531 529 700 723 723 698 528 530
531 531 531 532 529 700 723 723 698 536 542 542 624 542 542 537 700 723 723 698 528 530
531 531 531 532 529 700 723 723 706 707 707 579 579 579 707 707 708 723 723 698 528 530
531 531 531 532 529 691 692 723 723 723 723 595 595 595 723 723 723 690 691 691 528 530
531 531 531 532 547 521 700 723 723 723 723 595 595 595 723 723 723 698 520 544 546 530
531 531 531 532 531 547 544 544 544 544 544 544 544 544 544 544 544 544 546 531 531 530