UnknownMap_08302970_Layout (60x40)
113 113 113 113 113 113 113 113 113 113 113 116 124 124 125 117 116 169 124 125 384 408 368 368 368 410 385 123 137 113 115 123 137 292 226 292 292 292 292 226 292 292 117 117 113 117 400 368 368 368 368 368 368 368 368 368 368 368 368 368
113 113 113 113 113 113 113 113 116 124 124 125 113 113 116 125 117 384 393 393 408 368 368 368 368 368 410 385 123 137 123 137 115 292 292 292 292 292 292 292 292 116 125 117 116 125 400 368 368 368 368 368 368 368 368 368 368 368 368 368
124 124 124 124 124 124 124 124 125 113 113 113 116 124 125 116 125 400 368 368 368 368 368 368 368 368 368 410 385 115 113 115 123 137 292 292 292 226 292 116 124 125 113 117 117 384 408 368 368 368 368 368 368 368 368 368 368 368 368 368
113 113 113 113 113 116 169 169 169 124 124 124 125 113 116 125 384 408 368 368 368 368 368 368 368 368 368 336 357 115 113 123 137 123 137 226 292 292 116 125 113 116 124 125 117 400 368 368 368 368 368 368 368 368 368 368 368 368 368 368
113 113 116 124 124 125 113 113 113 116 169 169 169 124 125 384 408 368 368 368 368 368 368 368 368 368 368 344 365 123 137 113 123 137 123 124 124 124 125 113 116 125 116 124 125 400 368 368 368 368 368 368 368 368 368 368 368 368 368 368
124 124 125 113 116 169 124 124 124 125 384 393 393 393 393 408 368 368 373 374 368 368 368 368 368 336 337 368 410 385 123 137 113 123 169 169 159 169 169 124 125 113 117 384 393 408 368 368 368 368 368 368 368 368 368 368 368 368 368 368
169 169 169 124 125 384 393 393 393 393 408 373 374 368 373 379 374 368 381 382 368 368 368 368 368 344 345 368 368 410 385 123 124 169 169 169 167 169 169 169 169 124 125 400 368 368 368 368 368 368 368 368 368 368 368 368 368 368 368 368
384 393 346 347 393 408 368 368 368 368 368 381 382 368 378 113 380 368 368 368 368 368 368 368 368 368 336 337 368 368 410 393 393 385 292 292 292 292 292 384 393 346 347 408 368 368 368 368 336 337 368 368 368 368 368 368 368 368 368 368
408 368 344 345 368 368 368 368 373 374 368 368 368 368 386 121 388 368 368 368 368 368 368 368 373 374 344 345 368 368 368 368 368 402 292 292 292 292 292 400 368 344 345 373 379 379 379 374 344 345 368 368 368 368 368 368 368 368 368 368
368 368 368 368 373 379 374 368 381 382 368 368 373 374 336 337 368 368 368 368 368 368 336 337 381 382 368 368 368 368 368 368 368 410 393 393 393 393 393 408 368 373 374 386 121 137 113 380 368 368 373 374 368 368 368 368 368 368 368 368
368 368 368 368 378 113 380 368 368 368 368 368 381 382 344 345 368 368 373 374 368 368 344 345 368 373 379 374 368 368 368 368 368 368 368 368 368 368 368 368 368 381 382 368 368 386 121 388 336 337 381 382 368 368 368 368 368 368 368 368
336 337 368 368 386 121 388 368 368 373 374 336 337 368 368 368 336 337 381 382 368 336 337 368 368 378 113 380 373 374 368 368 368 368 368 368 368 368 368 368 373 374 368 368 368 368 368 368 344 345 368 373 379 379 374 368 368 368 368 368
344 345 368 368 368 368 368 336 337 381 382 344 345 368 373 374 344 345 368 336 337 344 345 368 368 386 121 388 381 382 368 368 373 374 368 368 368 368 368 373 180 380 368 368 368 368 368 368 368 368 373 180 113 113 180 374 368 368 368 368
368 368 368 368 368 368 368 344 345 368 368 368 368 368 381 382 368 368 368 344 345 368 368 368 368 368 368 368 368 368 368 368 381 382 368 368 368 368 368 378 113 380 368 368 368 368 368 368 368 368 386 121 121 121 121 388 336 337 368 368
368 368 368 368 368 368 368 368 368 368 368 368 368 368 368 368 368 368 373 374 368 368 368 368 368 368 368 368 368 368 368 368 368 368 368 368 368 373 374 386 121 388 368 368 368 368 368 368 368 373 374 368 368 368 368 368 344 345 373 379
368 368 368 368 368 368 368 368 368 368 368 368 368 368 368 368 368 368 381 382 373 379 374 368 368 368 368 368 368 368 368 368 368 368 368 336 337 381 382 368 368 368 368 368 368 368 368 368 368 381 382 368 368 368 368 368 368 368 378 113
368 368 368 368 368 368 368 368 368 368 368 368 368 368 368 368 368 368 368 368 378 113 180 379 374 368 368 368 368 373 374 368 368 373 374 344 345 368 368 368 368 368 368 368 373 379 374 368 368 368 368 368 368 368 368 368 373 374 386 121
368 368 368 368 368 368 368 368 368 368 368 368 368 368 368 368 368 368 368 368 386 121 121 121 388 368 368 368 368 381 382 373 374 381 382 368 368 368 368 368 368 368 373 379 180 113 380 368 368 368 368 368 368 368 368 368 381 382 368 368
368 368 368 368 368 368 368 368 368 368 368 368 368 368 368 368 368 368 368 368 368 368 368 373 374 368 368 368 368 368 368 381 382 368 368 368 368 368 368 368 368 368 378 113 113 113 380 368 368 368 368 368 368 368 368 368 368 368 336 337
368 368 368 368 368 368 368 368 368 368 368 368 368 368 368 368 368 368 368 368 368 368 368 381 382 368 368 368 368 368 368 368 368 368 368 368 368 368 368 368 368 368 386 121 121 121 388 368 368 368 368 368 368 368 368 368 368 368 344 345
368 368 368 368 368 368 368 368 368 368 368 368 368 368 368 368 368 368 368 368 368 368 368 368 336 337 368 368 373 374 368 368 368 368 368 368 368 373 379 374 368 368 368 368 368 368 368 368 368 368 368 368 368 368 368 368 368 368 368 368
368 368 368 368 368 368 368 368 368 368 368 368 368 368 368 368 368 368 368 368 368 368 368 368 344 345 336 337 381 382 368 368 368 368 373 374 373 180 113 380 368 368 368 368 368 368 368 368 368 368 368 368 368 368 368 368 368 368 368 368
368 368 368 368 368 368 368 368 368 368 368 368 368 368 368 368 368 368 368 368 368 368 368 368 368 368 344 345 368 368 373 379 379 374 381 382 386 121 121 388 368 368 368 368 368 368 368 368 368 368 368 368 368 368 368 368 368 368 368 368
368 368 368 368 368 368 368 368 368 368 368 368 368 368 368 368 368 368 368 368 368 368 368 368 368 368 368 368 368 368 386 121 121 388 368 368 368 368 368 368 368 368 368 368 368 368 368 368 368 368 368 368 368 368 368 368 368 368 368 368
368 368 368 368 368 368 368 368 368 368 368 368 368 368 368 368 368 368 368 368 368 368 368 368 368 368 368 368 368 368 368 368 368 368 368 368 368 368 368 368 368 368 368 368 368 368 368 368 368 368 368 368 368 368 368 368 368 368 368 368
368 368 368 368 368 368 368 368 368 368 368 368 368 368 368 368 368 368 368 368 368 368 368 368 368 368 368 368 368 368 368 368 368 368 368 368 368 368 368 368 368 368 368 368 368 368 368 368 368 368 368 368 368 368 368 368 368 368 368 368
368 368 368 368 368 368 368 368 368 368 368 368 368 368 368 368 368 368 368 368 368 368 368 368 368 368 368 368 368 368 368 368 368 368 368 368 368 368 368 368 368 368 368 368 368 368 368 368 368 368 368 368 368 368 368 368 368 368 368 368
368 368 368 368 368 368 368 368 368 368 368 368 336 337 368 368 368 368 368 368 368 368 368 368 368 368 368 368 368 368 368 368 368 368 368 368 368 368 368 368 368 368 368 368 368 368 368 368 368 368 368 368 368 368 368 368 368 368 373 374
368 368 368 368 368 368 336 337 368 368 368 368 344 345 368 368 368 368 368 368 368 368 368 368 368 368 368 368 368 368 368 368 368 368 368 368 368 368 368 368 368 368 368 368 368 368 368 368 336 337 373 374 368 368 368 368 368 368 381 382
368 368 368 373 374 368 344 345 368 368 368 368 368 368 368 368 373 374 368 368 368 368 368 368 368 368 368 368 368 368 368 368 368 368 368 368 368 368 368 368 368 368 368 368 368 368 368 368 344 345 381 382 368 368 368 368 368 368 373 379
336 337 368 381 382 368 368 368 373 379 374 368 368 368 368 368 378 180 374 368 373 374 368 368 368 368 368 368 368 368 368 368 368 368 368 373 374 368 368 368 368 368 368 368 368 368 373 374 368 368 368 368 368 368 368 368 368 368 378 113
344 345 368 368 368 368 368 368 378 113 380 368 373 374 368 368 386 137 180 374 381 382 368 368 368 368 368 368 368 368 368 368 368 336 337 381 382 368 368 368 368 368 368 368 373 374 381 382 368 368 368 368 368 368 368 368 336 337 386 121
379 379 379 379 372 368 368 368 386 121 388 368 381 382 373 374 368 386 121 388 368 368 368 368 368 368 368 373 379 379 374 368 368 344 345 368 368 373 374 368 368 368 368 368 381 382 368 368 368 336 337 368 373 374 368 368 344 345 368 368
113 113 113 113 180 379 372 368 368 368 368 373 374 368 381 382 368 368 373 374 368 368 368 368 368 368 368 378 113 113 180 379 374 368 368 368 368 381 382 373 374 368 368 373 379 379 374 368 368 344 345 368 381 382 368 373 374 368 368 368
108 108 108 108 109 113 180 379 379 379 372 381 382 368 368 368 373 374 381 382 368 368 373 379 379 374 368 386 137 113 113 113 180 374 368 368 368 368 368 381 382 368 373 180 113 113 180 379 379 374 373 379 379 379 374 381 382 368 368 368
113 113 113 113 191 108 108 109 113 113 180 379 372 368 368 368 381 382 368 368 373 379 180 113 113 380 373 374 386 121 121 121 121 388 368 368 368 368 368 368 336 337 386 121 121 121 137 113 113 180 180 113 113 116 388 368 368 368 368 368
113 113 113 113 113 113 113 191 109 113 113 113 117 372 368 368 368 368 368 368 378 113 113 113 116 388 381 382 368 368 368 368 368 368 368 368 368 368 368 368 344 345 368 368 368 368 386 121 137 113 113 113 116 388 368 368 368 368 336 337
113 113 113 113 113 113 113 113 191 108 108 109 117 117 379 372 368 368 373 374 386 121 121 121 388 368 368 368 368 368 368 368 368 368 368 368 368 368 368 368 368 368 368 368 368 368 368 368 386 121 121 121 388 368 368 368 368 368 344 345
113 113 113 113 113 113 113 113 113 113 113 191 191 191 108 191 372 368 381 382 368 368 368 368 368 368 368 368 368 368 368 368 368 368 368 368 368 368 368 368 368 368 368 368 368 368 368 368 368 368 368 368 368 368 368 368 368 368 368 368
113 113 113 113 113 113 113 113 113 113 113 113 113 113 113 113 117 372 368 368 368 368 368 368 368 368 368 368 368 368 368 368 368 368 368 368 368 368 368 368 368 368 368 368 368 368 368 368 368 368 368 368 368 368 368 368 368 368 368 368