UnknownMap_082FF894_Layout (19x19)
796 809 809 809 809 809 809 809 809 809 809 809 809 809 809 809 809 809 797
841 819 796 809 809 809 809 809 809 809 809 809 809 809 809 809 797 819 800
802 819 802 819 819 819 819 819 819 819 819 819 819 819 819 819 800 819 800
802 796 810 819 796 809 809 809 809 809 809 809 809 809 797 819 808 797 800
802 802 819 796 810 796 809 809 809 809 809 809 832 797 808 797 819 800 840
802 802 819 802 796 810 795 795 795 795 795 795 833 808 797 800 819 800 800
802 802 819 802 847 795 795 795 796 876 797 795 795 795 800 800 819 800 800
802 802 819 802 802 795 795 796 879 868 878 797 795 795 800 800 819 800 800
802 802 819 802 802 795 796 879 868 868 868 878 797 795 800 800 819 800 800
802 802 819 802 802 795 877 868 863 868 863 868 875 795 800 800 819 806 800
802 802 819 807 802 795 877 868 868 863 868 868 875 795 800 800 819 800 800
802 802 819 802 802 795 804 874 863 868 863 872 804 795 800 846 819 800 800
807 802 819 802 804 794 795 804 874 868 872 804 795 792 804 800 819 800 800
802 802 819 804 791 802 795 795 804 873 804 795 795 800 783 804 819 800 800
802 804 791 819 802 804 818 818 818 818 818 818 818 804 800 819 783 804 800
802 819 802 819 804 818 818 818 818 818 818 818 818 818 804 819 846 819 800
802 819 804 818 818 818 818 791 819 819 819 783 818 818 818 818 804 819 800
802 819 819 819 819 819 819 804 818 818 818 804 819 819 819 819 819 819 800
804 818 818 818 818 818 818 818 791 819 783 818 818 818 818 818 818 818 804