UnknownMap_083041B4_Layout (27x46)
747 761 761 761 761 761 761 761 761 761 761 761 761 761 748 753 753 753 753 753 753 753 753 753 753 753 753
754 747 761 761 761 761 761 761 761 761 761 761 761 748 752 753 753 753 753 753 753 753 753 753 753 753 753
754 754 757 757 757 757 757 757 757 757 757 757 757 752 760 761 761 748 753 753 753 753 753 753 753 753 753
754 756 745 771 757 757 757 757 757 757 757 757 757 760 761 761 748 752 753 753 753 753 753 753 753 753 753
754 753 753 754 757 758 757 757 757 757 757 757 757 757 757 757 752 752 753 753 753 753 753 753 753 753 753
756 745 746 756 741 742 743 745 771 757 757 757 757 757 757 757 752 752 753 753 753 753 753 753 753 753 753
753 753 754 753 753 753 753 753 754 757 757 757 757 757 757 757 752 752 753 753 753 753 753 753 753 753 753
753 753 756 745 745 746 753 753 754 747 761 761 516 761 761 748 752 760 748 753 753 753 753 753 753 753 753
753 753 753 753 753 754 753 753 754 754 757 757 757 757 757 752 752 753 752 753 753 753 753 753 753 753 753
753 753 753 753 753 754 753 753 754 754 757 757 757 757 757 752 752 753 760 748 753 753 753 753 753 753 753
753 753 753 753 753 754 753 753 754 754 757 757 757 757 757 752 760 748 753 752 753 753 753 753 753 753 753
753 753 753 753 753 754 753 747 762 754 747 761 516 761 748 752 753 752 753 752 753 753 753 753 753 753 753
753 753 753 753 753 754 753 754 747 762 754 757 757 757 752 752 753 752 753 760 748 753 753 753 753 753 753
753 753 753 753 747 762 753 754 754 747 762 757 757 757 752 760 748 760 748 753 752 753 753 753 753 753 753
753 753 753 753 754 753 753 754 754 754 757 757 757 757 760 748 752 753 752 753 760 748 753 753 753 753 753
753 747 761 761 762 753 747 762 754 754 757 757 757 757 757 752 752 753 752 753 753 752 753 753 753 753 753
753 754 753 753 753 753 754 747 762 754 539 537 516 537 540 752 760 748 752 753 753 752 753 753 753 753 753
761 762 753 747 761 761 762 754 747 762 530 529 529 529 528 760 748 752 752 753 753 752 753 753 753 753 753
753 753 753 754 753 753 753 754 754 539 538 529 529 529 536 540 752 752 752 753 753 752 753 753 753 753 753
747 761 761 762 753 747 761 762 754 530 529 529 529 529 529 528 752 752 752 753 753 752 753 753 753 753 753
754 753 753 753 753 754 753 753 754 530 529 529 529 529 529 528 752 752 760 761 748 760 761 761 761 761 761
754 753 753 747 761 762 753 753 754 530 539 537 516 537 540 528 752 752 753 753 752 753 753 753 753 753 753
754 753 747 762 753 753 747 761 762 530 530 529 529 529 528 528 752 760 761 748 760 761 761 761 761 761 748
762 753 754 753 753 747 762 529 529 530 530 529 529 529 528 528 760 761 748 760 761 761 761 761 761 748 752
761 761 762 753 753 754 539 525 525 538 530 529 529 529 528 536 540 540 760 761 761 761 761 748 753 752 752
753 747 761 761 761 762 530 529 539 525 538 529 529 529 536 525 540 536 525 525 540 529 529 752 753 752 760
753 754 529 529 539 525 538 539 538 529 529 529 529 529 529 529 536 525 540 529 536 540 529 752 753 760 761
753 754 529 529 530 529 539 538 529 529 529 529 529 529 529 529 529 529 528 529 529 528 529 752 753 753 753
747 762 539 525 538 529 530 529 529 529 529 529 529 529 544 521 521 521 547 529 529 536 540 760 761 761 748
754 529 530 529 539 525 538 529 529 529 544 521 521 521 547 529 529 529 529 529 529 529 528 529 529 529 752
754 529 530 529 530 529 529 529 529 544 547 529 529 529 529 529 529 529 529 529 529 529 536 525 525 540 752
754 529 530 539 538 529 529 529 529 528 529 529 529 529 539 525 525 525 525 525 540 529 529 529 529 528 752
754 529 530 530 529 529 529 529 544 547 529 529 529 539 538 539 525 525 525 540 536 525 540 529 529 528 752
754 539 538 530 529 529 529 529 528 529 529 539 525 538 539 538 869 870 871 536 525 540 536 525 540 528 752
754 530 529 530 529 529 529 544 547 529 529 530 539 525 538 869 883 868 882 870 871 536 525 540 528 528 752
754 530 529 530 529 529 529 528 529 529 529 530 530 869 870 883 868 863 868 868 882 870 871 528 528 528 752
754 530 529 530 529 529 529 528 529 529 539 538 530 881 868 868 863 868 863 863 868 868 880 528 528 528 752
754 530 539 538 529 529 529 536 540 529 530 539 538 881 868 863 863 863 863 863 863 868 880 528 528 528 752
754 530 530 529 529 529 529 529 528 529 530 530 869 883 863 868 863 863 863 863 868 863 880 528 528 528 752
754 530 530 529 529 529 529 529 536 525 538 530 881 868 868 863 863 863 863 863 863 868 880 528 528 528 752
754 530 530 529 529 529 529 529 529 529 529 547 547 866 868 868 863 868 863 868 863 868 880 528 528 528 752
755 755 755 789 529 529 529 529 529 529 529 529 529 547 866 863 868 863 868 863 864 865 865 547 528 528 752
753 753 753 755 745 789 529 529 529 529 529 529 529 529 547 865 865 865 865 865 547 529 529 529 528 528 752
753 753 753 529 529 755 745 745 745 789 529 529 529 529 529 529 529 529 529 529 529 529 529 788 756 756 756
753 753 753 753 753 753 753 753 753 755 745 745 745 789 529 529 529 529 529 529 788 745 745 756 753 753 753
753 753 753 753 753 753 753 753 753 753 753 753 753 755 745 745 745 745 745 745 755 753 753 753 753 753 753