UnknownMap_082EDF30_Layout (58x26)
515 515 515 515 515 514 514 515 515 515 515 515 514 515 515 515 515 515 515 515 526 527 515 515 515 515 515 515 515 515 515 515 515 515 515 515 515 515 515 515 515 515 515 515 515 515 515 515 515 515 515 515 515 515 515 515 515 515
515 515 526 527 515 515 514 514 515 515 515 514 515 515 515 515 514 515 515 515 534 535 515 515 526 527 526 527 515 515 515 515 526 527 515 515 515 515 515 515 515 515 515 515 515 515 515 515 515 515 515 515 515 515 515 515 515 515
515 514 534 535 515 515 515 515 514 515 515 515 515 515 515 515 515 515 515 526 527 526 527 515 534 535 534 535 523 524 524 525 534 535 515 515 515 515 515 515 515 515 515 515 515 515 515 515 515 515 515 515 515 515 515 515 515 515
515 526 527 526 527 526 527 523 524 524 525 526 527 520 521 521 522 515 515 534 535 534 535 515 526 527 526 527 531 532 532 533 526 527 515 515 515 515 515 515 515 515 515 515 515 515 515 515 515 515 515 515 515 515 515 515 515 515
515 534 535 534 535 534 535 531 532 532 533 534 535 528 529 529 530 515 515 515 515 515 515 515 534 535 534 535 539 540 543 541 534 535 515 515 515 515 515 615 615 615 615 615 615 615 615 515 515 515 515 515 515 515 515 515 515 515
560 517 517 517 517 517 562 539 540 543 541 583 583 536 537 542 538 562 590 612 613 612 613 591 587 588 593 515 548 549 550 551 526 527 515 515 515 515 515 615 615 615 615 615 615 615 615 515 515 515 515 515 515 515 515 515 515 515
568 519 519 519 519 519 570 548 545 550 551 519 513 544 545 546 547 570 598 611 611 611 599 611 595 596 609 526 527 514 513 515 534 535 515 515 515 515 515 615 615 615 615 615 615 615 615 615 615 615 615 515 515 515 515 515 515 515
568 519 614 614 614 614 584 516 514 516 516 519 519 516 514 516 516 570 598 611 611 611 611 611 611 611 609 534 535 514 514 515 515 515 515 515 515 615 615 615 615 615 615 615 615 615 615 615 615 615 615 515 515 515 515 515 515 515
568 519 614 614 614 614 519 519 519 519 519 519 519 519 519 519 519 570 598 611 611 611 611 611 611 611 609 514 514 514 515 526 527 515 515 515 515 615 615 615 615 615 615 615 615 615 615 615 615 615 615 515 515 515 515 515 515 515
568 519 614 614 614 614 519 519 519 520 521 521 522 585 585 585 585 578 606 607 607 607 607 607 607 607 601 515 514 515 515 534 535 515 515 615 615 615 615 615 615 615 615 615 615 615 615 615 615 615 615 515 515 515 515 515 515 515
568 519 614 614 614 614 519 519 519 528 529 529 530 514 514 515 515 515 515 515 515 515 515 515 515 515 515 515 515 515 515 515 515 514 515 515 515 515 515 515 515 515 515 515 515 515 515 515 515 515 515 515 515 515 515 515 515 515
568 519 519 579 581 581 580 519 519 552 553 554 538 583 562 515 523 524 524 525 515 515 526 527 515 515 526 527 526 527 526 527 526 527 515 515 515 515 515 515 515 515 515 515 515 515 515 515 515 515 515 515 515 515 515 515 515 515
568 519 519 563 526 527 565 519 519 544 549 546 547 519 570 515 531 532 532 533 515 515 534 535 515 515 534 535 534 535 534 535 534 535 515 515 515 515 515 515 515 515 515 515 515 515 515 515 515 515 515 515 515 515 515 515 515 515
568 519 519 563 534 535 565 519 519 516 519 516 516 516 570 515 555 556 557 541 526 527 515 515 515 515 515 515 526 527 526 527 526 527 515 515 515 515 515 515 515 515 515 515 515 515 515 515 515 515 515 515 515 515 515 515 515 515
568 519 519 517 583 583 517 519 519 519 519 519 519 519 570 515 548 549 550 551 534 535 515 515 515 514 515 515 534 535 534 535 534 535 515 515 515 515 515 515 515 515 515 515 515 515 515 515 515 515 515 515 515 515 515 515 515 515
568 519 519 518 516 516 518 519 519 519 626 519 519 519 584 516 516 514 516 516 572 572 516 513 514 515 515 515 515 515 515 526 527 515 515 515 515 515 515 515 515 515 515 515 515 515 515 515 515 515 515 515 515 515 515 515 515 515
568 519 519 519 519 519 519 519 519 519 519 519 519 519 519 519 519 519 519 519 519 519 519 514 514 515 515 515 515 514 515 534 535 514 515 515 515 515 515 515 515 515 515 515 515 515 515 515 515 515 515 515 515 515 515 515 515 515
568 517 517 517 519 519 519 519 625 519 519 519 624 519 519 519 519 519 519 519 519 519 519 515 515 515 515 515 514 515 515 526 527 514 515 515 515 515 515 515 515 515 515 515 515 515 515 515 515 515 515 515 515 515 515 515 515 515
568 519 519 519 519 519 519 519 519 519 519 519 519 519 519 519 519 519 519 519 519 519 519 514 515 515 515 515 515 515 515 534 535 515 515 515 515 515 515 515 515 515 515 515 515 515 515 515 515 515 515 515 515 515 515 515 515 515
568 519 616 616 616 616 619 519 519 519 627 519 579 585 585 585 585 585 585 580 519 519 519 513 515 514 515 515 515 515 515 515 526 527 515 515 515 515 515 515 515 515 515 515 515 515 515 515 515 515 515 515 515 515 515 515 515 515
568 519 618 519 519 519 619 519 519 519 519 519 563 526 527 526 527 526 527 565 519 519 519 570 526 527 526 527 526 527 526 527 534 535 515 515 515 515 515 515 515 515 515 515 515 515 515 515 515 515 515 515 515 515 515 515 515 515
568 519 618 519 519 519 619 519 519 519 519 519 563 534 535 534 535 534 535 565 519 519 519 570 534 535 534 535 534 535 534 535 515 515 515 515 515 515 515 515 515 515 515 515 515 515 515 515 515 515 515 515 515 515 515 515 515 515
568 519 618 519 519 519 619 519 519 519 519 519 563 526 527 526 527 526 527 565 519 519 519 570 526 527 526 527 526 527 526 527 526 527 515 515 515 515 515 515 515 515 515 515 515 515 515 515 515 515 515 515 515 515 515 515 515 515
568 519 618 617 519 617 617 519 519 519 519 519 563 534 535 534 535 534 535 565 519 519 519 570 534 535 534 535 534 535 534 535 534 535 515 515 515 515 515 515 515 515 515 515 515 515 515 515 515 515 515 515 515 515 515 515 515 515
568 519 519 519 519 519 519 519 519 519 519 519 563 526 527 526 527 526 527 565 519 519 519 570 526 527 526 527 526 527 526 527 526 527 515 515 515 515 515 515 515 515 515 515 515 515 515 515 515 515 515 515 515 515 515 515 515 515
568 519 519 519 516 516 516 519 519 519 519 519 563 534 535 534 535 534 535 565 519 519 519 570 534 535 534 535 534 535 534 535 534 535 515 515 515 515 515 515 515 515 515 515 515 515 515 515 515 515 515 515 515 515 515 515 515 515