UnreferencedMap_Layout (80x40)
368 368 368 368 368 368 368 368 368 368 368 368 368 368 368 368 368 368 368 368 368 368 368 368 368 368 368 368 368 368 368 368 368 368 368 368 368 368 368 368 368 368 368 368 368 368 368 368 368 368 368 368 368 368 368 368 368 368 368 368 368 368 368 368 368 368 368 368 368 368 368 368 368 368 368 368 368 368 368 368
368 368 368 368 368 368 368 368 368 368 368 368 368 368 368 368 368 368 368 368 368 368 368 368 368 368 368 368 368 368 368 368 368 368 368 368 368 368 368 368 368 368 368 368 368 368 368 368 368 368 368 368 368 368 368 368 368 368 368 368 368 368 368 368 368 368 368 368 368 368 368 368 368 368 368 368 368 368 368 368
368 368 368 368 368 368 368 368 368 368 368 368 368 368 368 368 368 368 368 368 368 368 368 368 368 368 368 368 368 368 368 368 368 368 645 211 2 2 2 2 2 2 2 2 2 2 2 2 212 646 368 368 368 368 368 368 368 368 368 368 368 368 368 368 368 368 368 368 368 368 368 368 368 368 368 368 368 368 368 368
368 368 368 368 368 368 368 368 368 368 368 368 368 368 368 368 368 368 368 368 368 368 368 368 368 368 368 368 368 368 368 368 368 645 2 1 1 1 1 1 1 13 13 13 1 1 1 1 1 212 646 368 368 368 368 368 368 368 368 368 368 368 368 368 368 368 368 368 368 368 368 368 368 368 368 368 368 368 368 368
368 368 368 368 368 368 368 368 368 368 368 368 368 368 368 368 368 368 368 368 368 368 368 368 368 368 368 368 368 368 368 368 645 2 1 14 1 1 1 1 13 13 13 13 13 13 13 13 1 1 212 646 368 368 368 368 368 368 368 368 368 368 368 368 368 368 368 368 368 368 368 368 368 368 368 368 368 368 368 368
368 368 368 368 368 368 368 368 368 368 368 368 368 368 368 368 368 368 368 368 368 368 368 368 368 368 368 368 368 368 368 645 115 1 14 198 14 1 1 13 13 13 13 13 13 13 13 13 13 1 1 114 646 368 368 368 368 368 368 368 368 368 368 368 368 368 368 368 368 368 368 368 368 368 368 368 368 368 368 368
368 368 368 368 368 368 368 368 368 368 368 368 368 368 368 368 368 368 368 368 368 368 368 368 368 368 368 368 368 645 2 2 2 14 198 198 198 1 1 13 13 13 13 13 13 13 13 13 13 13 1 2 2 212 646 368 368 368 368 368 368 368 368 368 368 368 368 368 368 368 368 368 368 368 368 368 368 368 368 368
368 368 368 368 368 370 379 379 379 379 379 379 374 368 368 368 368 368 368 368 368 368 368 368 368 368 368 368 645 2 1 1 14 198 198 198 198 1 1 13 13 13 13 13 13 13 13 13 13 13 13 1 1 1 212 646 368 368 368 368 336 337 368 368 368 368 368 368 368 368 368 368 368 368 368 368 368 368 368 368
368 368 368 368 370 180 113 107 108 108 109 113 180 374 368 368 368 368 373 374 368 368 368 368 336 337 368 370 115 1 1 1 198 198 198 198 198 1 1 1 13 13 13 13 13 13 13 13 13 13 13 259 260 261 1 117 372 368 336 337 344 345 368 368 368 368 368 370 379 379 379 379 379 379 379 374 368 368 368 368
368 368 368 373 180 113 107 180 113 113 117 113 113 380 373 374 368 368 381 382 368 373 379 374 344 345 370 115 115 1 1 1 22 198 198 22 22 1 1 1 1 14 14 14 13 13 13 13 13 13 13 267 268 269 1 117 117 372 344 345 368 373 374 368 373 379 379 180 113 107 108 108 108 109 113 180 374 368 368 368
368 373 374 386 137 113 123 124 124 124 125 113 116 388 381 382 368 368 368 368 368 378 113 380 429 637 115 115 115 1 1 1 1 22 22 1 1 1 1 1 14 198 198 198 14 14 13 13 13 13 13 275 276 277 1 117 117 117 638 431 368 381 382 368 378 113 113 113 107 190 107 108 109 190 109 113 180 374 368 368
368 381 382 368 386 121 137 113 113 113 116 121 388 368 368 373 379 379 374 368 368 386 121 388 437 358 115 115 115 1 1 1 1 1 1 1 1 1 1 1 198 198 198 198 198 198 14 14 13 13 13 1 1 1 1 117 117 117 359 439 368 368 373 374 378 113 113 113 115 113 123 124 125 113 117 113 113 380 368 368
336 337 368 368 368 368 386 121 121 121 388 368 368 368 368 378 113 113 380 368 373 374 368 368 437 358 115 115 115 1 1 1 1 1 1 1 1 1 1 1 22 198 198 198 198 198 198 198 14 13 1 1 1 1 1 117 117 117 359 439 373 374 381 382 386 137 113 113 123 137 113 113 113 116 125 113 116 388 368 368
344 345 368 368 368 373 374 368 368 368 368 368 368 373 374 386 121 121 388 368 381 382 368 368 437 358 115 115 123 124 124 124 137 1 4 1 1 1 1 1 1 22 198 198 198 198 198 198 198 1 1 116 124 124 124 125 117 117 359 439 381 382 368 368 368 386 121 137 113 123 124 124 124 125 113 116 388 368 373 374
379 374 368 368 368 381 382 368 368 368 368 368 368 381 382 368 368 368 336 337 368 368 368 368 437 358 115 123 169 169 169 137 115 4 1 4 1 1 1 1 1 1 22 198 198 198 198 198 198 1 1 117 116 169 169 169 125 117 359 439 368 368 368 368 336 337 368 386 121 145 145 145 145 145 121 388 368 368 381 382
113 380 368 368 368 368 368 368 368 368 368 368 336 337 368 368 368 368 344 345 368 368 373 374 437 358 123 169 169 169 137 115 115 1 4 1 4 1 4 1 1 1 1 198 198 198 198 22 22 1 1 117 117 116 169 169 169 125 359 439 368 368 368 368 344 345 368 368 368 368 368 368 368 368 373 374 368 368 368 368
121 388 368 368 368 368 368 368 368 368 368 368 344 345 368 368 368 368 368 368 368 368 381 382 437 366 145 145 145 137 115 115 123 124 124 124 137 4 1 1 1 1 1 22 22 22 22 116 124 124 124 125 117 117 116 145 145 145 367 439 368 373 374 368 368 368 368 368 368 368 368 368 368 368 381 382 368 368 368 368
368 368 368 368 368 368 368 368 368 368 368 368 368 368 368 368 368 368 368 368 373 374 368 368 437 413 292 292 292 136 115 123 169 169 169 137 123 124 124 137 1 1 1 1 116 124 124 125 116 169 169 169 125 117 114 292 292 292 415 439 368 381 382 368 368 368 368 368 373 374 368 368 368 368 368 368 368 368 368 368
368 368 373 374 368 368 368 368 368 368 368 368 368 368 368 368 368 368 368 368 381 382 368 368 437 421 422 397 292 136 123 169 169 169 137 123 169 169 137 123 124 516 516 124 125 116 169 169 125 116 169 169 169 125 114 292 292 292 415 439 368 368 368 368 368 368 368 368 381 382 368 368 368 368 368 368 368 368 368 368
368 368 381 382 373 379 374 368 368 368 368 368 368 368 373 374 368 368 368 368 368 368 368 368 437 414 414 413 292 144 145 145 145 137 123 169 169 137 123 169 169 516 516 169 169 125 116 169 169 125 116 145 145 145 146 292 292 292 415 439 368 368 368 368 368 368 368 368 368 368 368 368 368 368 368 368 368 368 368 368
373 374 368 368 378 116 388 368 368 368 368 368 368 368 381 382 368 368 368 368 368 368 368 368 437 414 414 413 292 292 292 290 1 120 145 145 137 123 169 169 169 516 516 169 169 169 125 116 145 145 122 1 1 288 292 292 292 398 423 439 368 368 368 368 368 368 368 368 368 368 368 368 368 368 368 368 368 368 368 368
381 382 368 368 386 388 368 368 368 368 368 368 368 368 368 368 368 368 368 368 368 368 368 368 445 446 419 421 422 397 292 290 1 1 1 1 120 145 145 145 145 516 516 145 145 145 145 122 1 1 1 1 1 288 292 292 398 423 420 447 368 368 368 368 368 368 368 368 368 368 368 368 368 368 368 368 368 368 368 368
368 368 368 368 368 368 368 368 368 368 368 368 368 368 368 368 368 368 368 368 368 368 368 368 368 368 437 414 414 413 292 292 282 1 1 1 1 1 1 1 1 1 1 1 1 1 1 1 1 1 1 1 280 292 292 398 423 414 439 368 368 368 368 368 368 368 368 368 368 368 368 368 368 368 368 368 368 368 368 368
368 368 368 368 368 368 368 368 368 368 368 368 368 368 368 368 368 368 368 368 368 368 368 368 368 368 437 414 414 413 292 292 289 282 1 1 1 1 1 1 1 1 1 1 1 1 1 1 1 1 280 281 292 292 398 423 414 420 447 368 368 368 368 368 368 368 368 368 368 368 368 368 368 368 368 368 368 368 368 368
368 368 368 368 368 368 368 368 368 368 368 368 368 368 368 368 368 368 368 368 368 368 368 368 368 368 437 414 414 421 397 292 292 289 281 282 1 1 1 1 1 1 1 1 1 1 1 280 281 281 292 292 292 292 415 414 414 439 368 368 368 368 368 368 368 368 368 368 368 368 368 368 368 368 368 368 368 368 368 368
368 368 368 368 368 368 368 368 368 368 368 368 368 368 368 368 368 368 368 368 368 368 368 368 368 368 437 414 414 414 413 292 292 292 292 290 1 1 1 1 1 1 1 1 1 280 281 292 292 292 292 292 292 398 423 414 414 439 368 368 368 368 368 368 368 368 368 368 368 368 368 368 368 368 368 368 368 368 368 368
368 368 368 368 368 368 368 368 368 368 368 368 368 368 368 368 368 368 368 368 368 368 368 368 368 368 445 446 419 414 421 422 397 292 292 292 281 281 281 281 281 281 281 281 281 292 292 292 292 292 292 292 292 415 414 420 446 447 368 368 368 368 368 368 368 368 368 336 337 368 368 368 368 368 368 368 373 374 368 368
368 368 368 368 368 368 368 368 368 368 368 368 368 368 368 368 368 368 368 368 368 368 368 368 368 368 368 368 437 414 414 414 413 292 292 292 292 292 292 292 292 292 292 292 292 292 292 398 422 422 422 422 422 423 414 439 368 368 368 368 368 368 368 368 336 337 368 344 345 368 368 370 379 379 379 374 381 382 368 368
373 379 379 374 368 368 368 368 368 368 368 368 368 368 368 368 368 368 368 368 368 368 368 368 368 368 368 368 445 419 414 414 421 422 397 292 292 292 292 292 292 292 292 292 292 292 292 415 414 414 414 420 446 446 446 447 368 368 368 368 368 368 368 368 344 345 368 368 368 370 379 180 113 113 113 180 374 368 373 374
180 113 113 380 368 368 368 368 368 368 368 368 368 368 368 368 368 368 368 368 368 368 368 368 368 368 368 368 368 437 414 414 414 414 421 422 422 422 422 422 422 422 422 422 422 422 422 423 414 414 420 447 368 368 368 368 368 368 368 368 368 368 368 368 368 368 373 379 379 180 113 113 113 113 113 113 180 374 381 382
113 113 116 388 368 336 337 368 368 368 368 368 368 368 368 368 368 368 368 368 368 368 368 368 368 368 368 368 368 445 446 446 446 446 446 446 446 446 446 446 446 446 446 446 446 446 446 446 446 446 447 368 368 368 368 368 368 368 368 368 368 373 374 368 368 368 386 137 113 113 113 113 113 113 113 113 113 180 374 368
121 121 388 373 374 344 345 336 337 373 379 374 368 373 374 368 368 368 368 368 368 368 336 337 368 368 368 368 368 368 368 368 368 368 368 368 368 368 368 368 368 368 368 368 368 368 368 368 368 368 368 368 368 368 368 368 368 368 368 368 368 381 382 368 368 368 368 386 121 137 113 113 113 113 113 113 116 121 388 368
368 368 368 381 382 368 368 344 345 386 121 388 368 381 382 368 368 368 368 368 368 368 344 345 373 379 379 379 374 368 368 368 373 374 368 368 368 368 368 368 368 368 368 368 368 368 368 368 368 368 368 368 368 368 368 368 336 337 368 373 374 368 373 379 379 379 374 368 368 386 121 121 121 121 121 121 388 336 337 368
368 368 368 368 368 368 368 368 368 368 368 368 373 374 368 336 337 368 368 368 373 374 368 368 378 113 113 113 180 379 374 368 381 382 368 368 368 368 368 368 373 374 368 368 368 368 368 368 368 368 368 368 368 368 368 368 344 345 368 381 382 368 386 137 113 113 180 374 368 368 368 368 368 368 368 368 368 344 345 373
368 368 368 368 368 368 368 368 368 368 368 368 381 382 368 344 345 373 379 374 381 382 373 374 386 121 121 137 113 113 180 374 368 373 374 368 368 368 336 337 381 382 368 368 368 368 368 368 368 336 337 368 368 368 368 370 379 379 379 374 368 368 368 386 137 116 121 388 368 368 368 368 368 368 368 368 368 368 368 381
368 368 368 368 368 336 337 368 368 368 368 368 368 368 368 368 368 378 113 380 368 368 381 382 368 368 368 386 121 121 121 388 368 381 382 336 337 368 344 345 368 368 373 379 379 374 368 373 374 344 345 368 368 370 379 180 113 107 109 180 374 368 368 368 386 388 368 368 368 368 368 368 368 368 368 368 368 368 368 368
368 368 368 368 368 344 345 368 368 368 368 368 368 368 368 368 368 386 121 388 368 368 368 368 368 368 368 368 368 368 368 368 368 368 368 344 345 373 374 368 368 368 386 137 113 180 374 381 382 368 373 379 379 180 107 108 109 123 125 113 380 368 368 368 368 368 368 368 368 368 368 368 368 368 368 368 368 368 368 368
368 368 368 368 368 368 368 368 368 368 368 368 368 368 368 368 368 368 368 368 368 368 368 368 368 368 368 368 368 368 368 368 368 368 368 368 368 381 382 368 368 368 368 386 121 121 388 368 368 368 386 137 113 113 123 124 125 113 113 116 388 368 368 368 368 368 368 368 368 368 368 368 368 368 368 368 368 368 368 368
368 368 368 368 368 368 368 368 368 368 368 336 337 368 368 368 368 368 368 368 368 368 368 368 368 368 368 368 368 368 368 368 368 368 368 368 368 368 368 368 368 368 368 368 368 368 368 368 336 337 368 386 121 121 145 145 145 121 121 388 368 368 368 368 368 368 368 368 368 368 368 368 368 368 368 368 368 368 368 368
368 368 368 368 368 368 368 368 368 368 368 344 345 368 368 368 368 368 368 368 368 368 368 368 368 368 368 368 368 368 368 368 368 368 368 368 368 368 368 368 368 368 368 368 368 368 368 368 344 345 368 368 368 368 368 368 368 368 368 368 368 368 368 368 368 368 368 368 368 368 368 368 368 368 368 368 368 368 368 368