VerdanturfTown_WandasHouse_Layout (17x8)
517 517 632 633 634 517 517 518 517 517 622 623 760 517 517 517 518
620 621 640 641 642 525 525 526 525 525 630 631 768 617 714 715 526
628 629 648 649 650 548 548 548 548 548 638 639 768 625 722 723 724
569 565 566 566 566 566 567 547 547 547 547 556 768 569 730 731 732
569 573 737 584 585 574 575 547 547 547 547 547 776 569 547 547 547
569 573 737 592 593 738 575 547 547 547 547 547 784 569 547 547 556
657 581 582 582 582 582 583 547 547 547 547 547 557 559 547 547 546
665 547 547 547 547 547 547 520 521 547 547 547 547 547 547 547 554