VerdanturfTown_Layout (20x20)
124 124 125 113 113 116 169 169 159 169 124 608 575 575 574 571 572 573 581 114
113 113 113 113 113 117 116 145 167 145 145 48 49 50 51 80 81 82 83 122
124 124 124 124 124 125 114 516 516 516 944 56 57 58 59 88 89 90 91 705
206 206 917 918 918 918 924 3 516 516 846 96 65 66 67 96 97 98 99 199
199 199 925 926 926 926 932 516 516 516 803 516 1 1 517 516 1 1 516 713
199 199 933 934 934 934 940 516 516 516 516 516 1 1 516 516 1 1 516 516
199 199 941 942 467 943 927 529 516 516 516 516 1 1 3 516 1 1 516 516
199 713 910 911 475 919 935 516 516 516 516 1 1 1 1 1 1 1 516 516
713 531 516 3 1 1 1 1 1 1 1 1 1 1 1 1 1 517 516 516
516 516 516 516 1 1 1 1 1 1 1 1 1 1 1 1 516 517 516 516
532 516 516 516 517 516 517 516 516 516 529 516 516 1 1 516 516 516 516 516
904 905 905 906 517 516 517 516 904 905 905 905 906 1 1 517 516 516 516 517
912 913 913 914 845 845 845 845 912 913 913 913 914 1 1 517 904 905 905 906
920 921 907 908 532 516 531 530 920 907 921 907 908 1 1 517 912 913 913 914
928 929 915 916 516 533 532 3 928 915 929 915 916 1 1 517 920 921 907 908
692 517 516 516 517 517 516 517 517 516 1 1 1 1 516 516 928 929 915 916
700 516 517 517 516 516 516 517 516 516 516 517 516 517 516 517 516 516 516 516
705 534 516 517 516 516 533 705 705 705 705 516 532 517 517 516 516 516 516 705
199 705 705 534 516 516 705 199 199 199 199 705 705 516 516 691 691 691 705 199
199 199 199 705 705 705 199 199 199 199 199 199 199 705 705 705 705 705 199 199