VictoryRoad_B1F_Layout (46x31)
529 539 537 537 537 537 537 537 537 537 537 537 537 537 537 537 537 537 537 537 537 537 537 537 537 537 537 537 537 537 537 537 537 537 537 537 537 537 537 537 537 537 537 537 540 529
529 530 529 529 529 539 537 537 537 537 537 537 540 529 529 529 529 529 539 537 537 537 537 537 540 529 529 529 529 529 539 537 537 537 537 537 537 537 537 537 540 529 529 529 528 529
539 538 539 537 537 538 539 537 527 537 540 529 536 537 537 540 529 539 538 529 539 537 540 529 536 537 537 537 537 537 538 539 537 537 537 540 529 529 529 529 528 529 517 529 528 529
530 529 530 539 537 537 538 513 534 513 536 537 537 540 529 536 537 538 539 537 538 513 536 537 537 537 540 529 529 529 529 530 513 513 513 536 540 529 529 529 528 529 529 529 528 529
530 529 530 530 513 513 513 513 513 513 513 848 513 536 537 537 537 537 538 513 513 513 513 513 513 513 536 537 540 529 529 547 522 513 513 513 536 540 529 529 528 529 529 529 528 529
530 539 538 530 513 520 521 521 522 513 513 568 513 513 513 513 513 513 513 513 513 513 520 521 522 513 513 513 528 529 529 529 547 522 513 513 513 528 529 529 528 529 529 529 528 529
530 530 539 538 513 536 537 537 538 513 513 850 513 513 513 513 520 521 521 522 513 520 547 529 530 513 513 513 528 529 529 529 529 547 522 513 513 528 529 544 547 529 529 529 536 540
530 530 530 513 513 513 513 513 513 513 520 521 521 521 522 513 528 529 529 547 521 547 529 529 530 513 513 520 547 529 529 529 529 529 530 513 520 547 529 528 529 529 529 529 529 528
530 530 547 522 513 520 521 521 522 513 528 529 529 529 530 513 536 540 544 521 521 521 521 700 699 700 700 701 700 521 521 521 521 522 530 513 528 529 529 528 614 529 529 529 614 528
530 547 546 530 513 536 537 537 538 513 536 540 529 529 530 513 513 528 528 529 529 529 529 708 707 708 708 709 708 529 529 529 529 530 530 513 536 540 529 528 529 529 529 529 529 528
530 529 530 530 513 513 513 513 513 513 513 528 529 529 530 513 513 528 536 537 537 516 537 538 530 513 513 528 536 537 537 537 516 538 530 513 513 536 540 536 540 529 614 529 529 528
530 529 530 547 521 521 521 521 522 513 520 547 529 529 530 513 513 536 537 537 537 516 537 537 538 513 513 536 540 529 529 539 516 537 538 513 513 513 536 540 536 540 537 537 540 528
547 546 547 521 521 546 529 529 530 513 536 537 537 537 538 513 513 513 513 513 513 513 513 513 848 513 513 513 528 529 529 530 513 513 513 513 513 513 513 528 529 529 529 529 528 528
529 530 529 529 529 547 546 529 530 513 513 513 513 513 513 513 520 521 521 522 513 513 513 513 568 513 513 513 528 529 529 547 521 522 513 513 513 513 513 528 529 529 529 544 547 528
539 538 529 529 539 537 538 529 547 521 521 521 521 521 521 521 547 529 529 547 521 522 513 513 568 513 513 513 528 529 529 529 529 547 521 521 522 513 513 528 544 521 521 547 544 547
530 539 537 537 538 529 529 529 529 539 537 537 537 537 537 537 537 537 537 540 529 530 513 513 850 513 513 513 528 529 544 547 521 521 521 700 699 700 700 701 701 529 529 529 528 529
530 530 529 539 537 537 537 537 537 538 513 513 513 848 513 513 514 517 513 528 529 547 521 521 521 522 513 513 528 529 528 529 529 529 529 708 707 708 708 709 709 529 529 529 528 529
530 530 539 538 513 513 513 513 513 513 513 513 513 568 513 513 513 513 513 528 529 529 529 529 529 530 513 513 528 529 536 537 516 537 537 538 530 513 513 528 528 529 529 529 528 529
530 530 530 513 513 513 513 513 513 513 513 513 513 850 513 513 513 520 521 547 529 529 529 529 529 530 513 513 536 537 537 537 516 537 540 529 530 513 513 528 528 529 529 529 528 529
530 530 530 513 513 520 547 521 521 521 521 521 521 522 513 513 513 528 529 529 529 539 537 540 529 530 513 513 513 513 513 513 513 520 547 529 530 513 513 528 528 529 529 544 547 529
530 530 530 513 513 536 540 520 547 521 522 529 529 530 513 513 513 528 529 539 527 538 513 528 529 547 521 522 513 513 513 513 520 547 529 539 538 513 513 528 528 529 529 528 529 529
530 530 530 513 513 513 528 528 529 529 530 529 529 530 513 513 520 547 529 530 534 513 513 528 529 529 529 547 521 521 521 521 547 529 539 538 513 513 513 528 528 529 529 528 529 529
530 530 530 513 513 520 547 536 540 529 530 529 529 530 513 513 528 529 529 547 521 522 513 528 529 529 529 529 529 529 529 529 529 529 530 513 513 513 513 528 528 529 529 536 537 540
530 530 530 513 513 536 540 529 528 529 547 522 529 530 513 513 528 529 529 529 529 530 513 528 529 529 529 529 529 529 529 529 529 529 547 522 513 513 513 528 536 516 537 537 540 528
530 530 530 513 513 513 536 540 528 529 529 547 522 530 513 513 536 537 537 537 537 538 513 528 529 529 529 529 539 537 537 537 540 529 529 530 513 513 513 536 537 516 527 540 528 528
530 530 530 513 513 513 513 528 528 529 529 539 538 530 513 513 513 513 513 513 513 513 513 528 529 529 529 529 530 513 517 513 536 537 537 538 513 513 513 848 513 513 534 528 528 528
530 530 547 522 513 517 513 528 536 537 537 538 529 530 513 513 513 513 513 513 513 513 513 528 529 529 529 529 530 513 513 513 513 513 513 513 513 513 513 568 513 513 513 528 528 528
530 530 529 530 513 513 513 536 537 537 537 537 537 538 513 513 513 513 513 513 513 520 521 547 529 529 529 529 530 513 513 513 513 513 513 513 513 513 513 850 513 513 513 528 528 528
530 530 529 547 521 521 521 521 521 521 521 521 521 521 521 521 521 521 521 521 521 547 529 529 529 529 529 529 547 521 521 521 521 521 521 521 521 521 521 521 521 521 521 547 528 528
530 547 521 521 521 521 521 521 521 521 521 521 521 521 521 521 521 521 521 521 521 521 521 521 521 521 521 521 521 521 521 521 521 521 521 521 521 521 521 521 521 521 521 521 547 528
547 521 521 521 521 521 521 521 521 521 521 521 521 521 521 521 521 521 521 521 521 521 521 521 521 521 521 521 521 521 521 521 521 521 521 521 521 521 521 521 521 521 521 521 521 547