VictoryRoad_1F_Layout (46x45)
529 529 529 529 529 529 529 529 529 529 529 529 529 529 529 529 529 529 529 529 529 529 529 529 529 539 537 537 537 537 537 537 537 537 537 537 537 537 537 537 537 537 537 537 540 529
529 529 529 529 529 529 529 529 529 529 529 529 529 529 529 529 529 529 529 529 529 529 529 529 529 530 529 529 539 537 537 537 537 537 537 537 537 537 537 537 537 537 537 540 528 529
529 529 529 529 529 529 529 529 529 529 529 529 529 529 529 529 529 529 529 529 529 529 529 529 529 530 529 529 530 539 537 537 537 537 537 537 537 537 537 537 537 537 540 528 528 529
529 529 529 529 529 529 529 529 529 529 529 529 529 529 529 529 529 529 529 529 529 529 529 529 529 530 529 529 530 530 513 513 513 513 513 513 513 513 513 513 514 543 528 528 528 529
529 529 529 529 529 529 529 529 529 529 529 529 529 529 529 529 529 529 529 529 529 529 539 537 537 538 529 529 530 530 513 513 513 513 513 513 513 513 513 513 513 551 528 528 528 529
529 529 529 529 529 529 529 529 529 529 529 529 529 529 529 529 529 529 529 529 529 529 530 539 537 537 537 537 538 530 513 513 513 513 513 513 513 513 513 519 513 515 528 528 528 529
529 529 529 529 529 529 529 529 529 529 529 529 529 529 529 529 529 529 529 529 529 529 530 530 539 537 537 537 537 538 513 513 513 520 521 521 521 521 600 601 602 521 547 528 528 529
529 529 529 529 529 529 529 529 529 529 529 529 529 529 529 529 529 529 529 529 529 529 530 530 530 520 521 521 521 522 513 513 513 528 544 521 521 521 521 521 521 521 521 547 528 529
529 529 529 529 529 529 529 529 529 529 529 529 529 529 529 529 529 529 529 529 529 529 530 530 530 528 529 529 529 530 513 513 513 528 528 529 544 521 521 521 521 521 521 521 547 529
529 529 529 529 529 529 529 529 529 529 529 529 529 529 529 529 529 529 529 529 529 529 530 530 530 528 529 529 529 530 513 513 513 528 528 529 528 529 529 529 529 529 529 529 529 529
529 529 529 529 529 529 529 529 529 529 529 529 529 529 529 529 529 529 529 529 529 529 530 530 530 528 529 529 529 530 513 513 513 528 528 529 528 529 529 529 529 529 529 529 529 529
529 529 529 529 529 529 529 529 529 529 529 529 529 529 529 529 529 529 529 529 529 529 530 530 530 528 529 529 529 530 513 513 513 528 528 529 528 529 529 529 529 529 529 529 529 529
529 529 529 539 537 537 537 537 537 537 537 537 537 537 537 537 537 537 537 537 537 537 538 530 530 528 529 529 539 538 513 513 513 528 528 529 536 537 537 537 537 537 537 537 540 529
529 539 537 538 529 529 529 529 529 529 529 539 540 529 529 529 529 529 539 537 537 537 537 538 530 528 529 529 530 513 513 513 513 528 536 537 537 537 537 537 537 537 537 540 528 529
529 530 529 529 529 529 529 529 529 517 529 530 528 529 529 529 529 529 530 529 529 529 529 529 530 536 537 537 538 513 513 513 513 536 537 537 537 537 537 537 537 537 540 528 528 529
529 530 529 529 529 529 529 529 529 529 529 530 528 529 529 529 529 529 530 529 529 529 529 529 547 521 521 547 522 513 513 513 513 513 513 520 521 521 521 521 521 522 528 528 528 529
529 530 529 529 529 529 539 540 529 529 529 530 528 529 529 529 529 529 530 529 529 529 529 544 521 521 521 546 530 513 513 513 513 513 520 547 529 529 529 529 529 530 528 528 528 529
529 530 529 529 529 539 538 536 537 537 537 538 536 537 540 529 529 529 699 699 700 700 701 701 529 529 529 699 699 700 700 700 700 700 701 700 521 521 521 521 546 530 528 528 528 529
529 530 529 529 529 530 529 529 529 529 529 529 529 529 528 529 529 529 707 707 708 708 709 709 529 529 529 707 707 708 708 708 708 708 709 708 529 529 529 529 530 530 528 528 528 529
529 530 529 529 529 530 529 539 537 537 537 537 537 540 536 537 516 537 538 539 537 537 540 536 537 537 537 538 530 513 513 513 513 513 528 528 539 537 537 516 538 530 528 528 528 529
529 530 529 529 539 538 539 538 539 537 537 537 540 536 537 537 516 537 537 538 513 513 536 537 537 537 537 537 538 513 513 513 513 513 528 528 530 539 537 516 537 538 528 528 528 529
529 530 529 529 530 539 538 539 538 513 513 513 536 537 537 537 516 537 537 537 537 537 537 537 540 513 513 513 513 513 513 513 513 513 528 536 538 530 539 516 537 540 528 528 536 540
529 530 529 529 530 530 539 538 513 513 513 513 513 513 513 513 513 513 513 513 513 513 513 513 528 513 513 513 513 513 513 513 513 513 536 540 529 530 530 513 513 528 528 536 540 528
529 530 529 529 530 530 530 513 513 513 513 513 513 513 513 513 513 513 513 513 513 513 513 513 536 537 537 537 537 537 540 513 513 513 513 536 537 538 530 513 513 528 536 540 528 528
529 530 529 529 530 530 530 513 513 513 520 521 521 521 521 521 522 513 513 513 513 513 513 513 513 513 513 513 513 513 528 513 513 513 513 513 513 513 530 513 513 536 540 528 528 528
529 530 529 529 699 699 700 700 700 700 701 700 521 521 521 546 530 513 513 513 513 513 513 513 513 513 513 513 513 513 528 513 513 513 513 513 513 513 530 513 513 513 528 528 528 528
529 530 529 529 707 707 708 708 708 708 709 708 529 529 529 530 530 513 513 520 521 521 521 521 521 522 513 513 513 513 528 520 521 521 521 522 513 513 530 513 513 513 528 528 528 528
529 530 539 537 538 530 530 513 513 513 528 536 537 516 537 538 530 513 513 528 544 521 521 521 700 699 700 700 700 700 700 701 700 521 546 530 513 513 530 588 593 589 528 528 528 528
529 530 530 539 537 538 530 513 513 513 536 537 537 516 537 537 538 848 515 528 528 529 529 529 708 707 708 708 709 709 708 709 708 529 530 530 513 513 530 513 513 513 528 528 528 528
529 530 530 530 539 537 538 513 513 513 513 513 513 513 513 513 513 568 520 547 536 516 537 537 538 530 513 513 513 513 528 528 536 516 538 530 513 513 530 513 513 513 528 528 528 528
529 530 530 530 530 513 513 513 513 513 513 513 513 513 513 513 513 568 528 539 537 516 537 540 529 547 522 513 513 513 528 536 537 516 537 538 513 513 530 513 513 513 528 528 528 528
529 530 530 530 530 513 513 513 513 513 513 513 513 513 513 513 513 568 528 530 513 513 513 528 529 529 530 513 513 513 528 513 513 513 513 513 513 513 530 513 513 513 528 528 528 528
529 530 530 530 530 513 513 520 521 521 521 521 521 522 513 513 513 568 528 530 513 517 513 528 529 529 530 513 513 513 528 513 513 513 513 513 513 513 530 513 513 513 528 528 528 528
529 530 530 530 530 513 513 528 544 521 521 521 546 530 513 513 513 568 528 547 521 521 521 547 529 529 530 513 513 513 536 537 537 537 537 537 537 537 538 513 513 513 528 528 528 528
529 530 530 530 530 513 513 528 528 529 529 529 699 699 700 700 700 700 701 700 521 521 521 546 529 539 538 513 513 513 513 513 513 513 513 513 513 513 513 513 513 520 547 528 528 528
529 530 530 530 530 513 513 528 528 529 529 529 707 707 708 708 708 708 709 708 529 529 529 530 539 538 513 513 513 513 513 513 513 513 513 513 513 513 513 513 513 528 544 547 528 528
529 530 530 530 530 513 513 528 536 516 537 537 538 530 513 513 513 568 528 536 537 516 537 538 530 513 513 513 513 513 513 513 513 513 513 520 521 521 521 547 547 547 528 529 528 528
529 530 530 530 530 513 513 536 537 516 537 537 537 538 513 513 513 568 536 537 537 516 537 537 538 513 513 513 513 513 513 513 513 513 520 547 529 529 544 521 521 547 547 529 528 528
529 530 530 530 530 513 513 513 513 513 543 513 513 513 513 513 513 576 593 585 513 513 513 513 513 513 513 513 520 521 521 547 547 521 547 529 544 521 547 529 529 529 517 529 528 528
529 530 530 530 530 513 513 513 513 513 551 515 513 513 513 513 513 513 513 568 513 513 513 513 513 513 513 513 528 544 521 521 521 521 521 521 547 529 529 529 529 529 529 529 528 528
529 530 530 530 547 521 521 521 522 513 513 514 513 513 513 519 513 513 513 568 513 513 520 521 521 521 521 521 547 528 544 521 521 521 521 521 521 521 521 521 521 521 521 521 547 528
529 530 530 547 521 521 521 546 547 521 521 521 521 521 600 601 602 521 521 521 547 521 547 544 521 521 521 521 521 547 528 529 529 544 521 521 521 521 521 521 521 521 521 521 521 547
529 530 547 521 546 529 529 547 521 521 521 521 521 521 521 521 521 521 521 521 521 521 521 547 529 529 529 544 521 521 547 544 521 547 529 529 529 529 529 529 529 529 529 529 529 529
529 547 546 529 547 521 521 521 521 521 521 521 521 521 521 521 521 521 521 521 521 521 521 521 521 521 521 547 529 529 529 528 529 529 529 529 529 529 529 529 529 529 529 529 529 529
529 529 547 521 521 521 521 521 521 521 521 521 521 521 521 521 521 521 521 521 521 521 521 521 521 521 521 521 521 521 521 547 529 529 529 529 529 529 529 529 529 529 529 529 529 529