VictoryRoad_B2F_Layout (46x31)
529 529 529 539 537 537 537 537 537 537 537 537 537 537 537 537 537 537 537 537 537 537 537 537 537 537 537 537 540 529 529 529 529 529 529 529 539 537 540 529 529 529 529 529 529 529
529 529 529 530 384 393 393 393 393 393 393 393 393 393 393 393 393 393 393 393 393 393 393 393 393 393 393 385 528 529 529 529 529 529 529 529 530 529 536 540 529 529 539 527 537 540
529 529 529 530 400 635 635 635 635 635 635 635 635 635 635 635 635 635 635 635 635 635 635 635 635 635 635 402 528 529 529 529 539 537 537 537 538 529 529 528 529 529 530 534 529 528
529 529 529 530 400 635 635 635 635 635 635 635 635 635 635 635 635 635 635 635 635 635 635 635 635 635 635 402 528 529 529 529 530 529 529 529 529 529 529 536 540 529 530 529 529 528
529 529 529 530 400 635 635 635 635 635 635 635 635 635 635 635 635 635 635 635 635 635 635 635 635 635 635 402 536 540 529 529 530 529 529 529 529 529 529 529 528 529 530 529 529 528
529 529 539 538 400 635 635 635 635 635 852 853 853 853 854 635 635 635 635 635 635 635 635 635 635 635 635 402 529 528 529 529 530 529 529 529 529 529 529 529 536 537 538 529 529 528
529 529 530 529 855 855 855 377 635 402 528 529 529 529 530 855 855 855 855 855 855 855 855 377 635 635 635 402 529 528 529 529 530 529 529 544 521 546 529 529 529 529 529 529 529 528
539 537 538 529 529 529 529 400 635 402 528 529 539 537 538 529 529 529 529 529 529 529 529 855 855 377 635 402 544 547 529 539 538 529 529 528 529 547 546 529 529 529 529 529 529 528
530 529 529 529 529 529 529 400 635 402 528 539 538 529 529 529 529 529 529 529 529 529 529 529 529 400 635 402 536 537 537 538 529 529 529 536 537 537 538 529 529 529 529 529 529 528
530 529 529 529 529 529 529 400 635 402 528 530 539 537 537 537 537 537 537 537 537 537 537 537 537 187 179 188 537 537 537 537 537 537 516 537 537 537 537 537 540 529 529 529 529 528
530 529 529 529 529 529 529 400 635 402 536 538 530 539 537 537 537 537 537 537 537 537 537 537 537 185 185 185 537 537 537 537 537 537 516 537 537 540 529 529 528 529 529 529 529 528
530 529 529 539 537 537 537 187 179 188 537 537 538 530 539 537 537 537 537 527 537 537 537 537 537 185 185 185 537 537 537 537 537 537 516 537 540 528 529 529 528 529 529 529 529 528
530 529 529 530 539 537 537 185 185 185 537 537 537 538 530 384 393 385 513 534 513 384 346 347 393 884 885 886 393 393 393 393 385 513 513 513 528 536 537 540 528 529 529 529 529 528
530 529 529 530 530 539 539 185 185 185 537 537 537 537 538 400 635 402 513 513 513 400 344 345 635 635 635 635 635 635 635 635 402 513 513 513 528 529 529 528 528 529 529 529 529 528
530 529 529 530 530 530 384 884 885 886 393 393 393 393 393 408 635 410 393 393 393 408 635 336 337 635 635 635 635 635 635 635 410 393 393 385 528 529 529 528 528 529 529 529 529 528
530 529 529 530 530 530 400 635 635 635 635 635 635 635 635 635 635 635 635 635 635 635 635 344 345 635 635 635 635 635 635 635 635 635 635 376 528 544 521 547 528 529 529 529 529 528
530 529 529 530 530 547 547 547 853 853 853 854 635 635 635 635 635 635 635 635 635 852 853 853 853 853 853 853 853 853 853 853 854 635 635 402 528 528 544 521 547 529 529 529 529 528
530 529 529 530 547 521 521 521 521 521 546 676 854 635 635 635 852 853 853 853 853 676 544 521 521 521 521 521 521 521 521 546 530 580 580 580 528 528 528 529 529 529 529 529 529 528
530 529 529 547 521 521 521 521 521 546 530 529 530 580 580 580 528 544 521 521 521 521 547 544 521 521 521 521 521 521 699 699 699 700 700 700 701 701 701 529 529 529 529 529 529 528
530 529 529 529 529 529 529 529 529 699 699 699 699 700 700 700 699 699 699 521 521 521 521 547 529 529 529 529 529 529 707 707 707 708 708 708 709 709 709 529 529 529 529 529 529 528
530 539 537 537 537 537 540 529 529 707 707 707 707 708 708 708 707 707 707 529 529 529 529 529 529 529 529 529 529 539 538 530 530 513 513 513 528 528 536 540 590 594 594 594 591 528
530 530 529 529 529 529 536 537 537 538 530 529 530 513 513 513 528 528 528 529 529 529 529 529 529 529 529 539 537 538 539 538 530 513 513 513 528 536 540 528 529 529 529 529 529 528
530 530 529 529 539 537 537 537 537 537 538 539 538 513 513 513 528 528 536 537 537 537 537 537 537 537 537 538 539 537 538 539 538 513 513 513 536 540 528 528 529 529 529 529 529 528
530 530 529 539 538 529 539 537 537 537 537 538 513 513 513 513 528 536 537 540 529 529 529 529 539 537 537 537 538 529 529 530 513 513 513 513 513 528 528 536 516 537 537 537 540 528
530 530 529 530 529 529 530 513 513 513 849 513 513 513 513 513 536 537 540 528 529 529 529 529 530 529 539 537 537 537 527 538 513 513 513 513 513 528 536 537 516 537 537 540 528 528
530 530 529 530 539 527 538 513 513 513 569 513 513 513 513 513 513 513 528 528 529 529 529 529 530 529 530 513 513 513 534 513 513 513 513 513 513 536 537 537 516 540 529 528 528 528
530 530 529 530 530 535 513 513 513 513 851 513 513 513 513 513 513 513 528 528 529 529 529 529 530 529 530 513 513 513 513 513 513 513 513 513 513 513 513 513 513 528 529 528 528 528
530 530 529 530 547 521 521 521 521 521 521 521 521 521 521 521 521 521 547 528 529 529 529 529 530 529 547 521 521 521 521 521 521 521 521 521 521 521 521 521 521 547 529 528 528 528
530 530 529 547 521 521 521 521 521 521 521 521 521 521 521 521 521 521 521 547 529 529 529 529 547 521 521 521 521 521 521 521 521 521 521 521 521 521 521 521 521 521 521 547 528 528
530 547 521 521 521 521 521 521 521 521 521 521 521 521 521 521 521 521 521 521 521 521 521 521 521 521 521 521 521 521 521 521 521 521 521 521 521 521 521 521 521 521 521 521 547 528
547 521 521 521 521 521 521 521 521 521 521 521 521 521 521 521 521 521 521 521 521 521 521 521 521 521 521 521 521 521 521 521 521 521 521 521 521 521 521 521 521 521 521 521 521 547